Game_Id,Player_Id,Team_Id,Game_Rating,SA,GA,SV,SV_percent,TOI,PIM
21186,546,19,77,35,3,32,.914,3900000,0
21186,4524,33,90,42,3,39,.929,3900000,0
21186,15649,33,0,0,0,0,.00nan,0,0
21186,29239,19,0,0,0,0,.00nan,0,0
21187,546,19,73,28,2,26,.929,3586000,0
21187,4524,33,0,0,0,0,.00nan,0,0
21187,15649,33,86,31,1,30,.968,3600000,0
21187,29239,19,0,0,0,0,.00nan,0,0
21188,1931,30,94,21,0,21,1000,3600000,0
21188,4851,30,0,0,0,0,.00nan,0,0
21188,5031,18,0,0,0,0,.00nan,0,0
21188,29089,18,87,37,2,35,.946,3546000,0
21189,2308,17,0,0,0,0,.00nan,0,0
21189,3643,34,36,31,6,25,.806,3600000,0
21189,13675,34,0,0,0,0,.00nan,0,0
21189,31925,17,100,33,0,33,1000,3600000,0
21190,1840,23,0,0,0,0,.00nan,0,0
21190,20741,11,64,38,4,34,.895,3524000,0
21190,24549,23,78,30,2,28,.933,3600000,0
21190,32637,11,0,0,0,0,.00nan,0,0
21191,8126,10,0,0,0,0,.00nan,0,0
21191,17566,10,100,30,0,30,1000,3600000,0
21191,24605,21,49,23,4,19,.826,3600000,0
21191,26535,21,0,0,0,0,.00nan,0,0
21192,1814,16,81,33,2,31,.939,3900000,0
21192,2210,12,0,0,0,0,.00nan,0,0
21192,14112,16,0,0,0,0,.00nan,0,0
21192,32602,12,94,32,2,30,.938,3900000,0
21193,1593,4838,100,39,0,39,1000,3600000,0
21193,3644,4182,0,0,0,0,.00nan,0,0
21193,22120,4838,0,0,0,0,.00nan,0,0
21193,25302,4182,81,25,1,24,.960,3561000,0
21194,1448,28,0,0,0,0,.00nan,0,0
21194,13881,28,62,19,2,17,.895,3600000,0
21194,15159,9,0,0,0,0,.00nan,0,0
21194,20145,9,79,38,3,35,.921,3562000,0
21195,65,31,65,26,2,24,.923,3900000,0
21195,17544,20,95,46,2,44,.957,3900000,0
21195,30236,20,0,0,0,0,.00nan,0,0
21195,32612,31,0,0,0,0,.00nan,0,0
21196,1078,0,59,36,4,32,.889,3900000,0
21196,14638,29,0,0,0,0,.00nan,0,0
21196,17790,29,53,28,4,24,.857,3900000,0
21196,29152,0,0,0,0,0,.00nan,0,0
21197,1814,16,52,12,1,11,.917,1638000,0
21197,14112,16,25,18,5,13,.722,1962000,0
21197,20012,27,87,39,2,37,.949,3600000,0
21197,32629,27,0,0,0,0,.00nan,0,0
21198,1840,23,82,33,3,30,.909,3900000,0
21198,1931,30,77,42,3,39,.929,3900000,0
21198,4851,30,0,0,0,0,.00nan,0,0
21198,24549,23,0,0,0,0,.00nan,0,0
21199,3304,26,0,0,0,0,.00nan,0,0
21199,3643,34,28,15,4,11,.733,920000,0
21199,13675,34,43,28,5,23,.821,2680000,0
21199,29746,26,69,19,1,18,.947,3600000,0
21200,1634,22,100,36,1,35,.972,3600000,0
21200,4469,5,0,0,0,0,.00nan,0,0
21200,5168,22,0,0,0,0,.00nan,0,0
21200,19166,5,63,21,2,19,.905,3559000,0
21201,2072,8,99,38,1,37,.974,3600000,0
21201,4524,33,64,36,5,31,.861,3600000,0
21201,15649,33,0,0,0,0,.00nan,0,0
21201,22527,8,0,0,0,0,.00nan,0,0
21202,2036,24,92,43,2,41,.953,3600000,0
21202,2440,15,52,32,4,28,.875,3592000,0
21202,4127,15,0,0,0,0,.00nan,0,0
21202,29139,24,0,0,0,0,.00nan,0,0
21203,264,35,0,0,0,0,.00nan,0,0
21203,8073,14,99,53,1,52,.981,3600000,0
21203,24359,14,0,0,0,0,.00nan,0,0
21203,25490,35,50,24,3,21,.875,3541000,0
21204,15159,9,86,44,3,41,.932,3900000,0
21204,17544,20,0,0,0,0,.00nan,0,0
21204,20145,9,0,0,0,0,.00nan,0,0
21204,30236,20,55,31,3,28,.903,3848000,0
21205,2210,12,73,37,3,34,.919,3643000,0
21205,5031,18,77,41,4,37,.902,3643000,0
21205,29089,18,0,0,0,0,.00nan,0,0
21205,32602,12,0,0,0,0,.00nan,0,0
21206,2308,17,0,0,0,0,.00nan,0,0
21206,8126,10,0,0,0,0,.00nan,0,0
21206,17566,10,93,36,2,34,.944,3900000,0
21206,31925,17,97,44,2,42,.955,3900000,0
21207,1448,28,92,47,4,43,.915,3829050,0
21207,13881,28,0,0,0,0,.00nan,0,0
21207,24295,3,0,0,0,0,.00nan,0,0
21207,26285,3,86,49,5,44,.898,3829050,0
21208,546,19,72,35,3,32,.914,3600000,0
21208,24605,21,0,0,0,0,.00nan,0,0
21208,26535,21,70,23,2,21,.913,3600000,0
21208,29239,19,0,0,0,0,.00nan,0,0
21209,752,32,0,0,0,0,.00nan,0,0
21209,3643,34,55,26,4,22,.846,3900000,0
21209,13675,34,0,0,0,0,.00nan,0,0
21209,15180,32,48,30,4,26,.867,3900000,0
21210,65,31,76,44,4,40,.909,3600000,0
21210,264,35,0,0,0,0,.00nan,0,0
21210,25490,35,78,22,1,21,.955,3600000,0
21210,32612,31,0,0,0,0,.00nan,0,0
21211,4469,5,0,0,0,0,.00nan,0,0
21211,14638,29,0,0,0,0,.00nan,0,0
21211,17790,29,74,41,4,37,.902,3545000,0
21211,19166,5,43,16,3,13,.813,3600000,0
21212,2072,8,0,0,0,0,.00nan,0,0
21212,4524,33,64,32,3,29,.906,3544000,0
21212,15649,33,0,0,0,0,.00nan,0,0
21212,22527,8,81,27,2,25,.926,3600000,0
21213,1593,4838,47,34,5,29,.853,3524000,0
21213,20012,27,60,24,3,21,.875,3600000,0
21213,22120,4838,0,0,0,0,.00nan,0,0
21213,32629,27,0,0,0,0,.00nan,0,0
21214,1931,30,38,33,6,27,.818,3590000,0
21214,3304,26,100,35,1,34,.971,3102000,0
21214,4851,30,0,0,0,0,.00nan,0,0
21214,29746,26,32,9,3,6,.667,498000,0
21215,1634,22,58,35,4,31,.886,3600000,0
21215,5168,22,0,0,0,0,.00nan,0,0
21215,20741,11,38,31,6,25,.806,3572000,0
21215,32637,11,0,0,0,0,.00nan,0,0
21216,2036,24,65,39,5,34,.872,3600000,0
21216,24295,3,0,0,0,0,.00nan,0,0
21216,26285,3,100,41,2,39,.951,3600000,0
21216,29139,24,0,0,0,0,.00nan,0,0
21217,2440,15,64,33,4,29,.879,3600000,0
21217,3644,4182,0,0,0,0,.00nan,0,0
21217,4127,15,0,0,0,0,.00nan,0,0
21217,25302,4182,51,44,7,37,.841,3600000,0
21218,2308,17,84,32,2,30,.938,3900000,0
21218,8073,14,0,0,0,0,.00nan,0,0
21218,24359,14,81,32,2,30,.938,3900000,0
21218,31925,17,0,0,0,0,.00nan,0,0
21219,546,19,82,30,2,28,.933,3600000,0
21219,2210,12,0,0,0,0,.00nan,0,0
21219,29239,19,0,0,0,0,.00nan,0,0
21219,32602,12,68,33,3,30,.909,3549000,0
21220,1840,23,32,5,2,3,.600,384000,0
21220,5031,18,75,35,3,32,.914,3600000,0
21220,24549,23,42,43,7,36,.837,3216000,0
21220,29089,18,0,0,0,0,.00nan,0,0
21221,8126,10,64,42,5,37,.881,3600000,0
21221,17566,10,0,0,0,0,.00nan,0,0
21221,25620,25,73,24,1,23,.958,3600000,0
21221,26065,25,0,0,0,0,.00nan,0,0
21222,1078,0,0,0,0,0,.00nan,0,0
21222,15159,9,0,0,0,0,.00nan,0,0
21222,20145,9,77,38,3,35,.921,3715000,0
21222,29152,0,77,36,4,32,.889,3715000,0
21223,1448,28,0,0,0,0,.00nan,0,0
21223,13881,28,76,27,2,25,.926,3578000,0
21223,17544,20,100,41,1,40,.976,3600000,0
21223,30236,20,0,0,0,0,.00nan,0,0
21224,65,31,45,36,5,31,.861,3600000,0
21224,4469,5,0,0,0,0,.00nan,0,0
21224,19166,5,100,30,0,30,1000,3600000,0
21224,32612,31,0,0,0,0,.00nan,0,0
21225,752,32,63,15,1,14,.933,1242000,0
21225,2072,8,42,32,6,26,.813,2799000,0
21225,15180,32,34,29,6,23,.793,2658000,0
21225,22527,8,49,10,1,9,.900,1101000,0
21226,1931,30,82,37,3,34,.919,3579000,0
21226,4851,30,0,0,0,0,.00nan,0,0
21226,24295,3,94,36,2,34,.944,3600000,0
21226,26285,3,0,0,0,0,.00nan,0,0
21227,1814,16,0,0,0,0,.00nan,0,0
21227,3304,26,88,40,3,37,.925,3833000,0
21227,14112,16,70,40,4,36,.900,3833000,0
21227,29746,26,0,0,0,0,.00nan,0,0
21228,1448,28,77,37,3,34,.919,3600000,0
21228,8073,14,53,29,4,25,.862,3543000,0
21228,13881,28,0,0,0,0,.00nan,0,0
21228,24359,14,0,0,0,0,.00nan,0,0
21229,3643,34,0,0,0,0,.00nan,0,0
21229,13675,34,24,23,6,17,.739,3600000,0
21229,20741,11,0,0,0,0,.00nan,0,0
21229,32637,11,71,21,1,20,.952,3600000,0
21230,1840,23,91,33,2,31,.939,3600000,0
21230,24549,23,0,0,0,0,.00nan,0,0
21230,24605,21,55,27,4,23,.852,3570000,0
21230,26535,21,0,0,0,0,.00nan,0,0
21231,264,35,90,18,0,18,1000,3600000,0
21231,15159,9,92,49,2,47,.959,3528000,0
21231,20145,9,0,0,0,0,.00nan,0,0
21231,25490,35,0,0,0,0,.00nan,0,0
21232,17544,20,89,37,2,35,.946,3574000,0
21232,25302,4182,98,25,0,25,1000,3600000,0
21232,30236,20,0,0,0,0,.00nan,0,0
21232,32635,4182,0,0,0,0,.00nan,0,0
21233,5031,18,74,45,5,40,.889,3600000,0
21233,20012,27,100,38,1,37,.974,3600000,0
21233,29089,18,0,0,0,0,.00nan,0,0
21233,32629,27,0,0,0,0,.00nan,0,0
21234,8126,10,0,0,0,0,.00nan,0,0
21234,17566,10,75,46,4,42,.913,3600000,0
21234,25302,4182,85,27,1,26,.963,3600000,0
21234,32635,4182,0,0,0,0,.00nan,0,0
21235,1593,4838,88,49,4,45,.918,3567000,0
21235,14638,29,0,0,0,0,.00nan,0,0
21235,17790,29,78,32,2,30,.938,3600000,0
21235,22120,4838,0,0,0,0,.00nan,0,0
21236,546,19,88,37,2,35,.946,3900000,0
21236,1634,22,87,32,2,30,.938,3900000,0
21236,5168,22,0,0,0,0,.00nan,0,0
21236,29239,19,0,0,0,0,.00nan,0,0
21237,1931,30,0,0,0,0,.00nan,0,0
21237,4524,33,96,34,1,33,.971,3600000,0
21237,4851,30,63,30,3,27,.900,3585000,0
21237,15649,33,0,0,0,0,.00nan,0,0
21238,2036,24,0,0,0,0,.00nan,0,0
21238,20741,11,59,31,4,27,.871,3900000,0
21238,29139,24,55,33,4,29,.879,3900000,0
21238,32637,11,0,0,0,0,.00nan,0,0
21239,65,31,82,38,2,36,.947,3900000,0
21239,1078,0,93,40,2,38,.950,3900000,0
21239,29152,0,0,0,0,0,.00nan,0,0
21239,32612,31,0,0,0,0,.00nan,0,0
21240,2308,17,0,0,0,0,.00nan,0,0
21240,2440,15,84,31,2,29,.935,3600000,0
21240,4127,15,0,0,0,0,.00nan,0,0
21240,31925,17,63,36,5,31,.861,3600000,0
21241,752,32,0,0,0,0,.00nan,0,0
21241,1814,16,0,0,0,0,.00nan,0,0
21241,14112,16,100,29,0,29,1000,3600000,0
21241,15180,32,84,45,4,41,.911,3600000,0
21242,2440,15,0,0,0,0,.00nan,0,0
21242,4127,15,18,17,5,12,.706,3600000,0
21242,4469,5,0,0,0,0,.00nan,0,0
21242,19166,5,65,24,2,22,.917,3600000,0
21243,1840,23,0,0,0,0,.00nan,0,0
21243,24549,23,77,40,4,36,.900,3533000,0
21243,25620,25,91,33,2,31,.939,3600000,0
21243,26065,25,0,0,0,0,.00nan,0,0
21244,65,31,91,60,4,56,.933,3900000,0
21244,20741,11,0,0,0,0,.00nan,0,0
21244,32612,31,0,0,0,0,.00nan,0,0
21244,32637,11,52,34,4,30,.882,3871000,0
21245,14638,29,0,0,0,0,.00nan,0,0
21245,17790,29,64,32,3,29,.906,3900000,0
21245,20012,27,79,42,3,39,.929,3900000,0
21245,32629,27,0,0,0,0,.00nan,0,0
21246,4524,33,73,41,5,36,.878,3600000,0
21246,8126,10,0,0,0,0,.00nan,0,0
21246,15649,33,0,0,0,0,.00nan,0,0
21246,17566,10,78,40,4,36,.900,3600000,0
21247,1593,4838,65,27,3,24,.889,3600000,0
21247,22120,4838,0,0,0,0,.00nan,0,0
21247,24605,21,0,0,0,0,.00nan,0,0
21247,26535,21,34,23,5,18,.783,3567000,0
21248,3304,26,62,48,6,42,.875,3600000,0
21248,25302,4182,0,0,0,0,.00nan,0,0
21248,29746,26,0,0,0,0,.00nan,0,0
21248,32635,4182,96,23,0,23,1000,3600000,0
21249,264,35,87,41,3,38,.927,3900000,0
21249,1448,28,82,36,3,33,.917,3868000,0
21249,13881,28,0,0,0,0,.00nan,0,0
21249,25490,35,0,0,0,0,.00nan,0,0
21250,1634,22,0,0,0,0,.00nan,0,0
21250,2036,24,65,33,3,30,.909,3544000,0
21250,5168,22,85,35,2,33,.943,3600000,0
21250,29139,24,0,0,0,0,.00nan,0,0
21251,546,19,57,29,3,26,.897,3589000,0
21251,3643,34,91,43,2,41,.953,3600000,0
21251,13675,34,0,0,0,0,.00nan,0,0
21251,29239,19,0,0,0,0,.00nan,0,0
21252,1078,0,100,40,2,38,.950,3600000,0
21252,17544,20,40,32,5,27,.844,3600000,0
21252,29152,0,0,0,0,0,.00nan,0,0
21252,30236,20,0,0,0,0,.00nan,0,0
21253,1931,30,82,32,2,30,.938,3600000,0
21253,4851,30,0,0,0,0,.00nan,0,0
21253,8073,14,3,21,7,14,.667,2571000,0
21253,24359,14,58,6,0,6,1000,1029000,0
21254,2072,8,0,0,0,0,.00nan,0,0
21254,15159,9,83,24,1,23,.958,3600000,0
21254,20145,9,0,0,0,0,.00nan,0,0
21254,22527,8,42,25,5,20,.800,3600000,0
21255,752,32,67,35,4,31,.886,3551000,0
21255,5031,18,61,20,2,18,.900,3600000,0
21255,15180,32,0,0,0,0,.00nan,0,0
21255,29089,18,0,0,0,0,.00nan,0,0
21256,2210,12,60,12,1,11,.917,1710950,0
21256,24295,3,0,0,0,0,.00nan,0,0
21256,26285,3,64,24,3,21,.875,3600000,0
21256,32602,12,32,27,6,21,.778,1889050,0
21257,1814,16,0,0,0,0,.00nan,0,0
21257,1840,23,0,0,0,0,.00nan,0,0
21257,14112,16,98,41,0,41,1000,3900000,0
21257,24549,23,100,35,0,35,1000,3900000,0
21258,2308,17,0,0,0,0,.00nan,0,0
21258,4469,5,0,0,0,0,.00nan,0,0
21258,19166,5,68,27,2,25,.926,3600000,0
21258,31925,17,50,21,3,18,.857,3563000,0
21259,65,31,80,39,3,36,.923,3600000,0
21259,3304,26,100,24,0,24,1000,3600000,0
21259,29746,26,0,0,0,0,.00nan,0,0
21259,32612,31,0,0,0,0,.00nan,0,0
21260,20012,27,92,39,2,37,.949,3698000,0
21260,24605,21,0,0,0,0,.00nan,0,0
21260,26535,21,69,20,1,19,.950,3698000,0
21260,32629,27,0,0,0,0,.00nan,0,0
21261,8073,14,0,0,0,0,.00nan,0,0
21261,8126,10,0,0,0,0,.00nan,0,0
21261,17566,10,82,41,2,39,.951,3900000,0
21261,24359,14,83,32,2,30,.938,3900000,0
21262,1593,4838,28,29,6,23,.793,3600000,0
21262,22120,4838,0,0,0,0,.00nan,0,0
21262,25620,25,0,0,0,0,.00nan,0,0
21262,26065,25,67,38,3,35,.921,3600000,0
21263,1448,28,39,15,3,12,.800,3600000,0
21263,2072,8,58,34,4,30,.882,3600000,0
21263,13881,28,0,0,0,0,.00nan,0,0
21263,22527,8,0,0,0,0,.00nan,0,0
21264,2440,15,0,0,0,0,.00nan,0,0
21264,4127,15,55,30,4,26,.867,3600000,0
21264,4524,33,66,46,6,40,.870,3563000,0
21264,15649,33,0,0,0,0,.00nan,0,0
21265,546,19,89,32,1,31,.969,3600000,0
21265,2036,24,76,26,2,24,.923,3594000,0
21265,29139,24,0,0,0,0,.00nan,0,0
21265,29239,19,0,0,0,0,.00nan,0,0
21266,264,35,59,31,3,28,.903,3530000,0
21266,1078,0,90,29,1,28,.966,3600000,0
21266,25490,35,0,0,0,0,.00nan,0,0
21266,29152,0,0,0,0,0,.00nan,0,0
21267,1634,22,100,31,0,31,1000,3600000,0
21267,2308,17,57,35,4,31,.886,3600000,0
21267,5168,22,0,0,0,0,.00nan,0,0
21267,31925,17,0,0,0,0,.00nan,0,0
21268,14638,29,0,0,0,0,.00nan,0,0
21268,17790,29,83,37,3,34,.919,3900000,0
21268,25302,4182,0,0,0,0,.00nan,0,0
21268,32635,4182,63,31,3,28,.903,3900000,0
21269,1814,16,0,0,0,0,.00nan,0,0
21269,5031,18,95,41,2,39,.951,3598000,0
21269,14112,16,73,22,1,21,.955,3600000,0
21269,29089,18,0,0,0,0,.00nan,0,0
21270,1931,30,92,35,2,33,.943,3531000,0
21270,4851,30,0,0,0,0,.00nan,0,0
21270,17544,20,100,27,0,27,1000,3600000,0
21270,30236,20,0,0,0,0,.00nan,0,0
21271,752,32,0,0,0,0,.00nan,0,0
21271,15159,9,0,0,0,0,.00nan,0,0
21271,15180,32,81,30,1,29,.967,3600000,0
21271,20145,9,74,34,2,32,.941,3559000,0
21272,1840,23,0,0,0,0,.00nan,0,0
21272,2210,12,49,6,1,5,.833,1399000,0
21272,24549,23,63,34,4,30,.882,3730000,0
21272,32602,12,60,30,4,26,.867,2331000,0
21273,20741,11,85,37,3,34,.919,3600000,0
21273,24295,3,44,9,2,7,.778,1275850,0
21273,26285,3,40,31,6,25,.806,2324150,0
21273,32637,11,0,0,0,0,.00nan,0,0
21274,1634,22,74,42,4,38,.905,3600000,0
21274,4469,5,0,0,0,0,.00nan,0,0
21274,5168,22,0,0,0,0,.00nan,0,0
21274,19166,5,89,36,2,34,.944,3600000,0
21275,3643,34,87,37,3,34,.919,3900000,0
21275,8126,10,95,38,3,35,.921,3900000,0
21275,13675,34,0,0,0,0,.00nan,0,0
21275,17566,10,0,0,0,0,.00nan,0,0
21276,546,19,97,37,1,36,.973,3600000,0
21276,2440,15,45,21,4,17,.810,2289000,0
21276,4127,15,65,11,0,11,1000,1311000,0
21276,29239,19,0,0,0,0,.00nan,0,0
21277,1593,4838,79,36,2,34,.944,3600000,0
21277,8073,14,75,36,4,32,.889,3600000,0
21277,22120,4838,0,0,0,0,.00nan,0,0
21277,24359,14,0,0,0,0,.00nan,0,0
21278,2036,24,59,25,3,22,.880,3593000,0
21278,17544,20,90,31,1,30,.968,3600000,0
21278,29139,24,0,0,0,0,.00nan,0,0
21278,30236,20,0,0,0,0,.00nan,0,0
21279,1078,0,100,37,1,36,.973,3600000,0
21279,2072,8,59,7,0,7,1000,1260000,0
21279,22527,8,50,33,5,28,.848,2340000,0
21279,29152,0,0,0,0,0,.00nan,0,0
21280,24605,21,71,21,1,20,.952,3600000,0
21280,25302,4182,62,41,5,36,.878,3600000,0
21280,26535,21,0,0,0,0,.00nan,0,0
21280,32635,4182,0,0,0,0,.00nan,0,0
21281,5031,18,0,0,0,0,.00nan,0,0
21281,15159,9,64,35,3,32,.914,3514000,0
21281,20145,9,0,0,0,0,.00nan,0,0
21281,29089,18,79,27,1,26,.963,3600000,0
21282,752,32,58,5,0,5,1000,302000,0
21282,15180,32,41,32,6,26,.813,3298000,0
21282,25620,25,0,0,0,0,.00nan,0,0
21282,26065,25,100,50,2,48,.960,3600000,0
22499,65,31,56,31,4,27,.871,3585000,0
22499,546,19,0,0,0,0,.00nan,0,0
22499,29239,19,66,23,2,21,.913,3600000,0
22499,32612,31,0,0,0,0,.00nan,0,0
22501,3643,34,33,9,3,6,.667,551000,0
22501,13675,34,57,30,3,27,.900,3049000,0
22501,15159,9,64,16,1,15,.938,3600000,0
22501,20145,9,0,0,0,0,.00nan,0,0
22503,740,27,0,0,0,0,.00nan,0,0
22503,17544,20,68,33,3,30,.909,3600000,0
22503,20012,27,63,23,2,21,.913,3600000,0
22503,30236,20,0,0,0,0,.00nan,0,0
22505,264,35,0,0,0,0,.00nan,0,0
22505,1634,22,48,34,5,29,.853,3600000,0
22505,5168,22,0,0,0,0,.00nan,0,0
22505,25490,35,100,32,0,32,1000,3600000,0
22507,752,32,0,0,0,0,.00nan,0,0
22507,15180,32,60,28,3,25,.893,3600000,0
22507,25620,25,0,0,0,0,.00nan,0,0
22507,26065,25,100,31,0,31,1000,3600000,0
22509,8073,14,0,0,0,0,.00nan,0,0
22509,24359,14,45,33,5,28,.848,3600000,0
22509,24605,21,72,25,2,23,.920,3600000,0
22509,26535,21,0,0,0,0,.00nan,0,0
22511,1840,23,73,32,3,29,.906,3600000,0
22511,14638,29,86,43,4,39,.907,3577000,0
22511,17790,29,0,0,0,0,.00nan,0,0
22511,24549,23,0,0,0,0,.00nan,0,0
22513,2308,17,0,0,0,0,.00nan,0,0
22513,4469,5,0,0,0,0,.00nan,0,0
22513,19166,5,97,24,0,24,1000,3600000,0
22513,31925,17,76,33,3,30,.909,3600000,0
22515,1814,16,72,29,2,27,.931,3600000,0
22515,1931,30,0,0,0,0,.00nan,0,0
22515,4851,30,50,23,3,20,.870,3592000,0
22515,14112,16,0,0,0,0,.00nan,0,0
22517,1593,4838,0,0,0,0,.00nan,0,0
22517,2440,15,36,24,5,19,.792,3900000,0
22517,4127,15,0,0,0,0,.00nan,0,0
22517,22120,4838,94,59,5,54,.915,3900000,0
22519,1078,0,0,0,0,0,.00nan,0,0
22519,24295,3,0,0,0,0,.00nan,0,0
22519,26285,3,100,26,0,26,1000,3600000,0
22519,29152,0,80,42,4,38,.905,3600000,0
22521,5031,18,0,0,0,0,.00nan,0,0
22521,8126,10,0,0,0,0,.00nan,0,0
22521,17566,10,38,27,5,22,.815,3515000,0
22521,29089,18,86,42,3,39,.929,3600000,0
22523,2036,24,87,32,2,30,.938,3600000,0
22523,3644,4182,0,0,0,0,.00nan,0,0
22523,10101,24,0,0,0,0,.00nan,0,0
22523,25302,4182,62,45,5,40,.889,3600000,0
22525,3304,26,0,0,0,0,.00nan,0,0
22525,4524,33,0,0,0,0,.00nan,0,0
22525,15649,33,72,31,3,28,.903,3600000,0
22525,29746,26,87,37,2,35,.946,3600000,0
22527,1448,28,77,21,1,20,.952,3600000,0
22527,2210,12,0,0,0,0,.00nan,0,0
22527,13881,28,0,0,0,0,.00nan,0,0
22527,32602,12,61,29,3,26,.897,3520000,0
22529,2072,8,0,0,0,0,.00nan,0,0
22529,20741,11,58,30,4,26,.867,3514000,0
22529,22527,8,87,34,2,32,.941,3600000,0
22529,32637,11,0,0,0,0,.00nan,0,0
22531,2440,15,0,0,0,0,.00nan,0,0
22531,4127,15,63,22,2,20,.909,3600000,0
22531,4469,5,0,0,0,0,.00nan,0,0
22531,19166,5,54,23,3,20,.870,3600000,0
22533,3643,34,88,29,1,28,.966,3600000,0
22533,13675,34,0,0,0,0,.00nan,0,0
22533,15159,9,0,0,0,0,.00nan,0,0
22533,20145,9,76,27,2,25,.926,3600000,0
22535,752,32,100,39,0,39,1000,3600000,0
22535,15180,32,0,0,0,0,.00nan,0,0
22535,24295,3,0,0,0,0,.00nan,0,0
22535,26285,3,83,31,2,29,.935,3600000,0
22537,3644,4182,84,13,0,13,1000,3600000,0
22537,17544,20,0,0,0,0,.00nan,0,0
22537,25302,4182,0,0,0,0,.00nan,0,0
22537,30236,20,73,42,4,38,.905,3600000,0
22539,546,19,86,31,2,29,.935,3600000,0
22539,25620,25,0,0,0,0,.00nan,0,0
22539,26065,25,58,32,4,28,.875,3569000,0
22539,29239,19,0,0,0,0,.00nan,0,0
22541,1814,16,0,0,0,0,.00nan,0,0
22541,8073,14,48,25,4,21,.840,3900000,0
22541,14112,16,70,37,4,33,.892,3900000,0
22541,24359,14,0,0,0,0,.00nan,0,0
22543,1078,0,52,36,5,31,.861,3600000,0
22543,8126,10,82,30,1,29,.967,3600000,0
22543,17566,10,0,0,0,0,.00nan,0,0
22543,29152,0,0,0,0,0,.00nan,0,0
22545,2036,24,0,0,0,0,.00nan,0,0
22545,2308,17,76,36,3,33,.917,3900000,0
22545,10101,24,55,19,3,16,.842,3881000,0
22545,31925,17,0,0,0,0,.00nan,0,0
22547,1840,23,0,0,0,0,.00nan,0,0
22547,14638,29,0,0,0,0,.00nan,0,0
22547,17790,29,61,26,2,24,.923,3600000,0
22547,24549,23,87,41,3,38,.927,3543000,0
22549,1634,22,0,0,0,0,.00nan,0,0
22549,2072,8,92,33,1,32,.970,3600000,0
22549,5168,22,79,26,2,24,.923,3566000,0
22549,22527,8,0,0,0,0,.00nan,0,0
22551,65,31,0,0,0,0,.00nan,0,0
22551,5031,18,96,14,0,14,1000,3600000,0
22551,29089,18,0,0,0,0,.00nan,0,0
22551,32612,31,54,34,5,29,.853,3600000,0
22553,740,27,55,31,5,26,.839,3600000,0
22553,3304,26,76,20,1,19,.950,3600000,0
22553,20012,27,0,0,0,0,.00nan,0,0
22553,29746,26,0,0,0,0,.00nan,0,0
22555,1593,4838,59,28,4,24,.857,3561000,0
22555,20741,11,0,0,0,0,.00nan,0,0
22555,22120,4838,0,0,0,0,.00nan,0,0
22555,32637,11,81,33,2,31,.939,3600000,0
22557,1931,30,83,30,1,29,.967,3600000,0
22557,4524,33,60,34,4,30,.882,3570000,0
22557,4851,30,0,0,0,0,.00nan,0,0
22557,15649,33,0,0,0,0,.00nan,0,0
22559,264,35,0,0,0,0,.00nan,0,0
22559,2210,12,92,39,2,37,.949,3900000,0
22559,25490,35,79,27,2,25,.926,3900000,0
22559,32602,12,0,0,0,0,.00nan,0,0
22561,1448,28,0,0,0,0,.00nan,0,0
22561,13881,28,91,54,2,52,.963,3713000,0
22561,24605,21,0,0,0,0,.00nan,0,0
22561,26535,21,53,23,3,20,.870,3713000,0
22563,65,31,0,0,0,0,.00nan,0,0
22563,8073,14,63,27,3,24,.889,3600000,0
22563,24359,14,0,0,0,0,.00nan,0,0
22563,32612,31,40,23,4,19,.826,3567000,0
22565,546,19,0,0,0,0,.00nan,0,0
22565,5031,18,70,39,4,35,.897,3896000,0
22565,29089,18,0,0,0,0,.00nan,0,0
22565,29239,19,62,38,5,33,.868,3896000,0
22567,264,35,0,0,0,0,.00nan,0,0
22567,1931,30,76,28,2,26,.929,3600000,0
22567,4851,30,0,0,0,0,.00nan,0,0
22567,25490,35,87,29,1,28,.966,3600000,0
22569,740,27,0,0,0,0,.00nan,0,0
22569,752,32,84,35,2,33,.943,3562000,0
22569,15180,32,0,0,0,0,.00nan,0,0
22569,20012,27,78,24,1,23,.958,3600000,0
22571,3643,34,0,0,0,0,.00nan,0,0
22571,13675,34,67,23,1,22,.957,3900000,0
22571,20741,11,98,54,1,53,.981,3900000,0
22571,32637,11,0,0,0,0,.00nan,0,0
22573,1593,4838,92,32,1,31,.969,3600000,0
22573,14638,29,0,0,0,0,.00nan,0,0
22573,17790,29,53,22,3,19,.864,3514000,0
22573,22120,4838,0,0,0,0,.00nan,0,0
22575,2210,12,0,0,0,0,.00nan,0,0
22575,2308,17,0,0,0,0,.00nan,0,0
22575,31925,17,94,48,3,45,.938,3600000,0
22575,32602,12,100,29,0,29,1000,3600000,0
22577,8126,10,0,0,0,0,.00nan,0,0
22577,17566,10,44,28,5,23,.821,3600000,0
22577,24295,3,0,0,0,0,.00nan,0,0
22577,26285,3,84,24,1,23,.958,3600000,0
22579,1634,22,74,35,3,32,.914,3600000,0
22579,5168,22,0,0,0,0,.00nan,0,0
22579,25620,25,72,39,5,34,.872,3600000,0
22579,26065,25,0,0,0,0,.00nan,0,0
22581,2072,8,0,0,0,0,.00nan,0,0
22581,3304,26,0,0,0,0,.00nan,0,0
22581,22527,8,24,16,5,11,.688,3600000,0
22581,29746,26,100,37,2,35,.946,3600000,0
22583,4524,33,100,27,0,27,1000,3600000,0
22583,15649,33,0,0,0,0,.00nan,0,0
22583,24605,21,69,22,1,21,.955,3556000,0
22583,26535,21,0,0,0,0,.00nan,0,0
22585,1448,28,0,0,0,0,.00nan,0,0
22585,3644,4182,24,5,3,2,.400,505000,0
22585,13881,28,92,40,3,37,.925,3600000,0
22585,25302,4182,62,26,3,23,.885,3095000,0
22587,2440,15,43,26,5,21,.808,3900000,0
22587,4127,15,0,0,0,0,.00nan,0,0
22587,15159,9,0,0,0,0,.00nan,0,0
22587,20145,9,53,36,5,31,.861,3900000,0
22589,1078,0,0,0,0,0,.00nan,0,0
22589,17544,20,83,32,2,30,.938,3600000,0
22589,29152,0,50,34,5,29,.853,3600000,0
22589,30236,20,0,0,0,0,.00nan,0,0
22591,2036,24,68,37,4,33,.892,3600000,0
22591,4469,5,0,0,0,0,.00nan,0,0
22591,10101,24,0,0,0,0,.00nan,0,0
22591,19166,5,35,24,5,19,.792,3592000,0
22593,1814,16,0,0,0,0,.00nan,0,0
22593,1840,23,88,28,1,27,.964,3594000,0
22593,14112,16,95,23,0,23,1000,3600000,0
22593,24549,23,0,0,0,0,.00nan,0,0
22595,1634,22,0,0,0,0,.00nan,0,0
22595,4469,5,61,27,3,24,.889,3553000,0
22595,5168,22,82,32,2,30,.938,3600000,0
22595,19166,5,0,0,0,0,.00nan,0,0
22597,2072,8,79,46,5,41,.891,3600000,0
22597,22527,8,0,0,0,0,.00nan,0,0
22597,24295,3,0,0,0,0,.00nan,0,0
22597,26285,3,99,33,1,32,.970,3600000,0
22599,2036,24,0,0,0,0,.00nan,0,0
22599,10101,24,84,34,1,33,.971,3600000,0
22599,25620,25,0,0,0,0,.00nan,0,0
22599,26065,25,61,29,3,26,.897,3548000,0
22601,264,35,42,25,5,20,.800,3600000,0
22601,17544,20,0,0,0,0,.00nan,0,0
22601,25490,35,0,0,0,0,.00nan,0,0
22601,30236,20,100,42,0,42,1000,3600000,0
22603,1931,30,0,0,0,0,.00nan,0,0
22603,3644,4182,86,23,1,22,.957,3900000,0
22603,4851,30,98,38,1,37,.974,3900000,0
22603,25302,4182,0,0,0,0,.00nan,0,0
22605,546,19,52,42,6,36,.857,3600000,0
22605,14638,29,70,27,1,26,.963,3600000,0
22605,17790,29,0,0,0,0,.00nan,0,0
22605,29239,19,0,0,0,0,.00nan,0,0
22607,1078,0,36,18,4,14,.778,3600000,0
22607,24605,21,0,0,0,0,.00nan,0,0
22607,26535,21,35,28,5,23,.821,3600000,0
22607,29152,0,0,0,0,0,.00nan,0,0
22609,2308,17,99,32,1,31,.969,3600000,0
22609,2440,15,0,0,0,0,.00nan,0,0
22609,4127,15,27,29,6,23,.793,3600000,0
22609,31925,17,0,0,0,0,.00nan,0,0
22611,740,27,36,27,5,22,.815,3600000,0
22611,20012,27,0,0,0,0,.00nan,0,0
22611,20741,11,0,0,0,0,.00nan,0,0
22611,32637,11,33,39,7,32,.821,3567000,0
22613,1840,23,0,0,0,0,.00nan,0,0
22613,5031,18,0,0,0,0,.00nan,0,0
22613,24549,23,64,30,3,27,.900,3600000,0
22613,29089,18,96,19,0,19,1000,3600000,0
22615,1814,16,0,0,0,0,.00nan,0,0
22615,4524,33,88,38,2,36,.947,3600000,0
22615,14112,16,56,43,6,37,.860,3600000,0
22615,15649,33,0,0,0,0,.00nan,0,0
22617,1448,28,88,14,0,14,1000,3600000,0
22617,3304,26,96,52,3,49,.942,3600000,0
22617,13881,28,0,0,0,0,.00nan,0,0
22617,29746,26,0,0,0,0,.00nan,0,0
22619,752,32,0,0,0,0,.00nan,0,0
22619,15159,9,94,21,0,21,1000,3600000,0
22619,15180,32,92,40,1,39,.975,3593000,0
22619,20145,9,0,0,0,0,.00nan,0,0
22621,65,31,100,32,0,32,1000,3600000,0
22621,3643,34,67,28,3,25,.893,3600000,0
22621,13675,34,0,0,0,0,.00nan,0,0
22621,32612,31,0,0,0,0,.00nan,0,0
22623,2210,12,50,1,0,1,1000,821000,0
22623,8073,14,0,0,0,0,.00nan,0,0
22623,24359,14,70,34,3,31,.912,3600000,0
22623,32602,12,21,21,6,15,.714,2779000,0
22625,1593,4838,0,0,0,0,.00nan,0,0
22625,8126,10,30,25,5,20,.800,3600000,0
22625,17566,10,0,0,0,0,.00nan,0,0
22625,22120,4838,84,28,1,27,.964,3600000,0
22627,1814,16,56,26,3,23,.885,3600000,0
22627,14112,16,0,0,0,0,.00nan,0,0
22627,17544,20,0,0,0,0,.00nan,0,0
22627,30236,20,51,29,4,25,.862,3559000,0
22629,752,32,0,0,0,0,.00nan,0,0
22629,2072,8,71,32,3,29,.906,3565000,0
22629,15180,32,93,32,1,31,.969,3600000,0
22629,22527,8,0,0,0,0,.00nan,0,0
22631,65,31,49,32,5,27,.844,3600000,0
22631,8126,10,0,0,0,0,.00nan,0,0
22631,17566,10,87,23,1,22,.957,3600000,0
22631,32612,31,0,0,0,0,.00nan,0,0
22633,4469,5,81,33,2,31,.939,3600000,0
22633,5031,18,0,0,0,0,.00nan,0,0
22633,19166,5,0,0,0,0,.00nan,0,0
22633,29089,18,60,24,3,21,.875,3600000,0
22635,3644,4182,0,0,0,0,.00nan,0,0
22635,25302,4182,83,31,2,29,.935,3600000,0
22635,25620,25,0,0,0,0,.00nan,0,0
22635,26065,25,57,33,4,29,.879,3544000,0
22637,15159,9,18,10,4,6,.600,1159000,0
22637,20145,9,69,28,2,26,.929,2441000,0
22637,24605,21,0,0,0,0,.00nan,0,0
22637,26535,21,63,22,2,20,.909,3600000,0
22639,264,35,0,0,0,0,.00nan,0,0
22639,1634,22,63,29,3,26,.897,3600000,0
22639,5168,22,0,0,0,0,.00nan,0,0
22639,25490,35,28,30,6,24,.800,3600000,0
22641,1931,30,54,30,4,26,.867,3600000,0
22641,4851,30,0,0,0,0,.00nan,0,0
22641,20741,11,65,30,3,27,.900,3600000,0
22641,32637,11,0,0,0,0,.00nan,0,0
22643,3643,34,41,32,6,26,.813,2224050,0
22643,13675,34,59,12,1,11,.917,1375950,0
22643,24295,3,0,0,0,0,.00nan,0,0
22643,26285,3,78,30,3,27,.900,3600000,0
22645,1593,4838,95,27,1,26,.963,3900000,0
22645,2036,24,75,33,1,32,.970,3900000,0
22645,10101,24,0,0,0,0,.00nan,0,0
22645,22120,4838,0,0,0,0,.00nan,0,0
22647,1078,0,25,23,5,18,.783,2195000,0
22647,1840,23,0,0,0,0,.00nan,0,0
22647,24549,23,84,27,1,26,.963,3600000,0
22647,29152,0,96,29,1,28,.966,1405000,0
22649,2210,12,0,0,0,0,.00nan,0,0
22649,8073,14,0,0,0,0,.00nan,0,0
22649,24359,14,84,32,3,29,.906,3900000,0
22649,32602,12,58,25,3,22,.880,3900000,0
22651,4524,33,83,22,1,21,.955,3600000,0
22651,14638,29,0,0,0,0,.00nan,0,0
22651,15649,33,0,0,0,0,.00nan,0,0
22651,17790,29,58,32,4,28,.875,3600000,0
22653,740,27,98,47,1,46,.979,3900000,0
22653,2440,15,81,23,1,22,.957,3900000,0
22653,4127,15,0,0,0,0,.00nan,0,0
22653,20012,27,0,0,0,0,.00nan,0,0
22655,546,19,57,21,2,19,.905,3600000,0
22655,2308,17,63,38,4,34,.895,3329000,0
22655,29239,19,0,0,0,0,.00nan,0,0
22655,31925,17,45,4,1,3,.750,271000,0
22657,1448,28,60,25,3,22,.880,3600000,0
22657,3304,26,0,0,0,0,.00nan,0,0
22657,13881,28,0,0,0,0,.00nan,0,0
22657,29746,26,42,22,4,18,.818,3543000,0
22659,264,35,0,0,0,0,.00nan,0,0
22659,2210,12,74,29,2,27,.931,3600000,0
22659,25490,35,72,31,3,28,.903,3562000,0
22659,32602,12,0,0,0,0,.00nan,0,0
22661,4469,5,0,0,0,0,.00nan,0,0
22661,19166,5,63,38,4,34,.895,3518000,0
22661,24605,21,75,22,2,20,.909,3600000,0
22661,26535,21,0,0,0,0,.00nan,0,0
22663,1078,0,0,0,0,0,.00nan,0,0
22663,4524,33,67,20,2,18,.900,3600000,0
22663,15649,33,0,0,0,0,.00nan,0,0
22663,29152,0,28,37,7,30,.811,3600000,0
22665,1931,30,71,29,3,26,.897,3600000,0
22665,4851,30,0,0,0,0,.00nan,0,0
22665,25620,25,18,16,5,11,.688,1941000,0
22665,26065,25,61,8,0,8,1000,1618000,0
22667,740,27,47,27,5,22,.815,3600000,0
22667,20012,27,0,0,0,0,.00nan,0,0
22667,20741,11,72,32,2,30,.938,3600000,0
22667,32637,11,0,0,0,0,.00nan,0,0
22669,65,31,58,35,4,31,.886,3741000,0
22669,1634,22,0,0,0,0,.00nan,0,0
22669,5168,22,66,30,3,27,.900,3741000,0
22669,32612,31,0,0,0,0,.00nan,0,0
22671,2308,17,0,0,0,0,.00nan,0,0
22671,3304,26,0,0,0,0,.00nan,0,0
22671,29746,26,72,30,3,27,.900,3564000,0
22671,31925,17,66,19,2,17,.895,3600000,0
22673,3643,34,0,0,0,0,.00nan,0,0
22673,5031,18,51,32,5,27,.844,3900000,0
22673,13675,34,50,39,5,34,.872,3900000,0
22673,29089,18,0,0,0,0,.00nan,0,0
22675,1448,28,0,0,0,0,.00nan,0,0
22675,13881,28,71,24,2,22,.917,3600000,0
22675,17544,20,78,44,4,40,.909,3586000,0
22675,30236,20,0,0,0,0,.00nan,0,0
22677,1593,4838,60,23,2,21,.913,3900000,0
22677,2036,24,0,0,0,0,.00nan,0,0
22677,10101,24,86,35,2,33,.943,3900000,0
22677,22120,4838,0,0,0,0,.00nan,0,0
22679,752,32,0,0,0,0,.00nan,0,0
22679,8073,14,95,45,2,43,.956,3900000,0
22679,15180,32,71,24,2,22,.917,3900000,0
22679,24359,14,0,0,0,0,.00nan,0,0
22681,2072,8,0,0,0,0,.00nan,0,0
22681,22527,8,90,26,1,25,.962,3600000,0
22681,24295,3,0,0,0,0,.00nan,0,0
22681,26285,3,64,38,5,33,.868,3600000,0
22683,1840,23,0,0,0,0,.00nan,0,0
22683,8126,10,0,0,0,0,.00nan,0,0
22683,17566,10,79,42,4,38,.905,3560000,0
22683,24549,23,61,28,3,25,.893,3600000,0
22685,2440,15,65,24,3,21,.875,3621000,0
22685,4127,15,0,0,0,0,.00nan,0,0
22685,14638,29,0,0,0,0,.00nan,0,0
22685,17790,29,70,28,2,26,.929,3621000,0
22687,1814,16,0,0,0,0,.00nan,0,0
22687,3644,4182,86,44,3,41,.932,3600000,0
22687,14112,16,71,36,4,32,.889,3571000,0
22687,25302,4182,0,0,0,0,.00nan,0,0
22689,546,19,0,0,0,0,.00nan,0,0
22689,15159,9,0,0,0,0,.00nan,0,0
22689,20145,9,92,44,3,41,.932,3900000,0
22689,29239,19,63,27,3,24,.889,3878000,0
22691,546,19,81,27,2,25,.926,3600000,0
22691,1078,0,58,35,4,31,.886,3600000,0
22691,29152,0,0,0,0,0,.00nan,0,0
22691,29239,19,0,0,0,0,.00nan,0,0
22693,3644,4182,0,0,0,0,.00nan,0,0
22693,24605,21,0,0,0,0,.00nan,0,0
22693,25302,4182,86,26,1,25,.962,3600000,0
22693,26535,21,82,34,2,32,.941,3600000,0
22695,8126,10,70,29,4,25,.862,3654000,0
22695,14638,29,57,27,3,24,.889,3650000,0
22695,17566,10,0,0,0,0,.00nan,0,0
22695,17790,29,0,0,0,0,.00nan,0,0
22697,65,31,0,0,0,0,.00nan,0,0
22697,1814,16,55,46,6,40,.870,3600000,0
22697,14112,16,0,0,0,0,.00nan,0,0
22697,32612,31,83,32,2,30,.938,3600000,0
22699,24295,3,0,0,0,0,.00nan,0,0
22699,25620,25,0,0,0,0,.00nan,0,0
22699,26065,25,80,53,6,47,.887,3587250,0
22699,26285,3,60,34,5,29,.853,3600000,0
22701,740,27,0,0,0,0,.00nan,0,0
22701,8073,14,0,0,0,0,.00nan,0,0
22701,20012,27,82,26,1,25,.962,3600000,0
22701,24359,14,74,27,3,24,.889,3600000,0
22703,2210,12,0,0,0,0,.00nan,0,0
22703,15159,9,67,23,2,21,.913,3600000,0
22703,20145,9,0,0,0,0,.00nan,0,0
22703,32602,12,49,31,4,27,.871,3600000,0
22705,752,32,94,34,1,33,.971,3889000,0
22705,2440,15,0,0,0,0,.00nan,0,0
22705,4127,15,69,23,2,21,.913,3889000,0
22705,15180,32,0,0,0,0,.00nan,0,0
22707,1634,22,76,42,3,39,.929,3589000,0
22707,2036,24,71,22,1,21,.955,3600000,0
22707,5168,22,0,0,0,0,.00nan,0,0
22707,10101,24,0,0,0,0,.00nan,0,0
22709,1593,4838,0,0,0,0,.00nan,0,0
22709,2308,17,63,24,2,22,.917,3600000,0
22709,22120,4838,43,28,5,23,.821,3600000,0
22709,25529,17,0,0,0,0,.00nan,0,0
22711,264,35,49,18,3,15,.833,3703000,0
22711,3304,26,77,32,2,30,.938,3703000,0
22711,25490,35,0,0,0,0,.00nan,0,0
22711,29746,26,0,0,0,0,.00nan,0,0
22713,1931,30,0,0,0,0,.00nan,0,0
22713,4851,30,96,32,1,31,.969,3600000,0
22713,17544,20,0,0,0,0,.00nan,0,0
22713,30236,20,90,37,2,35,.946,3545000,0
22715,5031,18,0,0,0,0,.00nan,0,0
22715,20741,11,0,0,0,0,.00nan,0,0
22715,29089,18,38,12,3,9,.750,3591000,0
22715,32637,11,91,31,1,30,.968,3600000,0
22717,3643,34,57,17,2,15,.882,3600000,0
22717,4524,33,0,0,0,0,.00nan,0,0
22717,13675,34,0,0,0,0,.00nan,0,0
22717,15649,33,59,44,5,39,.886,3600000,0
22719,1448,28,56,26,3,23,.885,3585000,0
22719,2072,8,93,36,1,35,.972,3600000,0
22719,13881,28,0,0,0,0,.00nan,0,0
22719,22527,8,0,0,0,0,.00nan,0,0
22721,1840,23,62,23,3,20,.870,3600000,0
22721,4469,5,51,40,6,34,.850,3600000,0
22721,19166,5,0,0,0,0,.00nan,0,0
22721,24549,23,0,0,0,0,.00nan,0,0
22722,2822,43,69,19,1,18,.947,3600000,0
22722,7567,36,78,34,3,31,.912,3559000,0
22722,22499,36,0,0,0,0,.00nan,0,0
22722,34064,43,0,0,0,0,.00nan,0,0
22723,29955,41,81,32,2,30,.938,3600000,0
22723,34047,41,0,0,0,0,.00nan,0,0
22723,34616,53,0,0,0,0,.00nan,0,0
22723,45055,53,52,40,5,35,.875,3600000,0
22724,6875,52,88,36,2,34,.944,3600000,0
22724,23890,52,0,0,0,0,.00nan,0,0
22724,39136,38,0,0,0,0,.00nan,0,0
22724,52427,38,72,32,3,29,.906,3591000,0
22725,21710,44,57,31,4,27,.871,3600000,0
22725,29650,44,0,0,0,0,.00nan,0,0
22725,34310,42,0,0,0,0,.00nan,0,0
22725,34971,42,77,27,1,26,.963,3600000,0
22726,3290,51,0,0,0,0,.00nan,0,0
22726,6109,56,0,0,0,0,.00nan,0,0
22726,31610,56,57,26,3,23,.885,3600000,0
22726,44923,51,49,24,4,20,.833,3600000,0
22727,25529,39,0,0,0,0,.00nan,0,0
22727,30090,63,75,48,5,43,.896,3600000,0
22727,43424,39,61,31,4,27,.871,3600000,0
22727,45061,63,0,0,0,0,.00nan,0,0
22728,3290,51,71,31,3,28,.903,3600000,0
22728,6109,56,40,24,4,20,.833,3560000,0
22728,31610,56,0,0,0,0,.00nan,0,0
22728,44923,51,0,0,0,0,.00nan,0,0
22729,5212,57,61,15,1,14,.933,3600000,0
22729,29243,57,0,0,0,0,.00nan,0,0
22729,34616,53,88,49,4,45,.918,3600000,0
22729,45055,53,0,0,0,0,.00nan,0,0
22730,4121,59,80,26,1,25,.962,3600000,0
22730,5329,55,83,34,2,32,.941,3600000,0
22730,18610,59,0,0,0,0,.00nan,0,0
22730,63494,55,0,0,0,0,.00nan,0,0
22731,501,48,99,40,1,39,.975,3600000,0
22731,5911,37,0,0,0,0,.00nan,0,0
22731,32559,37,67,26,2,24,.923,3581000,0
22731,36238,48,0,0,0,0,.00nan,0,0
22732,21710,44,0,0,0,0,.00nan,0,0
22732,33404,44,58,28,4,24,.857,3677000,0
22732,34310,42,48,30,5,25,.833,3677000,0
22732,34971,42,0,0,0,0,.00nan,0,0
22733,25529,39,67,25,2,23,.920,3600000,0
22733,30090,63,36,35,7,28,.800,2999000,0
22733,43424,39,0,0,0,0,.00nan,0,0
22733,45061,63,59,7,0,7,1000,601000,0
22734,14359,58,0,0,0,0,.00nan,0,0
22734,30278,65,0,0,0,0,.00nan,0,0
22734,35806,65,98,26,0,26,1000,3600000,0
22734,35891,58,78,34,2,32,.941,3565000,0
22735,740,60,0,0,0,0,.00nan,0,0
22735,6603,62,76,29,3,26,.897,3900000,0
22735,17547,62,0,0,0,0,.00nan,0,0
22735,33315,60,77,35,3,32,.914,3900000,0
22736,6875,52,0,0,0,0,.00nan,0,0
22736,23890,52,42,27,5,22,.815,3534000,0
22736,39136,38,63,36,3,33,.917,3600000,0
22736,52427,38,0,0,0,0,.00nan,0,0
22737,2822,43,0,0,0,0,.00nan,0,0
22737,7567,36,0,0,0,0,.00nan,0,0
22737,22499,36,67,32,4,28,.875,3522000,0
22737,34064,43,65,25,2,23,.920,3600000,0
22738,3,50,0,0,0,0,.00nan,0,0
22738,15212,46,83,20,0,20,1000,3600000,0
22738,17638,50,88,56,5,51,.911,3600000,0
22738,34603,46,0,0,0,0,.00nan,0,0
22739,740,60,35,32,6,26,.813,3600000,0
22739,6603,62,0,0,0,0,.00nan,0,0
22739,17547,62,52,28,4,24,.857,3600000,0
22739,33315,60,0,0,0,0,.00nan,0,0
22740,4738,4619,0,0,0,0,.00nan,0,0
22740,11637,40,80,37,2,35,.946,3600000,0
22740,14142,40,0,0,0,0,.00nan,0,0
22740,16886,4619,93,39,1,38,.974,3600000,0
22741,501,48,85,35,2,33,.943,3600000,0
22741,5911,37,24,21,5,16,.762,3600000,0
22741,32559,37,0,0,0,0,.00nan,0,0
22741,36238,48,0,0,0,0,.00nan,0,0
22742,4466,54,53,20,2,18,.900,3600000,0
22742,12439,61,0,0,0,0,.00nan,0,0
22742,18670,54,0,0,0,0,.00nan,0,0
22742,54249,61,61,39,5,34,.872,3600000,0
22743,5212,57,0,0,0,0,.00nan,0,0
22743,29243,57,54,26,3,23,.885,3600000,0
22743,29955,41,55,35,5,30,.857,3600000,0
22743,34047,41,0,0,0,0,.00nan,0,0
22744,4121,59,0,0,0,0,.00nan,0,0
22744,14359,58,82,32,2,30,.938,3600000,0
22744,18610,59,75,34,3,31,.912,3592000,0
22744,35891,58,0,0,0,0,.00nan,0,0
22745,4454,49,0,0,0,0,.00nan,0,0
22745,8247,49,78,32,2,30,.938,3600000,0
22745,31624,47,57,25,3,22,.880,3600000,0
22745,54787,47,0,0,0,0,.00nan,0,0
22746,3,50,80,54,5,49,.907,3900000,0
22746,15212,46,0,0,0,0,.00nan,0,0
22746,17638,50,0,0,0,0,.00nan,0,0
22746,34603,46,41,27,5,22,.815,3893000,0
22747,1262,4837,70,21,1,20,.952,3600000,0
22747,2339,4837,0,0,0,0,.00nan,0,0
22747,4738,4619,53,36,4,32,.889,3600000,0
22747,16886,4619,0,0,0,0,.00nan,0,0
22748,4466,54,0,0,0,0,.00nan,0,0
22748,12439,61,64,39,4,35,.897,3600000,0
22748,18670,54,81,25,1,24,.960,3600000,0
22748,54249,61,0,0,0,0,.00nan,0,0
22749,5017,64,0,0,0,0,.00nan,0,0
22749,10101,64,61,35,4,31,.886,3600000,0
22749,34440,45,0,0,0,0,.00nan,0,0
22749,66184,45,41,38,6,32,.842,3513000,0
22750,5329,55,0,0,0,0,.00nan,0,0
22750,30278,65,0,0,0,0,.00nan,0,0
22750,32586,55,97,34,1,33,.971,3600000,0
22750,35806,65,50,24,3,21,.875,3577000,0
22751,1262,4837,0,0,0,0,.00nan,0,0
22751,2339,4837,64,28,4,24,.857,3900000,0
22751,11637,40,0,0,0,0,.00nan,0,0
22751,14142,40,74,48,4,44,.917,3900000,0
22752,4454,49,0,0,0,0,.00nan,0,0
22752,8247,49,95,42,2,40,.952,3600000,0
22752,31624,47,54,18,2,16,.889,3055000,0
22752,54787,47,25,12,4,8,.667,545000,0
22753,2822,43,75,38,3,35,.921,3600000,0
22753,3290,51,44,28,4,24,.857,3562000,0
22753,34064,43,0,0,0,0,.00nan,0,0
22753,44923,51,0,0,0,0,.00nan,0,0
22754,34310,42,0,0,0,0,.00nan,0,0
22754,34440,45,38,28,5,23,.821,3600000,0
22754,34971,42,99,33,1,32,.970,3600000,0
22754,66184,45,0,0,0,0,.00nan,0,0
22755,5212,57,87,41,2,39,.951,3600000,0
22755,6109,56,81,22,1,21,.955,3600000,0
22755,29243,57,0,0,0,0,.00nan,0,0
22755,31610,56,0,0,0,0,.00nan,0,0
22756,740,60,96,40,2,38,.950,3600000,0
22756,11637,40,48,27,4,23,.852,3519000,0
22756,14142,40,0,0,0,0,.00nan,0,0
22756,33315,60,0,0,0,0,.00nan,0,0
22757,740,60,0,0,0,0,.00nan,0,0
22757,1262,4837,49,27,4,23,.852,3739000,0
22757,2339,4837,0,0,0,0,.00nan,0,0
22757,33315,60,65,50,5,45,.900,3739000,0
22758,6109,56,63,25,3,22,.880,3600000,0
22758,30278,65,0,0,0,0,.00nan,0,0
22758,31610,56,0,0,0,0,.00nan,0,0
22758,35806,65,95,29,0,29,1000,3600000,0
22759,3290,51,25,27,6,21,.778,2788000,0
22759,5212,57,60,35,4,31,.886,3600000,0
22759,29243,57,0,0,0,0,.00nan,0,0
22759,44923,51,51,8,1,7,.875,812000,0
22760,2822,43,0,0,0,0,.00nan,0,0
22760,30090,63,66,53,6,47,.887,2780000,0
22760,34064,43,76,24,1,23,.958,3600000,0
22760,45061,63,62,9,0,9,1000,820000,0
22761,29955,41,100,47,2,45,.957,3600000,0
22761,34047,41,0,0,0,0,.00nan,0,0
22761,34616,53,0,0,0,0,.00nan,0,0
22761,45055,53,62,36,4,32,.889,3522000,0
22762,4121,59,0,0,0,0,.00nan,0,0
22762,18610,59,81,23,1,22,.957,3600000,0
22762,39136,38,60,25,2,23,.920,3562000,0
22762,52427,38,0,0,0,0,.00nan,0,0
22763,5329,55,69,39,4,35,.897,3682000,0
22763,25529,39,0,0,0,0,.00nan,0,0
22763,32586,55,0,0,0,0,.00nan,0,0
22763,43424,39,53,38,5,33,.868,3684000,0
22764,14359,58,97,43,1,42,.977,3546000,0
22764,25529,39,90,16,0,16,1000,3600000,0
22764,35891,58,0,0,0,0,.00nan,0,0
22764,43424,39,0,0,0,0,.00nan,0,0
22765,3290,51,0,0,0,0,.00nan,0,0
22765,5212,57,0,0,0,0,.00nan,0,0
22765,29243,57,49,22,3,19,.864,3600000,0
22765,44923,51,54,38,5,33,.868,3587000,0
22766,5329,55,0,0,0,0,.00nan,0,0
22766,29955,41,0,0,0,0,.00nan,0,0
22766,32586,55,74,40,3,37,.925,3900000,0
22766,34047,41,94,37,3,34,.919,3900000,0
22767,6875,52,0,0,0,0,.00nan,0,0
22767,23890,52,85,38,2,36,.947,3600000,0
22767,30278,65,0,0,0,0,.00nan,0,0
22767,35806,65,65,15,1,14,.933,3600000,0
22768,4466,54,82,14,0,14,1000,3600000,0
22768,5911,37,78,38,2,36,.947,3568000,0
22768,18670,54,0,0,0,0,.00nan,0,0
22768,32559,37,0,0,0,0,.00nan,0,0
22769,3,50,22,5,3,2,.400,208000,0
22769,17638,50,97,37,1,36,.973,3392000,0
22769,34440,45,83,26,1,25,.962,3600000,0
22769,66184,45,0,0,0,0,.00nan,0,0
22770,2822,43,87,26,1,25,.962,3745000,0
22770,30090,63,0,0,0,0,.00nan,0,0
22770,34064,43,0,0,0,0,.00nan,0,0
22770,45061,63,88,36,2,34,.944,3745000,0
22771,6109,56,0,0,0,0,.00nan,0,0
22771,31610,56,35,26,5,21,.808,3855000,0
22771,34616,53,53,30,5,25,.833,3900000,0
22771,45055,53,0,0,0,0,.00nan,0,0
22772,4121,59,92,34,1,33,.971,3600000,0
22772,18610,59,0,0,0,0,.00nan,0,0
22772,39136,38,0,0,0,0,.00nan,0,0
22772,52427,38,71,25,2,23,.920,3600000,0
22773,7567,36,61,25,3,22,.880,3600000,0
22773,22499,36,0,0,0,0,.00nan,0,0
22773,34310,42,0,0,0,0,.00nan,0,0
22773,34971,42,55,43,6,37,.860,3600000,0
22774,5073,44,0,0,0,0,.00nan,0,0
22774,11637,40,0,0,0,0,.00nan,0,0
22774,14142,40,55,26,4,22,.846,3900000,0
22774,21710,44,47,26,4,22,.846,3900000,0
22775,4430,49,87,37,3,34,.919,3578000,0
22775,4454,49,0,0,0,0,.00nan,0,0
22775,12439,61,0,0,0,0,.00nan,0,0
22775,54249,61,99,36,1,35,.972,3600000,0
22776,4738,4619,0,0,0,0,.00nan,0,0
22776,16886,4619,73,30,2,28,.933,3528000,0
22776,31624,47,100,32,0,32,1000,3600000,0
22776,38665,47,0,0,0,0,.00nan,0,0
22777,4466,54,84,41,3,38,.927,3879000,0
22777,5911,37,0,0,0,0,.00nan,0,0
22777,18670,54,0,0,0,0,.00nan,0,0
22777,32559,37,84,32,2,30,.938,3879000,0
22778,3,50,47,34,5,29,.853,3900000,0
22778,5017,64,0,0,0,0,.00nan,0,0
22778,10101,64,46,30,5,25,.833,3900000,0
22778,17638,50,0,0,0,0,.00nan,0,0
22779,1262,4837,83,27,1,26,.963,3600000,0
22779,2339,4837,0,0,0,0,.00nan,0,0
22779,6603,62,0,0,0,0,.00nan,0,0
22779,17547,62,94,46,2,44,.957,3542000,0
22780,501,48,82,31,2,29,.935,3900000,0
22780,740,60,87,39,2,37,.949,3900000,0
22780,33315,60,0,0,0,0,.00nan,0,0
22780,36238,48,0,0,0,0,.00nan,0,0
22781,4738,4619,64,30,3,27,.900,3600000,0
22781,16886,4619,0,0,0,0,.00nan,0,0
22781,31624,47,82,45,4,41,.911,3557000,0
22781,38665,47,0,0,0,0,.00nan,0,0
22782,3,50,82,42,3,39,.929,3600000,0
22782,15212,46,0,0,0,0,.00nan,0,0
22782,17638,50,0,0,0,0,.00nan,0,0
22782,34603,46,89,18,0,18,1000,3600000,0
22783,7567,36,0,0,0,0,.00nan,0,0
22783,22499,36,78,25,1,24,.960,3600000,0
22783,34310,42,73,32,2,30,.938,3553000,0
22783,34971,42,0,0,0,0,.00nan,0,0
22784,29955,41,29,9,3,6,.667,447000,0
22784,30278,65,59,33,4,29,.879,3600000,0
22784,34047,41,36,24,5,19,.792,3153000,0
22784,35806,65,0,0,0,0,.00nan,0,0
22785,14359,58,0,0,0,0,.00nan,0,0
22785,25529,39,50,23,3,20,.870,3547000,0
22785,35891,58,79,31,2,29,.935,3600000,0
22785,43424,39,0,0,0,0,.00nan,0,0
22786,6875,52,56,22,2,20,.909,3900000,0
22786,23890,52,0,0,0,0,.00nan,0,0
22786,34616,53,0,0,0,0,.00nan,0,0
22786,45055,53,72,32,2,30,.938,3900000,0
22787,1262,4837,0,0,0,0,.00nan,0,0
22787,2339,4837,98,43,3,40,.930,3600000,0
22787,6603,62,80,25,1,24,.960,3600000,0
22787,17547,62,0,0,0,0,.00nan,0,0
22788,4430,49,0,0,0,0,.00nan,0,0
22788,4454,49,72,24,2,22,.917,3600000,0
22788,12439,61,42,20,4,16,.800,3600000,0
22788,54249,61,0,0,0,0,.00nan,0,0
22789,5073,44,63,22,3,19,.864,3900000,0
22789,11637,40,86,44,3,41,.932,3900000,0
22789,14142,40,0,0,0,0,.00nan,0,0
22789,21710,44,0,0,0,0,.00nan,0,0
22790,501,48,91,26,1,25,.962,3600000,0
22790,740,60,0,0,0,0,.00nan,0,0
22790,33315,60,59,29,3,26,.897,3545000,0
22790,36238,48,0,0,0,0,.00nan,0,0
22791,5017,64,30,20,5,15,.750,1847000,0
22791,10101,64,54,23,3,20,.870,1753000,0
22791,15212,46,55,24,3,21,.875,3600000,0
22791,34603,46,0,0,0,0,.00nan,0,0
23875,15212,46,77,22,1,21,.955,3600000,0
23875,32629,63,0,0,0,0,.00nan,0,0
23875,34603,46,0,0,0,0,.00nan,0,0
23875,45061,63,60,34,4,30,.882,3600000,0
23877,1262,4837,48,35,5,30,.857,3600000,0
23877,2339,4837,0,0,0,0,.00nan,0,0
23877,20575,45,96,34,1,33,.971,3600000,0
23877,34440,45,0,0,0,0,.00nan,0,0
23879,501,48,0,0,0,0,.00nan,0,0
23879,6875,52,0,0,0,0,.00nan,0,0
23879,23890,52,53,35,4,31,.886,3579000,0
23879,36238,48,88,47,3,44,.936,3600000,0
23881,1969,64,0,0,0,0,.00nan,0,0
23881,5017,64,63,40,5,35,.875,3600000,0
23881,31624,47,100,33,0,33,1000,3600000,0
23881,54787,47,0,0,0,0,.00nan,0,0
23883,5911,37,66,24,2,22,.917,3900000,0
23883,29139,38,0,0,0,0,.00nan,0,0
23883,32559,37,0,0,0,0,.00nan,0,0
23883,39136,38,96,38,2,36,.947,3900000,0
23885,34310,42,0,0,0,0,.00nan,0,0
23885,34591,65,98,58,3,55,.948,3600000,0
23885,34971,42,88,25,1,24,.960,3600000,0
23885,35806,65,0,0,0,0,.00nan,0,0
23887,4121,59,0,0,0,0,.00nan,0,0
23887,18610,59,41,22,4,18,.818,3600000,0
23887,34616,53,0,0,0,0,.00nan,0,0
23887,45055,53,81,27,1,26,.963,3600000,0
23889,4454,49,68,25,2,23,.920,3600000,0
23889,7567,36,44,26,4,22,.846,3573000,0
23889,8247,49,0,0,0,0,.00nan,0,0
23889,22499,36,0,0,0,0,.00nan,0,0
23891,4466,54,62,22,3,19,.864,3600000,0
23891,18670,54,0,0,0,0,.00nan,0,0
23891,33315,60,0,0,0,0,.00nan,0,0
23891,41821,60,57,32,4,28,.875,3541000,0
23893,3,50,33,16,4,12,.750,943000,0
23893,5212,57,0,0,0,0,.00nan,0,0
23893,17638,50,98,34,1,33,.971,2657000,0
23893,29243,57,61,14,1,13,.929,3600000,0
23895,2822,43,0,0,0,0,.00nan,0,0
23895,11637,40,0,0,0,0,.00nan,0,0
23895,14142,40,77,27,1,26,.963,3600000,0
23895,34064,43,62,24,2,22,.917,3557000,0
23897,14359,58,0,0,0,0,.00nan,0,0
23897,29955,41,0,0,0,0,.00nan,0,0
23897,34047,41,60,26,2,24,.923,3584000,0
23897,35891,58,71,25,1,24,.960,3600000,0
23899,6109,56,48,39,6,33,.846,3302000,0
23899,6603,62,54,34,5,29,.853,3600000,0
23899,17547,62,0,0,0,0,.00nan,0,0
23899,31610,56,42,3,1,2,.667,272000,0
23901,4738,4619,84,35,2,33,.943,3600000,0
23901,12439,61,54,36,5,31,.861,3600000,0
23901,16886,4619,0,0,0,0,.00nan,0,0
23901,54249,61,0,0,0,0,.00nan,0,0
23903,1503,39,99,46,2,44,.957,3600000,0
23903,5329,55,60,29,3,26,.897,3600000,0
23903,32586,55,0,0,0,0,.00nan,0,0
23903,43424,39,0,0,0,0,.00nan,0,0
23905,3290,51,73,26,1,25,.962,3600000,0
23905,21710,44,0,0,0,0,.00nan,0,0
23905,33404,44,62,30,3,27,.900,3575000,0
23905,44923,51,0,0,0,0,.00nan,0,0
23907,4738,4619,62,10,0,10,1000,1527000,0
23907,6109,56,0,0,0,0,.00nan,0,0
23907,16886,4619,17,19,6,13,.684,2073000,0
23907,31610,56,82,31,2,29,.935,3600000,0
23909,5911,37,0,0,0,0,.00nan,0,0
23909,29139,38,35,29,6,23,.793,3549000,0
23909,32559,37,48,29,5,24,.828,3600000,0
23909,39136,38,0,0,0,0,.00nan,0,0
23911,14359,58,76,23,1,22,.957,3600000,0
23911,34616,53,48,28,4,24,.857,3600000,0
23911,35891,58,0,0,0,0,.00nan,0,0
23911,45055,53,0,0,0,0,.00nan,0,0
23913,3290,51,0,0,0,0,.00nan,0,0
23913,29955,41,69,49,5,44,.898,3600000,0
23913,34047,41,0,0,0,0,.00nan,0,0
23913,44923,51,74,23,1,22,.957,3600000,0
23915,501,48,100,37,0,37,1000,3600000,0
23915,33315,60,55,22,3,19,.864,3600000,0
23915,36238,48,0,0,0,0,.00nan,0,0
23915,41821,60,0,0,0,0,.00nan,0,0
23917,1503,39,0,0,0,0,.00nan,0,0
23917,4121,59,69,42,3,39,.929,3600000,0
23917,18610,59,0,0,0,0,.00nan,0,0
23917,43424,39,69,37,4,33,.892,3596000,0
23919,6875,52,51,35,5,30,.857,3600000,0
23919,21710,44,88,30,1,29,.967,3600000,0
23919,23890,52,0,0,0,0,.00nan,0,0
23919,33404,44,0,0,0,0,.00nan,0,0
23921,34310,42,91,30,1,29,.967,3600000,0
23921,34591,65,0,0,0,0,.00nan,0,0
23921,34971,42,0,0,0,0,.00nan,0,0
23921,35806,65,54,38,5,33,.868,3600000,0
23923,4454,49,0,0,0,0,.00nan,0,0
23923,8247,49,63,30,4,26,.867,3600000,0
23923,31624,47,64,47,5,42,.894,3591000,0
23923,54787,47,0,0,0,0,.00nan,0,0
23925,1262,4837,0,0,0,0,.00nan,0,0
23925,2339,4837,66,21,3,18,.857,3900000,0
23925,7567,36,0,0,0,0,.00nan,0,0
23925,22499,36,83,36,3,33,.917,3900000,0
23927,11637,40,97,23,0,23,1000,3600000,0
23927,14142,40,0,0,0,0,.00nan,0,0
23927,20575,45,0,0,0,0,.00nan,0,0
23927,34440,45,65,32,3,29,.906,3600000,0
23929,5212,57,71,26,1,25,.962,3600000,0
23929,15212,46,0,0,0,0,.00nan,0,0
23929,29243,57,0,0,0,0,.00nan,0,0
23929,34603,46,83,36,2,34,.944,3588000,0
23931,3,50,82,40,3,37,.925,3625000,0
23931,5329,55,0,0,0,0,.00nan,0,0
23931,17638,50,0,0,0,0,.00nan,0,0
23931,32586,55,69,23,2,21,.913,3625000,0
23933,2822,43,50,25,4,21,.840,3600000,0
23933,6603,62,0,0,0,0,.00nan,0,0
23933,17547,62,52,44,6,38,.864,3534000,0
23933,34064,43,0,0,0,0,.00nan,0,0
23935,4466,54,0,0,0,0,.00nan,0,0
23935,18670,54,96,32,2,30,.938,3600000,0
23935,32629,63,44,43,7,36,.837,3233000,0
23935,45061,63,55,4,0,4,1000,367000,0
23937,1969,64,84,42,3,39,.929,3900000,0
23937,5017,64,0,0,0,0,.00nan,0,0
23937,12439,61,0,0,0,0,.00nan,0,0
23937,54249,61,71,28,3,25,.893,3900000,0
23939,4466,54,0,0,0,0,.00nan,0,0
23939,18670,54,79,29,2,27,.931,3600000,0
23939,34310,42,0,0,0,0,.00nan,0,0
23939,34971,42,52,26,3,23,.885,3588000,0
23941,4121,59,0,0,0,0,.00nan,0,0
23941,4738,4619,98,43,2,41,.953,3600000,0
23941,16886,4619,0,0,0,0,.00nan,0,0
23941,18610,59,62,39,4,35,.897,3514000,0
23943,7567,36,0,0,0,0,.00nan,0,0
23943,14359,58,48,23,5,18,.783,2970000,0
23943,22499,36,78,28,2,26,.929,3600000,0
23943,35891,58,52,5,0,5,1000,630000,0
23945,3,50,60,20,2,18,.900,3600000,0
23945,17638,50,0,0,0,0,.00nan,0,0
23945,30090,63,0,0,0,0,.00nan,0,0
23945,45061,63,76,41,3,38,.927,3600000,0
23947,1503,39,0,0,0,0,.00nan,0,0
23947,21710,44,0,0,0,0,.00nan,0,0
23947,33404,44,53,23,3,20,.870,3549000,0
23947,43424,39,82,28,2,26,.929,3600000,0
23949,29955,41,56,32,4,28,.875,3600000,0
23949,34047,41,0,0,0,0,.00nan,0,0
23949,39136,38,0,0,0,0,.00nan,0,0
23949,52427,38,90,28,1,27,.964,3600000,0
23951,5329,55,100,26,0,26,1000,3600000,0
23951,5911,37,0,0,0,0,.00nan,0,0
23951,32559,37,86,40,3,37,.925,3600000,0
23951,32586,55,0,0,0,0,.00nan,0,0
23953,6875,52,0,0,0,0,.00nan,0,0
23953,23890,52,57,18,2,16,.889,3600000,0
23953,34616,53,0,0,0,0,.00nan,0,0
23953,45055,53,32,40,7,33,.825,3600000,0
23955,6109,56,0,0,0,0,.00nan,0,0
23955,31610,56,91,47,3,44,.936,3900000,0
23955,34591,65,69,27,3,24,.889,3900000,0
23955,35806,65,0,0,0,0,.00nan,0,0
23957,501,48,67,44,5,39,.886,3576000,0
23957,3290,51,0,0,0,0,.00nan,0,0
23957,36238,48,0,0,0,0,.00nan,0,0
23957,44923,51,31,14,4,10,.714,3600000,0
23959,4454,49,0,0,0,0,.00nan,0,0
23959,8247,49,45,39,6,33,.846,3600000,0
23959,20575,45,0,0,0,0,.00nan,0,0
23959,34440,45,72,26,2,24,.923,3600000,0
23961,2822,43,0,0,0,0,.00nan,0,0
23961,5212,57,37,22,4,18,.818,3570000,0
23961,29243,57,0,0,0,0,.00nan,0,0
23961,34064,43,77,39,3,36,.923,3600000,0
23963,1262,4837,68,25,2,23,.920,3600000,0
23963,2339,4837,0,0,0,0,.00nan,0,0
23963,11637,40,66,34,3,31,.912,3600000,0
23963,14142,40,0,0,0,0,.00nan,0,0
23965,6603,62,0,0,0,0,.00nan,0,0
23965,17547,62,53,22,3,19,.864,3548000,0
23965,33315,60,87,31,1,30,.968,3600000,0
23965,41821,60,0,0,0,0,.00nan,0,0
23967,1969,64,0,0,0,0,.00nan,0,0
23967,5017,64,55,31,5,26,.839,3600000,0
23967,31624,47,0,0,0,0,.00nan,0,0
23967,54787,47,80,33,2,31,.939,3600000,0
23969,12439,61,0,0,0,0,.00nan,0,0
23969,15212,46,69,21,1,20,.952,3600000,0
23969,34603,46,0,0,0,0,.00nan,0,0
23969,54249,61,73,42,5,37,.881,3600000,0
23971,11637,40,0,0,0,0,.00nan,0,0
23971,14142,40,52,38,5,33,.868,3900000,0
23971,34591,65,0,0,0,0,.00nan,0,0
23971,35806,65,34,24,5,19,.792,3900000,0
23973,2822,43,0,0,0,0,.00nan,0,0
23973,15212,46,0,0,0,0,.00nan,0,0
23973,34064,43,77,24,1,23,.958,3600000,0
23973,34603,46,73,35,3,32,.914,3530000,0
23975,4454,49,0,0,0,0,.00nan,0,0
23975,8247,49,77,35,3,32,.914,3600000,0
23975,30090,63,79,53,5,48,.906,3558000,0
23975,45061,63,0,0,0,0,.00nan,0,0
23977,7567,36,0,0,0,0,.00nan,0,0
23977,14359,58,0,0,0,0,.00nan,0,0
23977,22499,36,94,23,0,23,1000,3600000,0
23977,35891,58,65,31,3,28,.903,3600000,0
23979,6603,62,89,28,1,27,.964,3600000,0
23979,17547,62,0,0,0,0,.00nan,0,0
23979,21710,44,45,28,4,24,.857,3600000,0
23979,33404,44,0,0,0,0,.00nan,0,0
23981,4466,54,70,27,3,24,.889,3867000,0
23981,18670,54,0,0,0,0,.00nan,0,0
23981,39136,38,100,48,2,46,.958,3867000,0
23981,52427,38,0,0,0,0,.00nan,0,0
23983,4121,59,66,30,3,27,.900,3544000,0
23983,4738,4619,73,28,2,26,.929,3600000,0
23983,16886,4619,0,0,0,0,.00nan,0,0
23983,18610,59,0,0,0,0,.00nan,0,0
23985,12439,61,0,0,0,0,.00nan,0,0
23985,34310,42,62,29,3,26,.897,3582000,0
23985,34971,42,0,0,0,0,.00nan,0,0
23985,54249,61,85,36,1,35,.972,3600000,0
23987,5017,64,0,0,0,0,.00nan,0,0
23987,10101,64,81,36,2,34,.944,3600000,0
23987,20575,45,58,35,4,31,.886,3511000,0
23987,34440,45,0,0,0,0,.00nan,0,0
23989,1503,39,82,32,2,30,.938,3642000,0
23989,5212,57,0,0,0,0,.00nan,0,0
23989,29243,57,70,33,3,30,.909,3642000,0
23989,43424,39,0,0,0,0,.00nan,0,0
23991,5911,37,60,33,3,30,.909,3900000,0
23991,31624,47,72,31,3,28,.903,3900000,0
23991,32559,37,0,0,0,0,.00nan,0,0
23991,54787,47,0,0,0,0,.00nan,0,0
23993,6109,56,92,45,3,42,.933,3600000,0
23993,6875,52,73,18,1,17,.944,3600000,0
23993,23890,52,0,0,0,0,.00nan,0,0
23993,31610,56,0,0,0,0,.00nan,0,0
23995,3290,51,50,24,3,21,.875,3600000,0
23995,5329,55,47,31,5,26,.839,3527000,0
23995,32586,55,0,0,0,0,.00nan,0,0
23995,44923,51,0,0,0,0,.00nan,0,0
23997,501,48,0,0,0,0,.00nan,0,0
23997,34616,53,0,0,0,0,.00nan,0,0
23997,36238,48,99,38,1,37,.974,3600000,0
23997,45055,53,56,27,3,24,.889,3523000,0
23999,740,60,0,0,0,0,.00nan,0,0
23999,29955,41,29,31,6,25,.806,2537000,0
23999,34047,41,59,15,1,14,.933,1063000,0
23999,41821,60,54,31,4,27,.871,3600000,0
24001,3,50,0,0,0,0,.00nan,0,0
24001,1262,4837,52,20,3,17,.850,3600000,0
24001,2339,4837,0,0,0,0,.00nan,0,0
24001,17638,50,47,27,4,23,.852,3575000,0
24003,6603,62,0,0,0,0,.00nan,0,0
24003,17547,62,73,33,2,31,.939,3600000,0
24003,29955,41,0,0,0,0,.00nan,0,0
24003,34047,41,74,35,4,31,.886,3600000,0
24005,501,48,60,19,2,17,.895,3600000,0
24005,14359,58,56,30,3,27,.900,3553000,0
24005,35891,58,0,0,0,0,.00nan,0,0
24005,36238,48,0,0,0,0,.00nan,0,0
24007,740,60,45,28,5,23,.821,3600000,0
24007,4121,59,0,0,0,0,.00nan,0,0
24007,18610,59,90,33,2,31,.939,3600000,0
24007,41821,60,0,0,0,0,.00nan,0,0
24009,1262,4837,0,0,0,0,.00nan,0,0
24009,2339,4837,43,35,6,29,.829,3600000,0
24009,6875,52,0,0,0,0,.00nan,0,0
24009,23890,52,100,29,0,29,1000,3600000,0
24011,4454,49,47,27,4,23,.852,3532000,0
24011,5911,37,0,0,0,0,.00nan,0,0
24011,8247,49,0,0,0,0,.00nan,0,0
24011,32559,37,68,29,2,27,.931,3600000,0
24013,12439,61,39,28,5,23,.821,3600000,0
24013,30090,63,0,0,0,0,.00nan,0,0
24013,45061,63,88,54,4,50,.926,3600000,0
24013,54249,61,0,0,0,0,.00nan,0,0
24015,4466,54,0,0,0,0,.00nan,0,0
24015,15212,46,94,35,1,34,.971,3900000,0
24015,18670,54,94,29,1,28,.966,3900000,0
24015,34603,46,0,0,0,0,.00nan,0,0
24017,5329,55,0,0,0,0,.00nan,0,0
24017,20575,45,0,0,0,0,.00nan,0,0
24017,32586,55,37,33,6,27,.818,3600000,0
24017,34440,45,82,26,1,25,.962,3600000,0
24019,2822,43,73,36,3,33,.917,3900000,0
24019,34064,43,0,0,0,0,.00nan,0,0
24019,34310,42,0,0,0,0,.00nan,0,0
24019,34971,42,74,32,3,29,.906,3884000,0
24021,1503,39,0,0,0,0,.00nan,0,0
24021,6109,56,0,0,0,0,.00nan,0,0
24021,31610,56,92,20,0,20,1000,3600000,0
24021,43424,39,74,29,2,27,.931,3530000,0
24023,3,50,93,24,1,23,.958,3600000,0
24023,7567,36,72,26,1,25,.962,2518000,0
24023,17638,50,0,0,0,0,.00nan,0,0
24023,22499,36,11,19,6,13,.684,1082000,0
24025,21710,44,0,0,0,0,.00nan,0,0
24025,33404,44,34,15,4,11,.733,3600000,0
24025,34591,65,65,47,5,42,.894,3576000,0
24025,35806,65,0,0,0,0,.00nan,0,0
24027,5017,64,73,27,2,25,.926,3600000,0
24027,10101,64,0,0,0,0,.00nan,0,0
24027,31624,47,0,0,0,0,.00nan,0,0
24027,54787,47,54,29,3,26,.897,3547000,0
24029,4738,4619,0,0,0,0,.00nan,0,0
24029,16886,4619,48,21,3,18,.857,3600000,0
24029,34616,53,61,47,5,42,.894,3515000,0
24029,45055,53,0,0,0,0,.00nan,0,0
24031,3290,51,0,0,0,0,.00nan,0,0
24031,39136,38,0,0,0,0,.00nan,0,0
24031,44923,51,52,24,3,21,.875,3600000,0
24031,52427,38,53,32,5,27,.844,3531000,0
24033,5212,57,71,27,2,25,.926,3600000,0
24033,11637,40,55,6,0,6,1000,303000,0
24033,14142,40,47,43,7,36,.837,3297000,0
24033,29243,57,0,0,0,0,.00nan,0,0
24035,1262,4837,0,0,0,0,.00nan,0,0
24035,2339,4837,63,36,4,32,.889,3592000,0
24035,5017,64,0,0,0,0,.00nan,0,0
24035,10101,64,68,38,3,35,.921,3600000,0
24037,6109,56,0,0,0,0,.00nan,0,0
24037,29955,41,61,29,3,26,.897,3557000,0
24037,31610,56,88,32,1,31,.969,3600000,0
24037,34047,41,0,0,0,0,.00nan,0,0
24039,5212,57,69,24,1,23,.958,3900000,0
24039,14359,58,97,41,1,40,.976,3900000,0
24039,29243,57,0,0,0,0,.00nan,0,0
24039,35891,58,0,0,0,0,.00nan,0,0
24041,740,60,71,33,3,30,.909,3578000,0
24041,34616,53,70,27,2,25,.926,3600000,0
24041,41821,60,0,0,0,0,.00nan,0,0
24041,45055,53,0,0,0,0,.00nan,0,0
24043,4121,59,92,35,2,33,.943,3600000,0
24043,4454,49,56,31,3,28,.903,3600000,0
24043,8247,49,0,0,0,0,.00nan,0,0
24043,18610,59,0,0,0,0,.00nan,0,0
24045,4738,4619,81,32,3,29,.906,3549000,0
24045,16886,4619,0,0,0,0,.00nan,0,0
24045,30090,63,76,26,2,24,.923,3600000,0
24045,45061,63,0,0,0,0,.00nan,0,0
24047,6603,62,0,0,0,0,.00nan,0,0
24047,17547,62,59,20,2,18,.900,3600000,0
24047,20575,45,0,0,0,0,.00nan,0,0
24047,34440,45,95,33,1,32,.970,3600000,0
24049,5329,55,0,0,0,0,.00nan,0,0
24049,11637,40,82,33,2,31,.939,3600000,0
24049,14142,40,0,0,0,0,.00nan,0,0
24049,32586,55,74,35,3,32,.914,3544000,0
24051,3290,51,0,0,0,0,.00nan,0,0
24051,7567,36,66,44,5,39,.886,3600000,0
24051,22499,36,0,0,0,0,.00nan,0,0
24051,44923,51,90,28,1,27,.964,3600000,0
24053,12786,48,0,0,0,0,.00nan,0,0
24053,34310,42,87,33,1,32,.970,3600000,0
24053,34971,42,0,0,0,0,.00nan,0,0
24053,36238,48,67,33,3,30,.909,3527000,0
24055,12439,61,0,0,0,0,.00nan,0,0
24055,39136,38,94,42,2,40,.952,3600000,0
24055,52427,38,0,0,0,0,.00nan,0,0
24055,54249,61,58,26,3,23,.885,3563000,0
24057,5911,37,26,22,5,17,.773,3591000,0
24057,32559,37,0,0,0,0,.00nan,0,0
24057,34591,65,84,40,3,37,.925,3600000,0
24057,35806,65,0,0,0,0,.00nan,0,0
24059,2822,43,0,0,0,0,.00nan,0,0
24059,15212,46,0,0,0,0,.00nan,0,0
24059,34064,43,16,23,6,17,.739,3600000,0
24059,34603,46,89,35,2,33,.943,3600000,0
24061,3,50,75,32,2,30,.938,3600000,0
24061,17638,50,0,0,0,0,.00nan,0,0
24061,31624,47,48,27,4,23,.852,3561000,0
24061,54787,47,0,0,0,0,.00nan,0,0
24063,6875,52,0,0,0,0,.00nan,0,0
24063,23890,52,71,24,2,22,.917,3600000,0
24063,25529,39,0,0,0,0,.00nan,0,0
24063,43424,39,53,26,3,23,.885,3569000,0
24065,4466,54,60,35,4,31,.886,3600000,0
24065,18670,54,0,0,0,0,.00nan,0,0
24065,21710,44,100,30,0,30,1000,3600000,0
24065,33404,44,0,0,0,0,.00nan,0,0
24067,4466,54,0,0,0,0,.00nan,0,0
24067,11637,40,0,0,0,0,.00nan,0,0
24067,14142,40,100,33,0,33,1000,3600000,0
24067,18670,54,73,23,1,22,.957,3600000,0
24069,6603,62,87,29,2,27,.931,3613000,0
24069,17547,62,0,0,0,0,.00nan,0,0
24069,34310,42,0,0,0,0,.00nan,0,0
24069,34971,42,77,41,3,38,.927,3613000,0
24071,4738,4619,0,0,0,0,.00nan,0,0
24071,12786,48,65,30,3,27,.900,3600000,0
24071,16886,4619,53,31,4,27,.871,3592000,0
24071,36238,48,0,0,0,0,.00nan,0,0
24073,30090,63,0,0,0,0,.00nan,0,0
24073,34591,65,0,0,0,0,.00nan,0,0
24073,35806,65,99,36,1,35,.972,3600000,0
24073,45061,63,81,35,2,33,.943,3580000,0
24075,3290,51,37,25,5,20,.800,3571000,0
24075,14359,58,0,0,0,0,.00nan,0,0
24075,35891,58,87,48,4,44,.917,3600000,0
24075,44923,51,0,0,0,0,.00nan,0,0
24077,740,60,0,0,0,0,.00nan,0,0
24077,4121,59,0,0,0,0,.00nan,0,0
24077,18610,59,38,29,5,24,.828,3600000,0
24077,41821,60,97,38,2,36,.947,3600000,0
24079,34616,53,0,0,0,0,.00nan,0,0
24079,39136,38,0,0,0,0,.00nan,0,0
24079,45055,53,84,32,3,29,.906,3600000,0
24079,52427,38,100,27,0,27,1000,3600000,0
24081,5212,57,0,0,0,0,.00nan,0,0
24081,29243,57,65,16,1,15,.938,3600000,0
24081,31624,47,60,14,1,13,.929,1593000,0
24081,54787,47,40,29,5,24,.828,2007000,0
24083,5911,37,0,0,0,0,.00nan,0,0
24083,12439,61,50,25,4,21,.840,3563000,0
24083,32559,37,72,31,3,28,.903,3600000,0
24083,54249,61,0,0,0,0,.00nan,0,0
24085,5017,64,89,34,2,32,.941,3588000,0
24085,6875,52,97,20,0,20,1000,3600000,0
24085,10101,64,0,0,0,0,.00nan,0,0
24085,23890,52,0,0,0,0,.00nan,0,0
24087,7567,36,0,0,0,0,.00nan,0,0
24087,22499,36,76,39,3,36,.923,3600000,0
24087,29955,41,0,0,0,0,.00nan,0,0
24087,34047,41,60,32,4,28,.875,3546000,0
24089,3,50,0,0,0,0,.00nan,0,0
24089,17638,50,98,48,2,46,.958,3900000,0
24089,25529,39,99,39,2,37,.949,3900000,0
24089,43424,39,0,0,0,0,.00nan,0,0
24091,6109,56,43,38,6,32,.842,3600000,0
24091,21710,44,73,23,1,22,.957,3600000,0
24091,31610,56,0,0,0,0,.00nan,0,0
24091,33404,44,0,0,0,0,.00nan,0,0
24093,4454,49,0,0,0,0,.00nan,0,0
24093,8247,49,70,37,3,34,.919,3900000,0
24093,15212,46,61,22,3,19,.864,3900000,0
24093,34603,46,0,0,0,0,.00nan,0,0
24095,1262,4837,52,22,3,19,.864,3600000,0
24095,2339,4837,0,0,0,0,.00nan,0,0
24095,5329,55,67,24,2,22,.917,3600000,0
24095,32586,55,0,0,0,0,.00nan,0,0
24097,2822,43,69,28,3,25,.893,3900000,0
24097,20575,45,80,35,3,32,.914,3900000,0
24097,34064,43,0,0,0,0,.00nan,0,0
24097,34440,45,0,0,0,0,.00nan,0,0
24098,112,745,0,0,0,0,.00nan,0,0
24098,41784,745,99,39,1,38,.974,3746000,0
24098,48404,739,94,45,2,43,.956,3746000,0
24098,48581,739,0,0,0,0,.00nan,0,0
24099,616,748,0,0,0,0,.00nan,0,0
24099,16094,748,56,38,5,33,.868,3895000,0
24099,26904,742,41,24,4,20,.833,3895000,0
24099,48292,742,0,0,0,0,.00nan,0,0
24100,26052,733,37,13,3,10,.769,3585000,0
24100,26145,751,0,0,0,0,.00nan,0,0
24100,26334,751,86,34,2,32,.941,3600000,0
24100,48440,733,0,0,0,0,.00nan,0,0
24101,1818,2168,0,0,0,0,.00nan,0,0
24101,7162,1880,100,28,0,28,1000,3600000,0
24101,17409,2168,74,31,2,29,.935,3600000,0
24101,67002,1880,0,0,0,0,.00nan,0,0
24102,3520,743,57,34,4,30,.882,3572000,0
24102,3654,734,51,21,3,18,.857,3600000,0
24102,27247,734,0,0,0,0,.00nan,0,0
24102,140000,743,0,0,0,0,.00nan,0,0
24103,3779,729,0,0,0,0,.00nan,0,0
24103,6090,744,95,42,3,39,.929,3552000,0
24103,11430,744,0,0,0,0,.00nan,0,0
24103,26909,729,65,23,2,21,.913,3600000,0
24104,16599,741,78,29,2,27,.931,3600000,0
24104,16963,741,0,0,0,0,.00nan,0,0
24104,48404,739,86,40,3,37,.925,3544000,0
24104,48581,739,0,0,0,0,.00nan,0,0
24105,14995,737,0,0,0,0,.00nan,0,0
24105,17078,747,77,41,3,38,.927,3591000,0
24105,32600,747,0,0,0,0,.00nan,0,0
24105,50717,737,93,33,2,31,.939,3600000,0
24106,1434,3789,73,46,4,42,.913,3585000,0
24106,3768,738,64,24,2,22,.917,3600000,0
24106,17659,738,0,0,0,0,.00nan,0,0
24106,32630,3789,0,0,0,0,.00nan,0,0
24107,112,745,0,0,0,0,.00nan,0,0
24107,11475,740,90,31,1,30,.968,3600000,0
24107,41784,745,66,28,3,25,.893,3532000,0
24107,62469,740,0,0,0,0,.00nan,0,0
24108,2039,752,0,0,0,0,.00nan,0,0
24108,6635,736,0,0,0,0,.00nan,0,0
24108,25972,752,43,26,4,22,.846,3600000,0
24108,26104,736,92,34,1,33,.971,3600000,0
24109,848,732,77,21,1,20,.952,3600000,0
24109,992,749,60,42,6,36,.857,3600000,0
24109,32897,749,0,0,0,0,.00nan,0,0
24109,55049,732,0,0,0,0,.00nan,0,0
24110,1818,2168,0,0,0,0,.00nan,0,0
24110,17409,2168,88,56,3,53,.946,3550000,0
24110,26904,742,0,0,0,0,.00nan,0,0
24110,48292,742,71,19,1,18,.947,3600000,0
24111,616,748,53,11,1,10,.909,666000,0
24111,16094,748,58,50,7,43,.860,2934000,0
24111,26052,733,59,13,1,12,.923,3600000,0
24111,48440,733,0,0,0,0,.00nan,0,0
24112,7162,1880,67,36,4,32,.889,3600000,0
24112,26145,751,88,28,1,27,.964,3600000,0
24112,26334,751,0,0,0,0,.00nan,0,0
24112,67002,1880,0,0,0,0,.00nan,0,0
24113,3520,743,76,29,2,27,.931,3900000,0
24113,3779,729,0,0,0,0,.00nan,0,0
24113,26909,729,68,20,2,18,.900,3900000,0
24113,140000,743,0,0,0,0,.00nan,0,0
24114,3654,734,61,14,1,13,.929,3600000,0
24114,6090,744,72,39,4,35,.897,3600000,0
24114,11430,744,0,0,0,0,.00nan,0,0
24114,27247,734,0,0,0,0,.00nan,0,0
24115,1434,3789,95,35,2,33,.943,3600000,0
24115,32630,3789,0,0,0,0,.00nan,0,0
24115,48404,739,57,26,3,23,.885,3600000,0
24115,48581,739,0,0,0,0,.00nan,0,0
24116,992,749,62,25,3,22,.880,3546000,0
24116,14995,737,82,31,2,29,.935,3600000,0
24116,32897,749,0,0,0,0,.00nan,0,0
24116,50717,737,0,0,0,0,.00nan,0,0
24117,1369,741,0,0,0,0,.00nan,0,0
24117,3768,738,68,20,1,19,.950,3710000,0
24117,16599,741,89,37,2,35,.946,3710000,0
24117,17659,738,0,0,0,0,.00nan,0,0
24118,6635,736,0,0,0,0,.00nan,0,0
24118,17078,747,55,25,3,22,.880,3600000,0
24118,26104,736,100,25,0,25,1000,3600000,0
24118,32600,747,0,0,0,0,.00nan,0,0
24119,848,732,70,25,3,22,.880,3900000,0
24119,2039,752,0,0,0,0,.00nan,0,0
24119,25972,752,86,52,3,49,.942,3900000,0
24119,55049,732,0,0,0,0,.00nan,0,0
24120,26145,751,98,33,1,32,.970,3600000,0
24120,26334,751,0,0,0,0,.00nan,0,0
24120,26904,742,65,26,2,24,.923,3575000,0
24120,48292,742,0,0,0,0,.00nan,0,0
24121,112,745,0,0,0,0,.00nan,0,0
24121,3654,734,0,0,0,0,.00nan,0,0
24121,27247,734,60,31,4,27,.871,3600000,0
24121,41784,745,39,14,3,11,.786,3600000,0
24122,1818,2168,0,0,0,0,.00nan,0,0
24122,11475,740,52,26,3,23,.885,3600000,0
24122,17409,2168,100,33,0,33,1000,3600000,0
24122,62469,740,0,0,0,0,.00nan,0,0
24123,616,748,0,0,0,0,.00nan,0,0
24123,7162,1880,23,16,5,11,.688,3543000,0
24123,16094,748,72,44,4,40,.909,3600000,0
24123,67002,1880,0,0,0,0,.00nan,0,0
24124,3520,743,0,0,0,0,.00nan,0,0
24124,6090,744,89,27,2,25,.926,3600000,0
24124,11430,744,0,0,0,0,.00nan,0,0
24124,140000,743,51,32,4,28,.875,3520000,0
24125,2039,752,0,0,0,0,.00nan,0,0
24125,14995,737,0,0,0,0,.00nan,0,0
24125,25972,752,73,23,1,22,.957,3600000,0
24125,50717,737,74,37,3,34,.919,3600000,0
24126,1369,741,70,26,3,23,.885,3900000,0
24126,3779,729,0,0,0,0,.00nan,0,0
24126,16599,741,0,0,0,0,.00nan,0,0
24126,26909,729,61,35,3,32,.914,3879000,0
24127,992,749,70,33,3,30,.909,3536000,0
24127,6635,736,0,0,0,0,.00nan,0,0
24127,26104,736,69,19,1,18,.947,3600000,0
24127,32897,749,0,0,0,0,.00nan,0,0
24128,3768,738,61,30,4,26,.867,3600000,0
24128,17659,738,0,0,0,0,.00nan,0,0
24128,26052,733,95,22,0,22,1000,3600000,0
24128,48440,733,0,0,0,0,.00nan,0,0
24129,848,732,0,0,0,0,.00nan,0,0
24129,17078,747,43,31,5,26,.839,3600000,0
24129,32600,747,0,0,0,0,.00nan,0,0
24129,55049,732,57,33,4,29,.879,3600000,0
24130,616,748,0,0,0,0,.00nan,0,0
24130,1434,3789,71,20,1,19,.950,3600000,0
24130,16094,748,40,30,6,24,.800,3600000,0
24130,32630,3789,0,0,0,0,.00nan,0,0
24131,112,745,0,0,0,0,.00nan,0,0
24131,1818,2168,0,0,0,0,.00nan,0,0
24131,17409,2168,74,37,3,34,.919,3600000,0
24131,41784,745,70,24,2,22,.917,3600000,0
24132,6090,744,79,32,2,30,.938,3600000,0
24132,11430,744,0,0,0,0,.00nan,0,0
24132,11475,740,54,24,3,21,.875,3557000,0
24132,62469,740,0,0,0,0,.00nan,0,0
24133,3654,734,0,0,0,0,.00nan,0,0
24133,27247,734,88,17,0,17,1000,3600000,0
24133,48404,739,59,42,5,37,.881,3600000,0
24133,48581,739,0,0,0,0,.00nan,0,0
24134,26145,751,0,0,0,0,.00nan,0,0
24134,26334,751,75,37,2,35,.946,3888000,0
24134,26904,742,73,36,3,33,.917,3888000,0
24134,48292,742,0,0,0,0,.00nan,0,0
24135,2039,752,0,0,0,0,.00nan,0,0
24135,3520,743,79,28,2,26,.929,3600000,0
24135,25972,752,58,24,3,21,.875,3561000,0
24135,140000,743,0,0,0,0,.00nan,0,0
24136,3768,738,49,17,3,14,.824,3695000,0
24136,6635,736,0,0,0,0,.00nan,0,0
24136,17659,738,0,0,0,0,.00nan,0,0
24136,26104,736,99,43,2,41,.953,3695000,0
24137,17078,747,44,28,4,24,.857,3900000,0
24137,26052,733,46,25,4,21,.840,3900000,0
24137,32600,747,0,0,0,0,.00nan,0,0
24137,48440,733,0,0,0,0,.00nan,0,0
24138,848,732,0,0,0,0,.00nan,0,0
24138,3779,729,0,0,0,0,.00nan,0,0
24138,26909,729,64,32,3,29,.906,3600000,0
24138,55049,732,94,23,0,23,1000,3600000,0
24139,112,745,0,0,0,0,.00nan,0,0
24139,7162,1880,91,33,2,31,.939,3546000,0
24139,41784,745,99,36,1,35,.972,3600000,0
24139,67002,1880,0,0,0,0,.00nan,0,0
24140,1369,741,0,0,0,0,.00nan,0,0
24140,14995,737,100,41,2,39,.951,3838000,0
24140,16599,741,63,27,3,24,.889,3838000,0
24140,50717,737,0,0,0,0,.00nan,0,0
24141,3779,729,66,24,3,21,.875,3900000,0
24141,26909,729,0,0,0,0,.00nan,0,0
24141,48404,739,65,29,3,26,.897,3900000,0
24141,48581,739,0,0,0,0,.00nan,0,0
24142,3520,743,52,17,2,15,.882,3600000,0
24142,26145,751,63,50,5,45,.900,3600000,0
24142,26334,751,0,0,0,0,.00nan,0,0
24142,140000,743,0,0,0,0,.00nan,0,0
24143,616,748,99,35,1,34,.971,3600000,0
24143,16094,748,0,0,0,0,.00nan,0,0
24143,26904,742,49,22,3,19,.864,3600000,0
24143,48292,742,0,0,0,0,.00nan,0,0
24144,992,749,0,0,0,0,.00nan,0,0
24144,6090,744,51,21,3,18,.857,3600000,0
24144,11430,744,0,0,0,0,.00nan,0,0
24144,32897,749,64,39,4,35,.897,3583000,0
24145,1434,3789,57,26,3,23,.885,3600000,0
24145,14995,737,0,0,0,0,.00nan,0,0
24145,32630,3789,0,0,0,0,.00nan,0,0
24145,50717,737,39,24,4,20,.833,3600000,0
24146,3654,734,0,0,0,0,.00nan,0,0
24146,6635,736,0,0,0,0,.00nan,0,0
24146,26104,736,83,35,2,33,.943,3600000,0
24146,27247,734,42,33,5,28,.848,3600000,0
24147,1369,741,0,0,0,0,.00nan,0,0
24147,11475,740,75,16,1,15,.938,3900000,0
24147,16599,741,82,24,1,23,.958,3900000,0
24147,62469,740,0,0,0,0,.00nan,0,0
24148,2039,752,0,0,0,0,.00nan,0,0
24148,7162,1880,67,19,1,18,.947,3600000,0
24148,25972,752,69,24,2,22,.917,3553000,0
24148,67002,1880,0,0,0,0,.00nan,0,0
24149,848,732,0,0,0,0,.00nan,0,0
24149,3768,738,58,33,4,29,.879,3569000,0
24149,17659,738,0,0,0,0,.00nan,0,0
24149,55049,732,62,26,3,23,.885,3600000,0
24150,3520,743,65,50,5,45,.900,3600000,0
24150,17078,747,0,0,0,0,.00nan,0,0
24150,32600,747,74,21,1,20,.952,3600000,0
24150,140000,743,0,0,0,0,.00nan,0,0
24151,1818,2168,56,26,3,23,.885,3600000,0
24151,17409,2168,0,0,0,0,.00nan,0,0
24151,26904,742,0,0,0,0,.00nan,0,0
24151,48292,742,58,35,4,31,.886,3570000,0
24152,992,749,0,0,0,0,.00nan,0,0
24152,26145,751,67,29,2,27,.931,3900000,0
24152,26334,751,0,0,0,0,.00nan,0,0
24152,32897,749,98,34,2,32,.941,3900000,0
24153,1434,3789,75,29,2,27,.931,3600000,0
24153,11475,740,51,2,0,2,1000,500000,0
24153,32630,3789,0,0,0,0,.00nan,0,0
24153,62469,740,33,36,6,30,.833,3100000,0
24154,3654,734,0,0,0,0,.00nan,0,0
24154,14995,737,59,37,5,32,.865,3600000,0
24154,27247,734,75,17,1,16,.941,3600000,0
24154,50717,737,0,0,0,0,.00nan,0,0
24155,848,732,0,0,0,0,.00nan,0,0
24155,48404,739,100,44,2,42,.955,3600000,0
24155,48581,739,0,0,0,0,.00nan,0,0
24155,55049,732,25,28,6,22,.786,3600000,0
24156,3768,738,0,0,0,0,.00nan,0,0
24156,17659,738,99,41,1,40,.976,3600000,0
24156,26052,733,70,34,4,30,.882,3600000,0
24156,48440,733,0,0,0,0,.00nan,0,0
24157,3779,729,0,0,0,0,.00nan,0,0
24157,6635,736,0,0,0,0,.00nan,0,0
24157,26104,736,42,30,5,25,.833,3600000,0
24157,26909,729,78,30,2,28,.933,3600000,0
24158,6090,744,67,24,2,22,.917,3780000,0
24158,7162,1880,60,19,3,16,.842,3780000,0
24158,11430,744,0,0,0,0,.00nan,0,0
24158,67002,1880,0,0,0,0,.00nan,0,0
24159,992,749,38,37,6,31,.838,3600000,0
24159,17078,747,55,25,3,22,.880,3600000,0
24159,32600,747,0,0,0,0,.00nan,0,0
24159,32897,749,0,0,0,0,.00nan,0,0
24160,112,745,0,0,0,0,.00nan,0,0
24160,1818,2168,0,0,0,0,.00nan,0,0
24160,17409,2168,86,46,3,43,.935,3574000,0
24160,41784,745,62,9,1,8,.889,3600000,0
24161,616,748,0,0,0,0,.00nan,0,0
24161,2039,752,0,0,0,0,.00nan,0,0
24161,16094,748,65,31,3,28,.903,3600000,0
24161,25972,752,72,20,2,18,.900,3600000,0
24162,992,749,0,0,0,0,.00nan,0,0
24162,2279,747,93,20,0,20,1000,3900000,0
24162,5177,749,96,30,0,30,1000,3900000,0
24162,17078,747,0,0,0,0,.00nan,0,0
24163,1434,3789,89,27,1,26,.963,3600000,0
24163,14995,737,0,0,0,0,.00nan,0,0
24163,32630,3789,0,0,0,0,.00nan,0,0
24163,50717,737,64,30,3,27,.900,3520000,0
24164,3768,738,91,25,1,24,.960,3900000,0
24164,6635,736,0,0,0,0,.00nan,0,0
24164,17659,738,0,0,0,0,.00nan,0,0
24164,26104,736,100,30,1,29,.967,3900000,0
24165,16963,742,67,40,4,36,.900,3600000,0
24165,26052,733,80,36,2,34,.944,3600000,0
24165,26904,742,0,0,0,0,.00nan,0,0
24165,48440,733,0,0,0,0,.00nan,0,0
24166,7162,1880,45,28,4,24,.857,3537000,0
24166,11475,740,62,21,2,19,.905,3600000,0
24166,62469,740,0,0,0,0,.00nan,0,0
24166,67002,1880,0,0,0,0,.00nan,0,0
24167,1216,743,0,0,0,0,.00nan,0,0
24167,1369,741,0,0,0,0,.00nan,0,0
24167,3520,743,38,30,5,25,.833,3600000,0
24167,16599,741,73,22,1,21,.955,3600000,0
24168,6090,744,51,23,3,20,.870,3900000,0
24168,26145,751,61,26,3,23,.885,3900000,0
24168,26334,751,0,0,0,0,.00nan,0,0
24168,29248,744,0,0,0,0,.00nan,0,0
24169,112,745,0,0,0,0,.00nan,0,0
24169,1818,2168,0,0,0,0,.00nan,0,0
24169,17409,2168,89,40,2,38,.950,3560000,0
24169,41784,745,72,15,1,14,.933,3600000,0
24170,848,732,0,0,0,0,.00nan,0,0
24170,18870,729,0,0,0,0,.00nan,0,0
24170,26909,729,84,33,2,31,.939,3675000,0
24170,55049,732,61,22,3,19,.864,3675000,0
24171,616,748,0,0,0,0,.00nan,0,0
24171,2039,752,0,0,0,0,.00nan,0,0
24171,16094,748,100,31,0,31,1000,3600000,0
24171,25972,752,51,13,1,12,.923,3576000,0
24172,2279,747,98,22,0,22,1000,3600000,0
24172,17078,747,0,0,0,0,.00nan,0,0
24172,26145,751,74,25,2,23,.920,1882000,0
24172,26334,751,13,21,6,15,.714,1718000,0
24173,26052,733,81,20,1,19,.950,3600000,0
24173,48404,739,73,39,4,35,.897,3600000,0
24173,48440,733,0,0,0,0,.00nan,0,0
24173,48581,739,0,0,0,0,.00nan,0,0
24174,2849,734,0,0,0,0,.00nan,0,0
24174,6635,736,73,31,3,28,.903,3567000,0
24174,26104,736,0,0,0,0,.00nan,0,0
24174,27247,734,99,29,1,28,.966,3600000,0
24175,1434,3789,75,23,2,21,.913,3900000,0
24175,7162,1880,0,0,0,0,.00nan,0,0
24175,32630,3789,0,0,0,0,.00nan,0,0
24175,67002,1880,72,27,2,25,.926,3900000,0
24176,1369,741,0,0,0,0,.00nan,0,0
24176,6090,744,70,26,2,24,.923,3900000,0
24176,16599,741,73,25,2,23,.920,3900000,0
24176,29248,744,0,0,0,0,.00nan,0,0
24177,3768,738,90,32,2,30,.938,3667000,0
24177,17659,738,0,0,0,0,.00nan,0,0
24177,18870,729,95,39,1,38,.974,3667000,0
24177,26909,729,0,0,0,0,.00nan,0,0
24178,2039,752,66,15,1,14,.933,3600000,0
24178,17409,2168,0,0,0,0,.00nan,0,0
24178,20742,2168,75,37,3,34,.919,3600000,0
24178,25972,752,0,0,0,0,.00nan,0,0
24179,848,732,0,0,0,0,.00nan,0,0
24179,11475,740,65,28,3,25,.893,3889000,0
24179,55049,732,100,42,3,39,.929,3900000,0
24179,62469,740,0,0,0,0,.00nan,0,0
24180,992,749,0,0,0,0,.00nan,0,0
24180,1216,743,0,0,0,0,.00nan,0,0
24180,3520,743,80,31,2,29,.935,3600000,0
24180,5177,749,74,37,3,34,.919,3558000,0
24181,112,745,0,0,0,0,.00nan,0,0
24181,616,748,0,0,0,0,.00nan,0,0
24181,16094,748,72,39,3,36,.923,3553000,0
24181,41784,745,58,22,2,20,.909,3600000,0
24182,2279,747,62,35,4,31,.886,3536000,0
24182,6090,744,70,22,2,20,.909,3600000,0
24182,17078,747,0,0,0,0,.00nan,0,0
24182,29248,744,0,0,0,0,.00nan,0,0
24183,2849,734,0,0,0,0,.00nan,0,0
24183,14995,737,0,0,0,0,.00nan,0,0
24183,27247,734,71,28,2,26,.929,3900000,0
24183,50717,737,100,36,2,34,.944,3900000,0
24184,16963,742,0,0,0,0,.00nan,0,0
24184,26904,742,58,18,2,16,.889,3600000,0
24184,48404,739,62,38,4,34,.895,3563000,0
24184,48581,739,0,0,0,0,.00nan,0,0
24185,1369,741,95,36,1,35,.972,3567000,0
24185,16599,741,0,0,0,0,.00nan,0,0
24185,26145,751,0,0,0,0,.00nan,0,0
24185,26334,751,100,24,0,24,1000,3600000,0
24186,1434,3789,0,0,0,0,.00nan,0,0
24186,7162,1880,76,38,3,35,.921,3600000,0
24186,32630,3789,45,31,5,26,.839,3513000,0
24186,67002,1880,0,0,0,0,.00nan,0,0
24187,2039,752,98,21,0,21,1000,3613000,0
24187,17409,2168,93,40,1,39,.975,3613000,0
24187,20742,2168,0,0,0,0,.00nan,0,0
24187,25972,752,0,0,0,0,.00nan,0,0
24188,1216,743,0,0,0,0,.00nan,0,0
24188,3520,743,63,32,4,28,.875,3900000,0
24188,11475,740,52,24,4,20,.833,3900000,0
24188,62469,740,0,0,0,0,.00nan,0,0
24189,992,749,0,0,0,0,.00nan,0,0
24189,5177,749,81,25,1,24,.960,3600000,0
24189,26052,733,53,29,4,25,.862,3600000,0
24189,48440,733,0,0,0,0,.00nan,0,0
24190,848,732,0,0,0,0,.00nan,0,0
24190,18870,729,0,0,0,0,.00nan,0,0
24190,26909,729,86,31,1,30,.968,3600000,0
24190,55049,732,55,37,5,32,.865,3600000,0
24191,112,745,0,0,0,0,.00nan,0,0
24191,616,748,95,24,0,24,1000,3600000,0
24191,16094,748,0,0,0,0,.00nan,0,0
24191,41784,745,71,27,2,25,.926,3546000,0
24192,2849,734,83,34,2,32,.941,3900000,0
24192,3768,738,100,47,2,45,.957,3900000,0
24192,17659,738,0,0,0,0,.00nan,0,0
24192,27247,734,0,0,0,0,.00nan,0,0
24193,14995,737,0,0,0,0,.00nan,0,0
24193,48404,739,75,26,2,24,.923,3546000,0
24193,48581,739,0,0,0,0,.00nan,0,0
24193,50717,737,91,31,1,30,.968,3600000,0
24194,6635,736,0,0,0,0,.00nan,0,0
24194,16963,742,83,24,1,23,.958,3600000,0
24194,26104,736,88,36,2,34,.944,3600000,0
24194,26904,742,0,0,0,0,.00nan,0,0
24195,6090,744,50,28,4,24,.857,3600000,0
24195,26145,751,0,0,0,0,.00nan,0,0
24195,26334,751,59,33,5,28,.848,3558000,0
24195,29248,744,0,0,0,0,.00nan,0,0
24196,992,749,100,42,1,41,.976,3600000,0
24196,5177,749,0,0,0,0,.00nan,0,0
24196,11475,740,0,0,0,0,.00nan,0,0
24196,62469,740,73,28,2,26,.929,3545000,0
24197,1216,743,0,0,0,0,.00nan,0,0
24197,1369,741,0,0,0,0,.00nan,0,0
24197,3520,743,75,33,3,30,.909,3553000,0
24197,16599,741,100,41,1,40,.976,3600000,0
24198,7162,1880,50,37,6,31,.838,3600000,0
24198,26052,733,63,20,1,19,.950,3600000,0
24198,48440,733,0,0,0,0,.00nan,0,0
24198,67002,1880,0,0,0,0,.00nan,0,0
24199,2279,747,78,43,4,39,.907,3555000,0
24199,2849,734,71,25,2,23,.920,3600000,0
24199,17078,747,0,0,0,0,.00nan,0,0
24199,27247,734,0,0,0,0,.00nan,0,0
24200,616,748,46,28,4,24,.857,3900000,0
24200,16094,748,0,0,0,0,.00nan,0,0
24200,18870,729,49,29,4,25,.862,3900000,0
24200,26909,729,0,0,0,0,.00nan,0,0
24201,112,745,0,0,0,0,.00nan,0,0
24201,16963,742,0,0,0,0,.00nan,0,0
24201,26904,742,84,37,2,35,.946,3543000,0
24201,41784,745,73,25,1,24,.960,3600000,0
24202,2039,752,65,24,2,22,.917,3600000,0
24202,14995,737,50,25,3,22,.880,3600000,0
24202,25972,752,0,0,0,0,.00nan,0,0
24202,50717,737,0,0,0,0,.00nan,0,0
24203,3768,738,80,23,1,22,.957,3600000,0
24203,6635,736,0,0,0,0,.00nan,0,0
24203,17659,738,0,0,0,0,.00nan,0,0
24203,26104,736,70,34,3,31,.912,3578000,0
24204,1216,743,0,0,0,0,.00nan,0,0
24204,1434,3789,83,33,2,31,.939,3600000,0
24204,3520,743,73,28,3,25,.893,3544000,0
24204,32630,3789,0,0,0,0,.00nan,0,0
24205,992,749,0,0,0,0,.00nan,0,0
24205,1369,741,0,0,0,0,.00nan,0,0
24205,5177,749,74,36,3,33,.917,3600000,0
24205,16599,741,100,36,0,36,1000,3600000,0
24206,17409,2168,41,35,6,29,.829,3600000,0
24206,20742,2168,0,0,0,0,.00nan,0,0
24206,26052,733,77,22,1,21,.955,3600000,0
24206,48440,733,0,0,0,0,.00nan,0,0
24207,848,732,0,0,0,0,.00nan,0,0
24207,26145,751,84,25,1,24,.960,3600000,0
24207,26334,751,0,0,0,0,.00nan,0,0
24207,55049,732,81,36,3,33,.917,3513000,0
24208,616,748,0,0,0,0,.00nan,0,0
24208,2849,734,44,25,4,21,.840,3835000,0
24208,16094,748,76,52,5,47,.904,3827000,0
24208,27247,734,0,0,0,0,.00nan,0,0
24209,7162,1880,73,31,3,28,.903,3600000,0
24209,48404,739,61,38,4,34,.895,3582000,0
24209,48581,739,0,0,0,0,.00nan,0,0
24209,67002,1880,0,0,0,0,.00nan,0,0
24210,2279,747,52,27,4,23,.852,3600000,0
24210,17078,747,0,0,0,0,.00nan,0,0
24210,18870,729,0,0,0,0,.00nan,0,0
24210,26909,729,58,35,5,30,.857,3600000,0
24211,112,745,0,0,0,0,.00nan,0,0
24211,14995,737,100,34,1,33,.971,3900000,0
24211,41784,745,88,27,1,26,.963,3900000,0
24211,50717,737,0,0,0,0,.00nan,0,0
24212,6635,736,0,0,0,0,.00nan,0,0
24212,11475,740,80,29,2,27,.931,3554000,0
24212,26104,736,74,27,1,26,.963,3600000,0
24212,62469,740,0,0,0,0,.00nan,0,0
24213,6090,744,81,36,2,34,.944,3600000,0
24213,16963,742,49,22,3,19,.864,3600000,0
24213,26904,742,0,0,0,0,.00nan,0,0
24213,29248,744,0,0,0,0,.00nan,0,0
24214,992,749,0,0,0,0,.00nan,0,0
24214,3768,738,0,0,0,0,.00nan,0,0
24214,5177,749,96,31,1,30,.968,3600000,0
24214,17659,738,77,33,2,31,.939,3581000,0
24215,1369,741,0,0,0,0,.00nan,0,0
24215,16599,741,83,36,2,34,.944,3600000,0
24215,26145,751,0,0,0,0,.00nan,0,0
24215,26334,751,50,24,4,20,.833,3565000,0
24216,1434,3789,97,44,2,42,.955,3556000,0
24216,2039,752,0,0,0,0,.00nan,0,0
24216,25972,752,82,23,1,22,.957,3600000,0
24216,32630,3789,0,0,0,0,.00nan,0,0
24217,848,732,0,0,0,0,.00nan,0,0
24217,17409,2168,69,33,3,30,.909,3590000,0
24217,20742,2168,0,0,0,0,.00nan,0,0
24217,55049,732,70,19,1,18,.947,3600000,0
24218,11475,740,30,17,4,13,.765,890000,0
24218,18870,729,0,0,0,0,.00nan,0,0
24218,26909,729,91,31,1,30,.968,3600000,0
24218,62469,740,64,24,2,22,.917,2710000,0
24219,616,748,0,0,0,0,.00nan,0,0
24219,6635,736,0,0,0,0,.00nan,0,0
24219,16094,748,100,25,0,25,1000,3600000,0
24219,26104,736,66,35,4,31,.886,3600000,0
24220,14995,737,0,0,0,0,.00nan,0,0
24220,26052,733,88,36,3,33,.917,3725000,0
24220,48440,733,0,0,0,0,.00nan,0,0
24220,50717,737,56,29,4,25,.862,3726000,0
24221,2279,747,0,0,0,0,.00nan,0,0
24221,7162,1880,64,34,4,30,.882,3560000,0
24221,17078,747,77,33,2,31,.939,3600000,0
24221,67002,1880,0,0,0,0,.00nan,0,0
24222,1216,743,69,34,4,30,.882,3573000,0
24222,3520,743,0,0,0,0,.00nan,0,0
24222,16963,742,0,0,0,0,.00nan,0,0
24222,26904,742,63,24,2,22,.917,3600000,0
24223,26145,751,77,30,2,28,.933,3546000,0
24223,26334,751,0,0,0,0,.00nan,0,0
24223,48404,739,100,30,0,30,1000,3600000,0
24223,48581,739,0,0,0,0,.00nan,0,0
24224,3768,738,60,15,2,13,.867,3600000,0
24224,17409,2168,0,0,0,0,.00nan,0,0
24224,17659,738,0,0,0,0,.00nan,0,0
24224,20742,2168,81,42,4,38,.905,3572000,0
24225,1434,3789,76,35,3,32,.914,3579000,0
24225,6090,744,75,22,2,20,.909,3600000,0
24225,29248,744,0,0,0,0,.00nan,0,0
24225,32630,3789,0,0,0,0,.00nan,0,0
24226,2849,734,54,34,5,29,.853,3600000,0
24226,18870,729,15,27,7,20,.741,3558000,0
24226,26909,729,0,0,0,0,.00nan,0,0
24226,27247,734,0,0,0,0,.00nan,0,0
24227,112,745,0,0,0,0,.00nan,0,0
24227,1369,741,0,0,0,0,.00nan,0,0
24227,16599,741,89,39,2,37,.949,3553000,0
24227,41784,745,78,23,1,22,.957,3600000,0
24228,7162,1880,89,21,0,21,1000,3600000,0
24228,11475,740,74,34,3,31,.912,3600000,0
24228,62469,740,0,0,0,0,.00nan,0,0
24228,67002,1880,0,0,0,0,.00nan,0,0
24229,1216,743,0,0,0,0,.00nan,0,0
24229,2039,752,60,21,2,19,.905,3600000,0
24229,3520,743,29,28,6,22,.786,3600000,0
24229,25972,752,0,0,0,0,.00nan,0,0
24230,616,748,0,0,0,0,.00nan,0,0
24230,848,732,0,0,0,0,.00nan,0,0
24230,16094,748,54,25,3,22,.880,3600000,0
24230,55049,732,77,25,2,23,.920,3600000,0
24231,992,749,77,16,0,16,1000,3285000,0
24231,5177,749,28,11,4,7,.636,615000,0
24231,26145,751,0,0,0,0,.00nan,0,0
24231,26334,751,57,28,4,24,.857,3900000,0
24232,1434,3789,61,27,3,24,.889,3600000,0
24232,17409,2168,99,25,0,25,1000,3600000,0
24232,20742,2168,0,0,0,0,.00nan,0,0
24232,32630,3789,0,0,0,0,.00nan,0,0
24233,6635,736,0,0,0,0,.00nan,0,0
24233,14995,737,0,0,0,0,.00nan,0,0
24233,26104,736,100,35,1,34,.971,3600000,0
24233,50717,737,84,29,2,27,.931,3554000,0
24234,16963,742,0,0,0,0,.00nan,0,0
24234,26904,742,64,14,1,13,.929,3600000,0
24234,48404,739,68,46,5,41,.891,3600000,0
24234,48581,739,0,0,0,0,.00nan,0,0
24235,2279,747,69,26,2,24,.923,3600000,0
24235,17078,747,0,0,0,0,.00nan,0,0
24235,26052,733,53,26,3,23,.885,3600000,0
24235,48440,733,0,0,0,0,.00nan,0,0
24236,2849,734,63,17,2,15,.882,3564000,0
24236,3768,738,80,25,1,24,.960,3600000,0
24236,17659,738,0,0,0,0,.00nan,0,0
24236,27247,734,0,0,0,0,.00nan,0,0
24237,848,732,0,0,0,0,.00nan,0,0
24237,7162,1880,99,40,1,39,.975,3600000,0
24237,55049,732,68,24,2,22,.917,3565000,0
24237,67002,1880,0,0,0,0,.00nan,0,0
24238,1216,743,0,0,0,0,.00nan,0,0
24238,1369,741,63,28,3,25,.893,3900000,0
24238,3520,743,55,28,3,25,.893,3900000,0
24238,16599,741,0,0,0,0,.00nan,0,0
24239,2039,752,0,0,0,0,.00nan,0,0
24239,6090,744,0,0,0,0,.00nan,0,0
24239,25972,752,34,15,4,11,.733,3600000,0
24239,29248,744,93,54,3,51,.944,3600000,0
24240,6635,736,0,0,0,0,.00nan,0,0
24240,26104,736,75,23,1,22,.957,3600000,0
24240,48404,739,85,42,3,39,.929,3569000,0
24240,48581,739,0,0,0,0,.00nan,0,0
24241,3768,738,0,0,0,0,.00nan,0,0
24241,16963,742,0,0,0,0,.00nan,0,0
24241,17659,738,58,40,5,35,.875,3542000,0
24241,26904,742,53,27,4,23,.852,3600000,0
24242,11475,740,0,0,0,0,.00nan,0,0
24242,14995,737,66,24,2,22,.917,3900000,0
24242,50717,737,0,0,0,0,.00nan,0,0
24242,62469,740,69,29,2,27,.931,3900000,0
24243,1434,3789,87,27,1,26,.963,3600000,0
24243,6090,744,59,35,4,31,.886,3600000,0
24243,29248,744,0,0,0,0,.00nan,0,0
24243,32630,3789,0,0,0,0,.00nan,0,0
24244,1369,741,68,28,2,26,.929,3543000,0
24244,2279,747,77,19,1,18,.947,3600000,0
24244,16599,741,0,0,0,0,.00nan,0,0
24244,17078,747,0,0,0,0,.00nan,0,0
24245,2849,734,0,0,0,0,.00nan,0,0
24245,16963,742,71,37,3,34,.919,3600000,0
24245,26904,742,0,0,0,0,.00nan,0,0
24245,27247,734,43,32,5,27,.844,3584000,0
24246,18870,729,0,0,0,0,.00nan,0,0
24246,26145,751,0,0,0,0,.00nan,0,0
24246,26334,751,72,29,2,27,.931,3722000,0
24246,26909,729,71,32,3,29,.906,3722000,0
24247,992,749,0,0,0,0,.00nan,0,0
24247,2039,752,89,25,1,24,.960,3600000,0
24247,5177,749,70,35,4,31,.886,3600000,0
24247,25972,752,0,0,0,0,.00nan,0,0
24248,112,745,0,0,0,0,.00nan,0,0
24248,1216,743,0,0,0,0,.00nan,0,0
24248,3520,743,100,36,1,35,.972,3600000,0
24248,41784,745,61,25,3,22,.880,3573000,0
24249,616,748,0,0,0,0,.00nan,0,0
24249,16094,748,57,37,4,33,.892,3556000,0
24249,26052,733,65,27,3,24,.889,3600000,0
24249,48440,733,0,0,0,0,.00nan,0,0
24250,848,732,0,0,0,0,.00nan,0,0
24250,14995,737,0,0,0,0,.00nan,0,0
24250,50717,737,93,20,0,20,1000,3600000,0
24250,55049,732,53,38,5,33,.868,3600000,0
24251,6635,736,0,0,0,0,.00nan,0,0
24251,7162,1880,77,27,1,26,.963,3772000,0
24251,26104,736,93,23,0,23,1000,3772000,0
24251,67002,1880,0,0,0,0,.00nan,0,0
24252,1434,3789,62,34,4,30,.882,3600000,0
24252,6090,744,52,32,5,27,.844,3600000,0
24252,29248,744,0,0,0,0,.00nan,0,0
24252,32630,3789,0,0,0,0,.00nan,0,0
24253,17409,2168,98,37,2,35,.946,3600000,0
24253,20742,2168,0,0,0,0,.00nan,0,0
24253,26052,733,48,28,4,24,.857,3569000,0
24253,48440,733,0,0,0,0,.00nan,0,0
24254,2279,747,94,21,0,21,1000,3600000,0
24254,11475,740,0,0,0,0,.00nan,0,0
24254,17078,747,0,0,0,0,.00nan,0,0
24254,62469,740,75,26,2,24,.923,3569000,0
24255,1369,741,0,0,0,0,.00nan,0,0
24255,3768,738,0,0,0,0,.00nan,0,0
24255,16599,741,70,26,3,23,.885,3900000,0
24255,17659,738,83,36,3,33,.917,3900000,0
24256,26145,751,0,0,0,0,.00nan,0,0
24256,26334,751,78,20,1,19,.950,3600000,0
24256,48404,739,71,45,4,41,.911,3600000,0
24256,48581,739,0,0,0,0,.00nan,0,0
24257,112,745,0,0,0,0,.00nan,0,0
24257,2039,752,0,0,0,0,.00nan,0,0
24257,25972,752,95,26,0,26,1000,3600000,0
24257,41784,745,77,27,1,26,.963,3573000,0
24258,616,748,0,0,0,0,.00nan,0,0
24258,16094,748,100,27,0,27,1000,3600000,0
24258,18870,729,61,17,1,16,.941,2493000,0
24258,26909,729,28,14,4,10,.714,1107000,0
24259,2849,734,76,30,2,28,.933,3650000,0
24259,7162,1880,78,30,3,27,.900,3650000,0
24259,27247,734,0,0,0,0,.00nan,0,0
24259,67002,1880,0,0,0,0,.00nan,0,0
24260,1216,743,0,0,0,0,.00nan,0,0
24260,3520,743,58,35,4,31,.886,3577000,0
24260,16963,742,0,0,0,0,.00nan,0,0
24260,26904,742,65,20,2,18,.900,3600000,0
24261,848,732,0,0,0,0,.00nan,0,0
24261,6635,736,55,3,0,3,1000,1207000,0
24261,26104,736,24,24,6,18,.750,2393000,0
24261,55049,732,63,19,2,17,.895,3600000,0
24262,112,745,0,0,0,0,.00nan,0,0
24262,992,749,51,32,4,28,.875,3019000,0
24262,5177,749,23,4,3,1,.250,581000,0
24262,41784,745,73,24,2,22,.917,3600000,0
24263,1434,3789,0,0,0,0,.00nan,0,0
24263,2279,747,59,37,5,32,.865,3600000,0
24263,17078,747,0,0,0,0,.00nan,0,0
24263,32630,3789,84,31,2,29,.935,3600000,0
24264,17409,2168,0,0,0,0,.00nan,0,0
24264,18870,729,93,34,1,33,.971,3600000,0
24264,20742,2168,81,30,2,28,.933,3542000,0
24264,26909,729,0,0,0,0,.00nan,0,0
24265,1369,741,0,0,0,0,.00nan,0,0
24265,6090,744,0,0,0,0,.00nan,0,0
24265,16599,741,83,24,1,23,.958,3600000,0
24265,29248,744,44,35,7,28,.800,3600000,0
24266,26052,733,100,22,0,22,1000,3600000,0
24266,26145,751,98,43,1,42,.977,3555000,0
24266,26334,751,0,0,0,0,.00nan,0,0
24266,48440,733,0,0,0,0,.00nan,0,0
24267,2039,752,59,5,0,5,1000,845000,0
24267,3768,738,63,35,4,31,.886,3600000,0
24267,17659,738,0,0,0,0,.00nan,0,0
24267,25972,752,7,15,6,9,.600,2751000,0
24268,616,748,0,0,0,0,.00nan,0,0
24268,16094,748,58,25,3,22,.880,3600000,0
24268,48404,739,54,30,4,26,.867,3600000,0
24268,48581,739,0,0,0,0,.00nan,0,0
24269,992,749,0,0,0,0,.00nan,0,0
24269,5177,749,49,37,6,31,.838,3876000,0
24269,16963,742,0,0,0,0,.00nan,0,0
24269,26904,742,32,22,5,17,.773,3896000,0
24270,1216,743,53,8,1,7,.875,584000,0
24270,2849,734,0,0,0,0,.00nan,0,0
24270,3520,743,16,28,7,21,.750,3016000,0
24270,27247,734,92,20,0,20,1000,3600000,0
24271,11475,740,87,34,1,33,.971,3600000,0
24271,14995,737,0,0,0,0,.00nan,0,0
24271,50717,737,72,25,2,23,.920,3600000,0
24271,62469,740,0,0,0,0,.00nan,0,0
24272,848,732,0,0,0,0,.00nan,0,0
24272,7162,1880,64,22,2,20,.909,3600000,0
24272,55049,732,34,25,5,20,.800,3600000,0
24272,67002,1880,0,0,0,0,.00nan,0,0
24273,17409,2168,56,24,3,21,.875,3544000,0
24273,20742,2168,0,0,0,0,.00nan,0,0
24273,48404,739,68,24,2,22,.917,3600000,0
24273,48581,739,0,0,0,0,.00nan,0,0
24274,112,745,18,22,6,16,.727,2815000,0
24274,3768,738,0,0,0,0,.00nan,0,0
24274,17659,738,81,40,3,37,.925,3600000,0
24274,41784,745,56,5,0,5,1000,785000,0
24275,2279,747,97,32,1,31,.969,3600000,0
24275,16963,742,0,0,0,0,.00nan,0,0
24275,17078,747,0,0,0,0,.00nan,0,0
24275,26904,742,75,30,2,28,.933,3600000,0
24276,1216,743,97,37,1,36,.973,3600000,0
24276,1369,741,0,0,0,0,.00nan,0,0
24276,3520,743,0,0,0,0,.00nan,0,0
24276,16599,741,91,21,0,21,1000,3600000,0
24277,616,748,0,0,0,0,.00nan,0,0
24277,16094,748,65,25,2,23,.920,3900000,0
24277,26145,751,0,0,0,0,.00nan,0,0
24277,26334,751,76,33,2,31,.939,3900000,0
24278,6635,736,0,0,0,0,.00nan,0,0
24278,14995,737,61,30,3,27,.900,3563000,0
24278,26104,736,52,18,2,16,.889,3600000,0
24278,50717,737,0,0,0,0,.00nan,0,0
24279,848,732,0,0,0,0,.00nan,0,0
24279,7162,1880,53,28,4,24,.857,3900000,0
24279,55049,732,65,32,4,28,.875,3900000,0
24279,67002,1880,0,0,0,0,.00nan,0,0
24280,6090,744,82,28,1,27,.964,3600000,0
24280,11475,740,90,32,2,30,.938,3574000,0
24280,29248,744,0,0,0,0,.00nan,0,0
24280,62469,740,0,0,0,0,.00nan,0,0
24281,2849,734,0,0,0,0,.00nan,0,0
24281,3768,738,62,33,3,30,.909,3600000,0
24281,17659,738,0,0,0,0,.00nan,0,0
24281,27247,734,61,35,4,31,.886,3600000,0
24282,112,745,0,0,0,0,.00nan,0,0
24282,1434,3789,92,38,2,36,.947,3900000,0
24282,32630,3789,0,0,0,0,.00nan,0,0
24282,41784,745,64,22,2,20,.909,3900000,0
24283,992,749,0,0,0,0,.00nan,0,0
24283,5177,749,57,21,2,19,.905,3562000,0
24283,17409,2168,93,37,1,36,.973,3600000,0
24283,20742,2168,0,0,0,0,.00nan,0,0
24284,616,748,0,0,0,0,.00nan,0,0
24284,2279,747,75,18,1,17,.944,3600000,0
24284,16094,748,62,29,2,27,.931,3600000,0
24284,17078,747,0,0,0,0,.00nan,0,0
24285,6635,736,0,0,0,0,.00nan,0,0
24285,18870,729,0,0,0,0,.00nan,0,0
24285,26104,736,62,30,4,26,.867,3600000,0
24285,26909,729,68,25,2,23,.920,3600000,0
24286,2039,752,68,16,1,15,.938,3600000,0
24286,11475,740,0,0,0,0,.00nan,0,0
24286,25972,752,0,0,0,0,.00nan,0,0
24286,62469,740,58,38,5,33,.868,3600000,0
24287,1369,741,0,0,0,0,.00nan,0,0
24287,16599,741,100,26,0,26,1000,3600000,0
24287,26052,733,67,32,3,29,.906,3600000,0
24287,48440,733,0,0,0,0,.00nan,0,0
24288,7162,1880,70,25,1,24,.960,3600000,0
24288,14995,737,0,0,0,0,.00nan,0,0
24288,50717,737,79,32,2,30,.938,3600000,0
24288,67002,1880,0,0,0,0,.00nan,0,0
24289,1216,743,0,0,0,0,.00nan,0,0
24289,3520,743,75,26,1,25,.962,3600000,0
24289,26145,751,0,0,0,0,.00nan,0,0
24289,26334,751,74,40,4,36,.900,3600000,0
24290,848,732,0,0,0,0,.00nan,0,0
24290,48404,739,81,35,2,33,.943,3900000,0
24290,48581,739,0,0,0,0,.00nan,0,0
24290,55049,732,92,35,2,33,.943,3900000,0
24291,2849,734,0,0,0,0,.00nan,0,0
24291,16963,742,85,24,1,23,.958,3772000,0
24291,26904,742,0,0,0,0,.00nan,0,0
24291,27247,734,78,29,2,27,.931,3772000,0
24292,1434,3789,96,41,2,39,.951,3600000,0
24292,6090,744,72,30,3,27,.900,3600000,0
24292,29248,744,0,0,0,0,.00nan,0,0
24292,32630,3789,0,0,0,0,.00nan,0,0
24293,616,748,0,0,0,0,.00nan,0,0
24293,992,749,92,35,1,34,.971,3897000,0
24293,5177,749,0,0,0,0,.00nan,0,0
24293,16094,748,70,29,2,27,.931,3897000,0
24294,2279,747,43,23,4,19,.826,3600000,0
24294,17078,747,0,0,0,0,.00nan,0,0
24294,17409,2168,83,44,3,41,.932,3600000,0
24294,20742,2168,0,0,0,0,.00nan,0,0
24295,3768,738,48,26,4,22,.846,3600000,0
24295,17659,738,0,0,0,0,.00nan,0,0
24295,26145,751,24,29,6,23,.793,2514000,0
24295,26334,751,57,8,1,7,.875,1086000,0
24296,14995,737,69,34,3,31,.912,3570000,0
24296,18870,729,0,0,0,0,.00nan,0,0
24296,26909,729,66,22,2,20,.909,3600000,0
24296,50717,737,0,0,0,0,.00nan,0,0
24297,112,745,0,0,0,0,.00nan,0,0
24297,11475,740,0,0,0,0,.00nan,0,0
24297,41784,745,73,25,2,23,.920,3600000,0
24297,62469,740,80,38,4,34,.895,3565000,0
24298,1369,741,0,0,0,0,.00nan,0,0
24298,2039,752,0,0,0,0,.00nan,0,0
24298,16599,741,76,42,5,37,.881,3600000,0
24298,25972,752,54,14,2,12,.857,3600000,0
24299,848,732,0,0,0,0,.00nan,0,0
24299,6635,736,0,0,0,0,.00nan,0,0
24299,26104,736,53,36,4,32,.889,3600000,0
24299,55049,732,97,21,0,21,1000,3600000,0
24300,7162,1880,98,46,3,43,.935,3600000,0
24300,16963,742,0,0,0,0,.00nan,0,0
24300,26904,742,77,10,0,10,1000,3600000,0
24300,67002,1880,0,0,0,0,.00nan,0,0
24301,2849,734,0,0,0,0,.00nan,0,0
24301,26052,733,67,30,3,27,.900,3600000,0
24301,27247,734,64,29,4,25,.862,3551000,0
24301,48440,733,0,0,0,0,.00nan,0,0
24302,1216,743,0,0,0,0,.00nan,0,0
24302,1434,3789,79,30,2,28,.933,3600000,0
24302,3520,743,87,28,1,27,.964,3600000,0
24302,32630,3789,0,0,0,0,.00nan,0,0
24303,2279,747,74,29,2,27,.931,3536000,0
24303,11475,740,95,22,0,22,1000,3600000,0
24303,17078,747,0,0,0,0,.00nan,0,0
24303,62469,740,0,0,0,0,.00nan,0,0
24304,3768,738,56,17,2,15,.882,3600000,0
24304,17659,738,0,0,0,0,.00nan,0,0
24304,48404,739,93,56,3,53,.946,3551000,0
24304,48581,739,0,0,0,0,.00nan,0,0
24305,112,745,0,0,0,0,.00nan,0,0
24305,5177,749,98,41,2,39,.951,3900000,0
24305,29271,749,0,0,0,0,.00nan,0,0
24305,41784,745,61,24,2,22,.917,3900000,0
24306,1369,741,0,0,0,0,.00nan,0,0
24306,16599,741,69,23,2,21,.913,3600000,0
24306,26145,751,75,39,3,36,.923,3600000,0
24306,26334,751,0,0,0,0,.00nan,0,0
24307,6090,744,65,31,3,28,.903,3600000,0
24307,17409,2168,56,35,5,30,.857,3556000,0
24307,20742,2168,0,0,0,0,.00nan,0,0
24307,29248,744,0,0,0,0,.00nan,0,0
24308,2849,734,0,0,0,0,.00nan,0,0
24308,18870,729,55,33,4,29,.879,3600000,0
24308,26909,729,0,0,0,0,.00nan,0,0
24308,27247,734,90,17,0,17,1000,3600000,0
24309,14995,737,0,0,0,0,.00nan,0,0
24309,26052,733,74,27,2,25,.926,3812000,0
24309,48440,733,0,0,0,0,.00nan,0,0
24309,50717,737,64,28,3,25,.893,3812000,0
24310,2039,752,90,15,0,15,1000,3600000,0
24310,7162,1880,58,41,5,36,.878,3600000,0
24310,25972,752,0,0,0,0,.00nan,0,0
24310,67002,1880,0,0,0,0,.00nan,0,0
24311,616,748,0,0,0,0,.00nan,0,0
24311,848,732,0,0,0,0,.00nan,0,0
24311,16094,748,98,48,3,45,.938,3591000,0
24311,55049,732,52,13,2,11,.846,3600000,0
24312,112,745,0,0,0,0,.00nan,0,0
24312,1434,3789,69,34,3,31,.912,3600000,0
24312,32630,3789,0,0,0,0,.00nan,0,0
24312,41784,745,91,18,0,18,1000,3600000,0
24313,16963,742,0,0,0,0,.00nan,0,0
24313,26904,742,50,19,2,17,.895,3544000,0
24313,48404,739,96,35,1,34,.971,3600000,0
24313,48581,739,0,0,0,0,.00nan,0,0
24314,6090,744,87,27,1,26,.963,3600000,0
24314,6635,736,81,31,2,29,.935,3571000,0
24314,26104,736,0,0,0,0,.00nan,0,0
24314,29248,744,0,0,0,0,.00nan,0,0
24315,1216,743,0,0,0,0,.00nan,0,0
24315,3520,743,89,31,2,29,.935,3600000,0
24315,5177,749,0,0,0,0,.00nan,0,0
24315,29271,749,68,30,3,27,.900,3566000,0
24316,2039,752,63,23,2,21,.913,3600000,0
24316,2849,734,0,0,0,0,.00nan,0,0
24316,25972,752,0,0,0,0,.00nan,0,0
24316,27247,734,88,43,3,40,.930,3586000,0
24317,3768,738,80,22,1,21,.955,3600000,0
24317,17659,738,0,0,0,0,.00nan,0,0
24317,18870,729,0,0,0,0,.00nan,0,0
24317,26909,729,67,32,3,29,.906,3541000,0
24318,848,732,0,0,0,0,.00nan,0,0
24318,17409,2168,0,0,0,0,.00nan,0,0
24318,20742,2168,52,50,7,43,.860,3600000,0
24318,55049,732,50,17,3,14,.824,3600000,0
24319,11475,740,91,33,1,32,.970,3578000,0
24319,26052,733,100,24,0,24,1000,3600000,0
24319,48440,733,0,0,0,0,.00nan,0,0
24319,62469,740,0,0,0,0,.00nan,0,0
24320,112,745,0,0,0,0,.00nan,0,0
24320,2279,747,25,13,4,9,.692,1171000,0
24320,17078,747,21,22,6,16,.727,2429000,0
24320,41784,745,42,29,6,23,.793,3600000,0
24321,6090,744,47,22,4,18,.818,3600000,0
24321,29248,744,0,0,0,0,.00nan,0,0
24321,48404,739,100,34,0,34,1000,3600000,0
24321,48581,739,0,0,0,0,.00nan,0,0
24322,6635,736,0,0,0,0,.00nan,0,0
24322,16963,742,0,0,0,0,.00nan,0,0
24322,26104,736,67,27,2,25,.926,3585000,0
24322,26904,742,76,20,1,19,.950,3600000,0
24323,616,748,0,0,0,0,.00nan,0,0
24323,7162,1880,70,32,2,30,.938,3542000,0
24323,16094,748,82,25,1,24,.960,3600000,0
24323,67002,1880,0,0,0,0,.00nan,0,0
24324,1434,3789,97,57,3,54,.947,3547000,0
24324,2039,752,0,0,0,0,.00nan,0,0
24324,25972,752,65,16,1,15,.938,3600000,0
24324,32630,3789,0,0,0,0,.00nan,0,0
24325,14995,737,69,29,3,26,.897,3900000,0
24325,18870,729,51,26,3,23,.885,3900000,0
24325,26909,729,0,0,0,0,.00nan,0,0
24325,50717,737,0,0,0,0,.00nan,0,0
24326,848,732,0,0,0,0,.00nan,0,0
24326,26145,751,0,0,0,0,.00nan,0,0
24326,26334,751,78,21,1,20,.952,3600000,0
24326,55049,732,92,43,2,41,.953,3568000,0
24327,2849,734,90,28,1,27,.964,3600000,0
24327,5177,749,0,0,0,0,.00nan,0,0
24327,27247,734,0,0,0,0,.00nan,0,0
24327,29271,749,72,29,2,27,.931,3600000,0
24328,7162,1880,96,29,1,28,.966,3900000,0
24328,17409,2168,91,29,1,28,.966,3900000,0
24328,20742,2168,0,0,0,0,.00nan,0,0
24328,67002,1880,0,0,0,0,.00nan,0,0
24329,11475,740,82,33,2,31,.939,3562000,0
24329,16963,742,0,0,0,0,.00nan,0,0
24329,26904,742,79,18,1,17,.944,3600000,0
24329,62469,740,0,0,0,0,.00nan,0,0
24330,1369,741,87,35,2,33,.943,3514000,0
24330,2279,747,0,0,0,0,.00nan,0,0
24330,16599,741,0,0,0,0,.00nan,0,0
24330,17078,747,99,30,0,30,1000,3600000,0
24331,6090,744,66,28,3,25,.893,3516000,0
24331,26052,733,99,34,1,33,.971,3600000,0
24331,29248,744,0,0,0,0,.00nan,0,0
24331,48440,733,0,0,0,0,.00nan,0,0
24332,1216,743,0,0,0,0,.00nan,0,0
24332,3520,743,100,24,0,24,1000,3600000,0
24332,48404,739,94,35,2,33,.943,3578000,0
24332,48581,739,0,0,0,0,.00nan,0,0
24333,3768,738,20,10,4,6,.600,1052000,0
24333,14995,737,0,0,0,0,.00nan,0,0
24333,17659,738,72,18,0,18,1000,2548000,0
24333,50717,737,76,19,1,18,.947,3600000,0
24334,112,745,0,0,0,0,.00nan,0,0
24334,1434,3789,96,50,2,48,.960,3600000,0
24334,32630,3789,0,0,0,0,.00nan,0,0
24334,41784,745,49,22,3,19,.864,3546000,0
24335,6635,736,0,0,0,0,.00nan,0,0
24335,18870,729,0,0,0,0,.00nan,0,0
24335,26104,736,91,38,3,35,.921,3900000,0
24335,26909,729,82,38,3,35,.921,3900000,0
24847,14995,737,62,46,5,41,.891,3600000,0
24847,26904,742,87,36,2,34,.944,3600000,0
24847,48292,742,0,0,0,0,.00nan,0,0
24847,50717,737,0,0,0,0,.00nan,0,0
24849,3768,738,0,0,0,0,.00nan,0,0
24849,26145,751,0,0,0,0,.00nan,0,0
24849,26334,751,64,37,5,32,.865,3600000,0
24849,66184,738,77,26,1,25,.962,3600000,0
24851,1434,3789,79,14,0,14,1000,3600000,0
24851,16963,736,92,32,2,30,.938,3575000,0
24851,26104,736,0,0,0,0,.00nan,0,0
24851,32630,3789,0,0,0,0,.00nan,0,0
24853,2039,752,46,27,4,23,.852,3598000,0
24853,6090,744,90,36,2,34,.944,3600000,0
24853,11430,744,0,0,0,0,.00nan,0,0
24853,25972,752,0,0,0,0,.00nan,0,0
24855,3520,743,61,40,4,36,.900,3600000,0
24855,11475,740,72,22,1,21,.955,3600000,0
24855,65139,740,0,0,0,0,.00nan,0,0
24855,140000,743,0,0,0,0,.00nan,0,0
24857,1180,741,0,0,0,0,.00nan,0,0
24857,16599,741,97,21,0,21,1000,3600000,0
24857,26052,733,68,42,4,38,.905,3600000,0
24857,48440,733,0,0,0,0,.00nan,0,0
24859,17078,747,60,22,3,19,.864,3600000,0
24859,17409,2168,100,26,0,26,1000,3600000,0
24859,20742,2168,0,0,0,0,.00nan,0,0
24859,32600,747,0,0,0,0,.00nan,0,0
24861,3654,734,0,0,0,0,.00nan,0,0
24861,7162,1880,46,27,4,23,.852,3600000,0
24861,27247,734,75,24,1,23,.958,3600000,0
24861,67002,1880,0,0,0,0,.00nan,0,0
24863,616,748,0,0,0,0,.00nan,0,0
24863,992,749,0,0,0,0,.00nan,0,0
24863,16094,748,75,30,2,28,.933,3600000,0
24863,32897,749,46,31,5,26,.839,3600000,0
24865,848,732,100,29,0,29,1000,3600000,0
24865,3779,729,0,0,0,0,.00nan,0,0
24865,26909,729,69,27,2,25,.926,3542000,0
24865,55049,732,0,0,0,0,.00nan,0,0
24867,112,745,0,0,0,0,.00nan,0,0
24867,41784,745,71,26,2,24,.923,3544000,0
24867,48404,739,99,43,1,42,.977,3600000,0
24867,48581,739,0,0,0,0,.00nan,0,0
24869,848,732,100,25,0,25,1000,3600000,0
24869,26904,742,0,0,0,0,.00nan,0,0
24869,48292,742,73,48,4,44,.917,3600000,0
24869,55049,732,0,0,0,0,.00nan,0,0
24871,6090,744,68,26,2,24,.923,3600000,0
24871,11430,744,0,0,0,0,.00nan,0,0
24871,14995,737,0,0,0,0,.00nan,0,0
24871,50717,737,64,31,3,28,.903,3571000,0
24873,3768,738,0,0,0,0,.00nan,0,0
24873,7162,1880,70,41,5,36,.878,3600000,0
24873,66184,738,69,27,2,25,.926,3600000,0
24873,67002,1880,0,0,0,0,.00nan,0,0
24875,26052,733,97,26,0,26,1000,3600000,0
24875,26145,751,0,0,0,0,.00nan,0,0
24875,26334,751,65,26,2,24,.923,3554000,0
24875,48440,733,0,0,0,0,.00nan,0,0
24877,1818,2168,0,0,0,0,.00nan,0,0
24877,11475,740,99,27,0,27,1000,3779000,0
24877,17409,2168,82,26,1,25,.962,3779000,0
24877,65139,740,0,0,0,0,.00nan,0,0
24879,6635,736,74,28,2,26,.929,3900000,0
24879,26104,736,0,0,0,0,.00nan,0,0
24879,48404,739,75,24,2,22,.917,3900000,0
24879,48581,739,0,0,0,0,.00nan,0,0
24881,616,748,0,0,0,0,.00nan,0,0
24881,3779,729,0,0,0,0,.00nan,0,0
24881,16094,748,80,33,1,32,.970,3600000,0
24881,26909,729,45,23,4,19,.826,3600000,0
24883,1180,741,0,0,0,0,.00nan,0,0
24883,3520,743,89,46,3,43,.935,3541000,0
24883,16599,741,93,38,2,36,.947,3600000,0
24883,140000,743,0,0,0,0,.00nan,0,0
24885,112,745,0,0,0,0,.00nan,0,0
24885,17078,747,76,23,1,22,.957,3600000,0
24885,32600,747,0,0,0,0,.00nan,0,0
24885,41784,745,74,38,3,35,.921,3562000,0
24887,992,749,78,32,2,30,.938,3600000,0
24887,3654,734,0,0,0,0,.00nan,0,0
24887,27247,734,26,23,5,18,.783,3600000,0
24887,32897,749,0,0,0,0,.00nan,0,0
24889,1434,3789,95,28,1,27,.964,3600000,0
24889,2039,752,45,23,4,19,.826,3600000,0
24889,25972,752,0,0,0,0,.00nan,0,0
24889,32630,3789,0,0,0,0,.00nan,0,0
24891,2039,752,0,0,0,0,.00nan,0,0
24891,3768,738,72,18,1,17,.944,3600000,0
24891,25972,752,91,55,2,53,.964,3571000,0
24891,66184,738,0,0,0,0,.00nan,0,0
24893,1818,2168,70,33,3,30,.909,3555000,0
24893,3779,729,62,14,1,13,.929,3600000,0
24893,17409,2168,0,0,0,0,.00nan,0,0
24893,26909,729,0,0,0,0,.00nan,0,0
24895,992,749,0,0,0,0,.00nan,0,0
24895,14995,737,85,33,3,30,.909,3557000,0
24895,32897,749,74,31,2,29,.935,3600000,0
24895,50717,737,0,0,0,0,.00nan,0,0
24897,112,745,57,18,2,16,.889,3900000,0
24897,6635,736,0,0,0,0,.00nan,0,0
24897,26104,736,84,30,2,28,.933,3900000,0
24897,41784,745,0,0,0,0,.00nan,0,0
24899,11475,740,89,20,0,20,1000,3600000,0
24899,48404,739,0,0,0,0,.00nan,0,0
24899,48581,739,76,37,3,34,.919,3600000,0
24899,65139,740,0,0,0,0,.00nan,0,0
24901,616,748,48,39,5,34,.872,3600000,0
24901,3654,734,60,12,1,11,.917,3600000,0
24901,16094,748,0,0,0,0,.00nan,0,0
24901,27247,734,0,0,0,0,.00nan,0,0
24903,1180,741,100,25,0,25,1000,3600000,0
24903,16599,741,0,0,0,0,.00nan,0,0
24903,26904,742,71,34,4,30,.882,3600000,0
24903,48292,742,0,0,0,0,.00nan,0,0
24905,7162,1880,77,40,4,36,.900,3757000,0
24905,26145,751,66,24,3,21,.875,3757000,0
24905,26334,751,0,0,0,0,.00nan,0,0
24905,67002,1880,0,0,0,0,.00nan,0,0
24907,848,732,77,34,3,31,.912,3900000,0
24907,3520,743,0,0,0,0,.00nan,0,0
24907,55049,732,0,0,0,0,.00nan,0,0
24907,140000,743,68,33,3,30,.909,3900000,0
24909,1434,3789,0,0,0,0,.00nan,0,0
24909,6090,744,0,0,0,0,.00nan,0,0
24909,11430,744,77,25,2,23,.920,3600000,0
24909,32630,3789,35,28,6,22,.786,3600000,0
24911,17078,747,0,0,0,0,.00nan,0,0
24911,26052,733,100,40,1,39,.975,3600000,0
24911,32600,747,60,38,6,32,.842,3600000,0
24911,48440,733,0,0,0,0,.00nan,0,0
24913,992,749,100,36,0,36,1000,3600000,0
24913,17078,747,71,20,1,19,.950,3553000,0
24913,32600,747,0,0,0,0,.00nan,0,0
24913,32897,749,0,0,0,0,.00nan,0,0
24915,112,745,0,0,0,0,.00nan,0,0
24915,41784,745,82,23,1,22,.957,3600000,0
24915,48404,739,63,35,4,31,.886,3600000,0
24915,48581,739,0,0,0,0,.00nan,0,0
24917,1434,3789,68,32,4,28,.875,3900000,0
24917,26145,751,80,39,4,35,.897,3900000,0
24917,26334,751,0,0,0,0,.00nan,0,0
24917,32630,3789,0,0,0,0,.00nan,0,0
24919,3654,734,0,0,0,0,.00nan,0,0
24919,16599,741,67,23,2,21,.913,3600000,0
24919,16963,741,0,0,0,0,.00nan,0,0
24919,27247,734,57,22,3,19,.864,3555000,0
24921,1818,2168,0,0,0,0,.00nan,0,0
24921,3768,738,0,0,0,0,.00nan,0,0
24921,17409,2168,67,29,2,27,.931,3541000,0
24921,66184,738,100,28,0,28,1000,3600000,0
24923,3779,729,0,0,0,0,.00nan,0,0
24923,7162,1880,82,41,2,39,.951,3581000,0
24923,26909,729,83,27,1,26,.963,3600000,0
24923,67002,1880,0,0,0,0,.00nan,0,0
24925,2039,752,0,0,0,0,.00nan,0,0
24925,25972,752,93,35,1,34,.971,3600000,0
24925,26904,742,0,0,0,0,.00nan,0,0
24925,48292,742,100,27,0,27,1000,3600000,0
24927,848,732,0,0,0,0,.00nan,0,0
24927,26052,733,0,0,0,0,.00nan,0,0
24927,48440,733,93,34,1,33,.971,3577000,0
24927,55049,732,100,20,0,20,1000,3600000,0
24929,616,748,0,0,0,0,.00nan,0,0
24929,6635,736,0,0,0,0,.00nan,0,0
24929,16094,748,78,22,1,21,.955,3600000,0
24929,26104,736,87,41,4,37,.902,3600000,0
24931,3520,743,57,24,3,21,.875,3600000,0
24931,14995,737,0,0,0,0,.00nan,0,0
24931,50717,737,88,33,1,32,.970,3600000,0
24931,140000,743,0,0,0,0,.00nan,0,0
24933,6090,744,97,18,0,18,1000,3600000,0
24933,11430,744,0,0,0,0,.00nan,0,0
24933,11475,740,63,37,4,33,.892,3600000,0
24933,65139,740,0,0,0,0,.00nan,0,0
24935,112,745,0,0,0,0,.00nan,0,0
24935,848,732,0,0,0,0,.00nan,0,0
24935,41784,745,44,38,6,32,.842,3600000,0
24935,55049,732,63,26,3,23,.885,3600000,0
24937,3768,738,0,0,0,0,.00nan,0,0
24937,17078,747,0,0,0,0,.00nan,0,0
24937,32600,747,92,41,2,39,.951,3622000,0
24937,66184,738,77,24,1,23,.958,3622000,0
24939,14995,737,79,33,2,31,.939,3600000,0
24939,16599,741,0,0,0,0,.00nan,0,0
24939,16963,741,89,22,0,22,1000,3600000,0
24939,50717,737,0,0,0,0,.00nan,0,0
24941,2039,752,65,24,2,22,.917,3541000,0
24941,7162,1880,0,0,0,0,.00nan,0,0
24941,25972,752,0,0,0,0,.00nan,0,0
24941,67002,1880,97,37,1,36,.973,3600000,0
24943,992,749,32,33,6,27,.818,3600000,0
24943,1434,3789,0,0,0,0,.00nan,0,0
24943,32630,3789,82,35,2,33,.943,3600000,0
24943,32897,749,0,0,0,0,.00nan,0,0
24945,1818,2168,80,25,1,24,.960,3600000,0
24945,6635,736,40,32,5,27,.844,3600000,0
24945,17409,2168,0,0,0,0,.00nan,0,0
24945,26104,736,0,0,0,0,.00nan,0,0
24947,3779,729,74,24,1,23,.958,3600000,0
24947,26909,729,0,0,0,0,.00nan,0,0
24947,48404,739,0,0,0,0,.00nan,0,0
24947,48581,739,90,34,2,32,.941,3565000,0
24949,3654,734,82,36,2,34,.944,3600000,0
24949,6090,744,63,41,5,36,.878,3600000,0
24949,11430,744,0,0,0,0,.00nan,0,0
24949,27247,734,0,0,0,0,.00nan,0,0
24951,616,748,0,0,0,0,.00nan,0,0
24951,16094,748,70,37,3,34,.919,3574000,0
24951,26052,733,81,21,1,20,.952,3600000,0
24951,48440,733,0,0,0,0,.00nan,0,0
24953,3520,743,0,0,0,0,.00nan,0,0
24953,26145,751,0,0,0,0,.00nan,0,0
24953,26334,751,80,36,3,33,.917,3557000,0
24953,140000,743,84,23,1,22,.957,3600000,0
24955,11475,740,68,13,0,13,1000,1044000,0
24955,26904,742,79,25,1,24,.960,3600000,0
24955,48292,742,0,0,0,0,.00nan,0,0
24955,65139,740,44,39,6,33,.846,2556000,0
24957,3654,734,0,0,0,0,.00nan,0,0
24957,3768,738,91,29,1,28,.966,3600000,0
24957,27247,734,76,30,2,28,.933,3589000,0
24957,66184,738,0,0,0,0,.00nan,0,0
24959,26145,751,69,26,2,24,.923,3600000,0
24959,26334,751,0,0,0,0,.00nan,0,0
24959,48404,739,75,40,3,37,.925,3551000,0
24959,48581,739,0,0,0,0,.00nan,0,0
24961,616,748,0,0,0,0,.00nan,0,0
24961,16094,748,81,22,1,21,.955,3600000,0
24961,16599,741,0,0,0,0,.00nan,0,0
24961,16963,741,83,36,2,34,.944,3575000,0
24963,3779,729,0,0,0,0,.00nan,0,0
24963,14995,737,0,0,0,0,.00nan,0,0
24963,26909,729,52,32,4,28,.875,3600000,0
24963,50717,737,87,29,1,28,.966,3600000,0
24965,848,732,53,22,3,19,.864,3600000,0
24965,17078,747,62,18,2,16,.889,3600000,0
24965,32600,747,0,0,0,0,.00nan,0,0
24965,55049,732,0,0,0,0,.00nan,0,0
24967,1434,3789,53,19,2,17,.895,3856000,0
24967,2039,752,86,34,2,32,.941,3900000,0
24967,25972,752,0,0,0,0,.00nan,0,0
24967,32630,3789,0,0,0,0,.00nan,0,0
24969,112,745,0,0,0,0,.00nan,0,0
24969,26904,742,0,0,0,0,.00nan,0,0
24969,41784,745,100,23,0,23,1000,3600000,0
24969,48292,742,70,30,3,27,.900,3600000,0
24971,11475,740,64,38,4,34,.895,3600000,0
24971,26052,733,73,23,1,22,.957,3600000,0
24971,48440,733,0,0,0,0,.00nan,0,0
24971,65139,740,0,0,0,0,.00nan,0,0
24973,3520,743,11,18,6,12,.667,2464000,0
24973,6090,744,65,32,3,29,.906,3600000,0
24973,11430,744,0,0,0,0,.00nan,0,0
24973,140000,743,57,8,0,8,1000,1136000,0
24975,992,749,0,0,0,0,.00nan,0,0
24975,1818,2168,0,0,0,0,.00nan,0,0
24975,17409,2168,75,33,3,30,.909,3716000,0
24975,32897,749,59,22,2,20,.909,3716000,0
24977,6635,736,0,0,0,0,.00nan,0,0
24977,7162,1880,78,31,2,29,.935,3600000,0
24977,26104,736,61,29,3,26,.897,3544000,0
24977,67002,1880,0,0,0,0,.00nan,0,0
24979,1818,2168,64,35,4,31,.886,3546000,0
24979,17409,2168,0,0,0,0,.00nan,0,0
24979,48404,739,0,0,0,0,.00nan,0,0
24979,48581,739,64,30,3,27,.900,3600000,0
24981,7162,1880,0,0,0,0,.00nan,0,0
24981,11475,740,69,25,2,23,.920,3600000,0
24981,65139,740,0,0,0,0,.00nan,0,0
24981,67002,1880,87,38,3,35,.921,3565000,0
24983,16599,741,65,42,5,37,.881,3558000,0
24983,16963,741,0,0,0,0,.00nan,0,0
24983,17078,747,0,0,0,0,.00nan,0,0
24983,32600,747,44,22,4,18,.818,3600000,0
24985,848,732,0,0,0,0,.00nan,0,0
24985,3520,743,0,0,0,0,.00nan,0,0
24985,55049,732,60,26,3,23,.885,3600000,0
24985,140000,743,69,44,4,40,.909,3549000,0
24987,992,749,77,25,1,24,.960,3600000,0
24987,6090,744,32,4,2,2,.500,606000,0
24987,11430,744,8,19,6,13,.684,2994000,0
24987,32897,749,0,0,0,0,.00nan,0,0
24989,3654,734,83,18,0,18,1000,3600000,0
24989,3779,729,65,39,4,35,.897,3600000,0
24989,26909,729,0,0,0,0,.00nan,0,0
24989,27247,734,0,0,0,0,.00nan,0,0
24991,112,745,0,0,0,0,.00nan,0,0
24991,6635,736,69,28,2,26,.929,3600000,0
24991,26104,736,0,0,0,0,.00nan,0,0
24991,41784,745,47,28,4,24,.857,3518000,0
24993,26052,733,0,0,0,0,.00nan,0,0
24993,26145,751,0,0,0,0,.00nan,0,0
24993,26334,751,68,23,2,21,.913,3600000,0
24993,48440,733,85,46,3,43,.935,3600000,0
24995,3768,738,0,0,0,0,.00nan,0,0
24995,14995,737,81,36,3,33,.917,3550000,0
24995,50717,737,0,0,0,0,.00nan,0,0
24995,66184,738,77,27,1,26,.963,3600000,0
24997,616,748,76,27,1,26,.963,3600000,0
24997,2039,752,0,0,0,0,.00nan,0,0
24997,16094,748,0,0,0,0,.00nan,0,0
24997,25972,752,54,35,5,30,.857,3600000,0
24999,1434,3789,0,0,0,0,.00nan,0,0
24999,26904,742,67,21,2,19,.905,3600000,0
24999,32630,3789,98,36,1,35,.972,3600000,0
24999,48292,742,0,0,0,0,.00nan,0,0
25000,15143,572,0,0,0,0,.00nan,0,0
25000,15191,562,0,0,0,0,.00nan,0,0
25000,29939,562,65,30,3,27,.900,3900000,0
25000,31909,572,70,34,3,31,.912,3900000,0
25001,514,566,66,15,1,14,.933,3600000,0
25001,4520,575,52,42,5,37,.881,3600000,0
25001,10231,575,0,0,0,0,.00nan,0,0
25001,49537,566,0,0,0,0,.00nan,0,0
25002,677,564,100,42,1,41,.976,3600000,0
25002,7095,574,49,18,3,15,.833,3573000,0
25002,10180,564,0,0,0,0,.00nan,0,0
25002,32108,574,0,0,0,0,.00nan,0,0
25003,988,568,70,30,2,28,.933,3581000,0
25003,1073,571,0,0,0,0,.00nan,0,0
25003,26709,571,72,20,1,19,.950,3600000,0
25003,30896,568,0,0,0,0,.00nan,0,0
25004,5566,570,0,0,0,0,.00nan,0,0
25004,32024,573,0,0,0,0,.00nan,0,0
25004,38070,573,90,32,2,30,.938,3600000,0
25004,52471,570,67,45,4,41,.911,3523000,0
25005,2024,569,0,0,0,0,.00nan,0,0
25005,10167,569,66,18,1,17,.944,3600000,0
25005,10252,565,31,15,4,11,.733,1155000,0
25005,40928,565,67,13,0,13,1000,2445000,0
25006,9960,578,0,0,0,0,.00nan,0,0
25006,14561,578,89,25,1,24,.960,3600000,0
25006,26830,577,0,0,0,0,.00nan,0,0
25006,31893,577,86,48,3,45,.938,3516000,0
25007,514,566,0,0,0,0,.00nan,0,0
25007,15143,572,77,34,3,31,.912,3600000,0
25007,31909,572,0,0,0,0,.00nan,0,0
25007,49537,566,86,15,0,15,1000,3600000,0
25008,988,568,82,28,1,27,.964,3569000,0
25008,4520,575,96,29,0,29,1000,3600000,0
25008,10231,575,0,0,0,0,.00nan,0,0
25008,30896,568,0,0,0,0,.00nan,0,0
25009,10111,576,0,0,0,0,.00nan,0,0
25009,15305,576,75,31,2,29,.935,3582000,0
25009,26830,577,0,0,0,0,.00nan,0,0
25009,31893,577,77,27,1,26,.963,3600000,0
25010,2826,571,0,0,0,0,.00nan,0,0
25010,26709,571,99,42,1,41,.976,3600000,0
25010,32024,573,0,0,0,0,.00nan,0,0
25010,38070,573,69,26,2,24,.923,3600000,0
25011,5566,570,45,23,5,18,.783,3600000,0
25011,10252,565,0,0,0,0,.00nan,0,0
25011,15209,565,100,44,1,43,.977,3600000,0
25011,52471,570,0,0,0,0,.00nan,0,0
25012,5079,574,56,18,2,16,.889,3600000,0
25012,7095,574,0,0,0,0,.00nan,0,0
25012,15191,562,73,37,3,34,.919,3600000,0
25012,29939,562,0,0,0,0,.00nan,0,0
25013,677,564,80,32,2,30,.938,3600000,0
25013,9960,578,0,0,0,0,.00nan,0,0
25013,10180,564,0,0,0,0,.00nan,0,0
25013,14561,578,96,32,1,31,.969,3600000,0
25014,5079,574,0,0,0,0,.00nan,0,0
25014,7095,574,80,30,2,28,.933,3900000,0
25014,26830,577,76,25,2,23,.920,3900000,0
25014,31893,577,0,0,0,0,.00nan,0,0
25015,4520,575,0,0,0,0,.00nan,0,0
25015,9960,578,80,31,1,30,.968,3600000,0
25015,10231,575,62,24,2,22,.917,3559000,0
25015,14561,578,0,0,0,0,.00nan,0,0
25016,514,566,0,0,0,0,.00nan,0,0
25016,677,564,0,0,0,0,.00nan,0,0
25016,10180,564,64,35,3,32,.914,3900000,0
25016,49537,566,59,24,3,21,.875,3900000,0
25017,988,568,0,0,0,0,.00nan,0,0
25017,5566,570,0,0,0,0,.00nan,0,0
25017,30896,568,67,26,2,24,.923,3600000,0
25017,52471,570,89,47,3,44,.936,3590000,0
25018,2024,569,68,30,3,27,.900,3600000,0
25018,10167,569,0,0,0,0,.00nan,0,0
25018,15143,572,0,0,0,0,.00nan,0,0
25018,31909,572,56,39,5,34,.872,3600000,0
25019,10111,576,78,30,2,28,.933,3600000,0
25019,15191,562,0,0,0,0,.00nan,0,0
25019,15305,576,0,0,0,0,.00nan,0,0
25019,29939,562,74,41,4,37,.902,3562000,0
25020,2826,571,0,0,0,0,.00nan,0,0
25020,26709,571,92,31,1,30,.968,3600000,0
25020,32024,573,78,22,2,20,.909,3546000,0
25020,38070,573,0,0,0,0,.00nan,0,0
25021,677,564,98,56,2,54,.964,3582000,0
25021,5079,574,83,17,0,17,1000,3600000,0
25021,7095,574,0,0,0,0,.00nan,0,0
25021,10180,564,0,0,0,0,.00nan,0,0
25022,988,568,0,0,0,0,.00nan,0,0
25022,10111,576,66,22,2,20,.909,3600000,0
25022,15305,576,0,0,0,0,.00nan,0,0
25022,30896,568,52,29,4,25,.862,3583000,0
25023,15191,562,0,0,0,0,.00nan,0,0
25023,26830,577,0,0,0,0,.00nan,0,0
25023,29939,562,97,41,2,39,.951,3900000,0
25023,31893,577,69,25,2,23,.920,3900000,0
25024,10252,565,0,0,0,0,.00nan,0,0
25024,15209,565,93,44,1,43,.977,3779000,0
25024,32024,573,54,15,2,13,.867,3779000,0
25024,38070,573,0,0,0,0,.00nan,0,0
25025,4520,575,79,30,3,27,.900,3600000,0
25025,10231,575,0,0,0,0,.00nan,0,0
25025,15143,572,83,46,4,42,.913,3556000,0
25025,31909,572,0,0,0,0,.00nan,0,0
25026,2024,569,93,43,3,40,.930,3546000,0
25026,9960,578,0,0,0,0,.00nan,0,0
25026,10167,569,0,0,0,0,.00nan,0,0
25026,14561,578,66,25,2,23,.920,3600000,0
25027,4520,575,0,0,0,0,.00nan,0,0
25027,10231,575,95,36,2,34,.944,3600000,0
25027,26830,577,27,21,5,16,.762,3600000,0
25027,31893,577,0,0,0,0,.00nan,0,0
25028,677,564,53,34,5,29,.853,3900000,0
25028,10180,564,0,0,0,0,.00nan,0,0
25028,15143,572,55,34,5,29,.853,3900000,0
25028,31909,572,0,0,0,0,.00nan,0,0
25029,988,568,78,34,2,32,.941,3600000,0
25029,5079,574,90,19,0,19,1000,3600000,0
25029,7095,574,0,0,0,0,.00nan,0,0
25029,30896,568,0,0,0,0,.00nan,0,0
25030,2826,571,0,0,0,0,.00nan,0,0
25030,15191,562,0,0,0,0,.00nan,0,0
25030,26709,571,62,22,2,20,.909,3600000,0
25030,29939,562,43,32,5,27,.844,3600000,0
25031,10111,576,0,0,0,0,.00nan,0,0
25031,10252,565,22,22,6,16,.727,1418000,0
25031,15209,565,64,27,3,24,.889,2182000,0
25031,15305,576,37,10,3,7,.700,3600000,0
25032,514,566,68,35,3,32,.914,3588000,0
25032,32024,573,0,0,0,0,.00nan,0,0
25032,32749,566,0,0,0,0,.00nan,0,0
25032,38070,573,74,21,1,20,.952,3600000,0
25033,5566,570,83,26,1,25,.962,3566000,0
25033,9960,578,0,0,0,0,.00nan,0,0
25033,14561,578,100,31,0,31,1000,3600000,0
25033,52471,570,0,0,0,0,.00nan,0,0
25034,514,566,0,0,0,0,.00nan,0,0
25034,2826,571,0,0,0,0,.00nan,0,0
25034,26709,571,100,55,3,52,.945,3900000,0
25034,32749,566,47,18,3,15,.833,3900000,0
25035,26830,577,0,0,0,0,.00nan,0,0
25035,31893,577,73,28,2,26,.929,3561000,0
25035,32024,573,66,19,1,18,.947,3600000,0
25035,38070,573,0,0,0,0,.00nan,0,0
25036,2024,569,0,0,0,0,.00nan,0,0
25036,4520,575,77,28,2,26,.929,3600000,0
25036,10167,569,61,27,3,24,.889,3595000,0
25036,10231,575,0,0,0,0,.00nan,0,0
25037,988,568,0,0,0,0,.00nan,0,0
25037,15143,572,0,0,0,0,.00nan,0,0
25037,30896,568,48,35,5,30,.857,3600000,0
25037,31909,572,69,25,2,23,.920,3600000,0
25038,10111,576,37,17,3,14,.824,3600000,0
25038,15191,562,100,39,0,39,1000,3600000,0
25038,15305,576,0,0,0,0,.00nan,0,0
25038,29939,562,0,0,0,0,.00nan,0,0
25039,5079,574,0,0,0,0,.00nan,0,0
25039,5566,570,0,0,0,0,.00nan,0,0
25039,7095,574,82,34,2,32,.941,3600000,0
25039,52471,570,45,22,4,18,.818,3551000,0
25040,677,564,0,0,0,0,.00nan,0,0
25040,10180,564,73,32,2,30,.938,3689000,0
25040,10252,565,80,39,3,36,.923,3689000,0
25040,15209,565,0,0,0,0,.00nan,0,0
25041,988,568,0,0,0,0,.00nan,0,0
25041,4520,575,85,29,1,28,.966,3600000,0
25041,10231,575,0,0,0,0,.00nan,0,0
25041,30896,568,97,38,2,36,.947,3600000,0
25042,677,564,0,0,0,0,.00nan,0,0
25042,2024,569,0,0,0,0,.00nan,0,0
25042,10167,569,71,41,4,37,.902,3600000,0
25042,10180,564,89,26,0,26,1000,3600000,0
25043,10111,576,73,25,1,24,.960,3600000,0
25043,15305,576,0,0,0,0,.00nan,0,0
25043,26830,577,0,0,0,0,.00nan,0,0
25043,31893,577,60,47,5,42,.894,3600000,0
25044,10252,565,0,0,0,0,.00nan,0,0
25044,15191,562,50,23,4,19,.826,3600000,0
25044,15209,565,99,37,1,36,.973,3600000,0
25044,29939,562,0,0,0,0,.00nan,0,0
25045,514,566,79,23,1,22,.957,3600000,0
25045,9960,578,0,0,0,0,.00nan,0,0
25045,14561,578,43,35,5,30,.857,3600000,0
25045,32749,566,0,0,0,0,.00nan,0,0
25046,677,564,0,0,0,0,.00nan,0,0
25046,5566,570,83,33,1,32,.970,3543000,0
25046,10180,564,100,23,0,23,1000,3600000,0
25046,52471,570,0,0,0,0,.00nan,0,0
25047,2826,571,0,0,0,0,.00nan,0,0
25047,15143,572,77,46,4,42,.913,3890000,0
25047,26709,571,78,37,3,34,.919,3875000,0
25047,31909,572,0,0,0,0,.00nan,0,0
25048,988,568,95,39,2,37,.949,3893000,0
25048,10252,565,0,0,0,0,.00nan,0,0
25048,15209,565,68,29,2,27,.931,3900000,0
25048,30896,568,0,0,0,0,.00nan,0,0
25049,2024,569,52,31,4,27,.871,3600000,0
25049,10167,569,0,0,0,0,.00nan,0,0
25049,26830,577,41,12,3,9,.750,475000,0
25049,31893,577,76,34,2,32,.941,3068000,0
25050,514,566,76,22,1,21,.955,3600000,0
25050,4520,575,91,42,3,39,.929,3600000,0
25050,10231,575,0,0,0,0,.00nan,0,0
25050,32749,566,0,0,0,0,.00nan,0,0
25051,5566,570,0,0,0,0,.00nan,0,0
25051,9960,578,100,31,0,31,1000,3600000,0
25051,14561,578,0,0,0,0,.00nan,0,0
25051,52471,570,68,21,1,20,.952,3571000,0
25052,2826,571,0,0,0,0,.00nan,0,0
25052,10111,576,0,0,0,0,.00nan,0,0
25052,15305,576,69,33,4,29,.879,3556000,0
25052,26709,571,75,28,2,26,.929,3600000,0
25053,15191,562,0,0,0,0,.00nan,0,0
25053,29939,562,82,38,3,35,.921,3600000,0
25053,32024,573,0,0,0,0,.00nan,0,0
25053,38070,573,100,28,0,28,1000,3600000,0
25054,5079,574,58,30,4,26,.867,3600000,0
25054,7095,574,0,0,0,0,.00nan,0,0
25054,15143,572,96,24,0,24,1000,3600000,0
25054,31909,572,0,0,0,0,.00nan,0,0
25055,514,566,0,0,0,0,.00nan,0,0
25055,15191,562,65,30,3,27,.900,3600000,0
25055,29939,562,0,0,0,0,.00nan,0,0
25055,32749,566,62,32,4,28,.875,3586000,0
25056,677,564,0,0,0,0,.00nan,0,0
25056,4520,575,0,0,0,0,.00nan,0,0
25056,10180,564,72,34,3,31,.912,3836000,0
25056,10231,575,73,32,2,30,.938,3836000,0
25057,988,568,0,0,0,0,.00nan,0,0
25057,9960,578,62,31,3,28,.903,3518000,0
25057,14561,578,0,0,0,0,.00nan,0,0
25057,30896,568,96,34,1,33,.971,3600000,0
25058,5566,570,74,22,1,21,.955,3600000,0
25058,26830,577,73,32,2,30,.938,3600000,0
25058,31893,577,0,0,0,0,.00nan,0,0
25058,52471,570,0,0,0,0,.00nan,0,0
25059,10252,565,70,25,2,23,.920,3600000,0
25059,15143,572,78,42,3,39,.929,3543000,0
25059,15209,565,0,0,0,0,.00nan,0,0
25059,31909,572,0,0,0,0,.00nan,0,0
25060,10111,576,93,34,1,33,.971,3600000,0
25060,15305,576,0,0,0,0,.00nan,0,0
25060,32024,573,0,0,0,0,.00nan,0,0
25060,38070,573,53,27,4,23,.852,3600000,0
25061,2826,571,0,0,0,0,.00nan,0,0
25061,5079,574,0,0,0,0,.00nan,0,0
25061,7095,574,54,16,2,14,.875,3900000,0
25061,26709,571,97,48,2,46,.958,3900000,0
25062,2024,569,0,0,0,0,.00nan,0,0
25062,5079,574,0,0,0,0,.00nan,0,0
25062,7095,574,86,28,2,26,.929,3746000,0
25062,10167,569,85,44,3,41,.932,3746000,0
25063,514,566,69,17,1,16,.941,3600000,0
25063,5566,570,0,0,0,0,.00nan,0,0
25063,32749,566,0,0,0,0,.00nan,0,0
25063,52471,570,64,33,3,30,.909,3518000,0
25064,2826,571,88,28,1,27,.964,3600000,0
25064,10252,565,0,0,0,0,.00nan,0,0
25064,15209,565,88,42,3,39,.929,3562000,0
25064,26709,571,0,0,0,0,.00nan,0,0
25065,4520,575,69,19,1,18,.947,3600000,0
25065,9960,578,0,0,0,0,.00nan,0,0
25065,10231,575,0,0,0,0,.00nan,0,0
25065,14561,578,74,36,2,34,.944,3600000,0
25066,9960,578,0,0,0,0,.00nan,0,0
25066,14561,578,77,33,2,31,.939,3600000,0
25066,26830,577,0,0,0,0,.00nan,0,0
25066,31893,577,43,36,5,31,.861,3600000,0
25067,514,566,82,34,2,32,.941,3600000,0
25067,2024,569,47,21,3,18,.857,3581000,0
25067,10167,569,0,0,0,0,.00nan,0,0
25067,32749,566,0,0,0,0,.00nan,0,0
25068,4520,575,68,34,3,31,.912,3571000,0
25068,10111,576,0,0,0,0,.00nan,0,0
25068,10231,575,0,0,0,0,.00nan,0,0
25068,15305,576,85,33,2,31,.939,3600000,0
25069,5079,574,0,0,0,0,.00nan,0,0
25069,7095,574,66,15,1,14,.933,3600000,0
25069,10252,565,49,47,6,41,.872,3600000,0
25069,15209,565,0,0,0,0,.00nan,0,0
25070,2826,571,0,0,0,0,.00nan,0,0
25070,26709,571,74,26,3,23,.885,3559000,0
25070,32024,573,0,0,0,0,.00nan,0,0
25070,38070,573,70,25,2,23,.920,3600000,0
25071,677,564,74,21,1,20,.952,3600000,0
25071,10180,564,0,0,0,0,.00nan,0,0
25071,15143,572,58,28,3,25,.893,3538000,0
25071,31909,572,0,0,0,0,.00nan,0,0
25072,5566,570,0,0,0,0,.00nan,0,0
25072,15191,562,90,32,1,31,.969,3600000,0
25072,29939,562,0,0,0,0,.00nan,0,0
25072,52471,570,86,35,2,33,.943,3560000,0
25073,15143,572,0,0,0,0,.00nan,0,0
25073,31909,572,46,30,5,25,.833,3600000,0
25073,32024,573,50,15,2,13,.867,3600000,0
25073,38070,573,0,0,0,0,.00nan,0,0
25074,988,568,0,0,0,0,.00nan,0,0
25074,2024,569,0,0,0,0,.00nan,0,0
25074,10167,569,90,21,0,21,1000,3600000,0
25074,30896,568,81,27,1,26,.963,3588000,0
25075,5079,574,37,19,4,15,.789,3600000,0
25075,7095,574,0,0,0,0,.00nan,0,0
25075,15191,562,82,32,2,30,.938,3600000,0
25075,29939,562,0,0,0,0,.00nan,0,0
25076,4520,575,0,0,0,0,.00nan,0,0
25076,10231,575,64,22,2,20,.909,3900000,0
25076,10252,565,0,0,0,0,.00nan,0,0
25076,15209,565,80,37,2,35,.946,3900000,0
25077,2826,571,93,28,1,27,.964,3600000,0
25077,5566,570,68,27,2,25,.926,3555000,0
25077,26709,571,0,0,0,0,.00nan,0,0
25077,52471,570,0,0,0,0,.00nan,0,0
25078,9960,578,0,0,0,0,.00nan,0,0
25078,10111,576,64,16,1,15,.938,3600000,0
25078,14561,578,61,25,2,23,.920,3576000,0
25078,15305,576,0,0,0,0,.00nan,0,0
25079,677,564,0,0,0,0,.00nan,0,0
25079,10180,564,46,22,3,19,.864,3575000,0
25079,26830,577,100,40,1,39,.975,3600000,0
25079,31893,577,0,0,0,0,.00nan,0,0
25081,2024,569,91,17,0,17,1000,3600000,0
25081,9960,578,79,32,2,30,.938,3555000,0
25081,10167,569,0,0,0,0,.00nan,0,0
25081,14561,578,0,0,0,0,.00nan,0,0
25082,2826,571,0,0,0,0,.00nan,0,0
25082,10111,576,0,0,0,0,.00nan,0,0
25082,15305,576,85,24,1,23,.958,3876000,0
25082,26709,571,70,23,2,21,.913,3876000,0
25085,15143,572,44,17,3,14,.824,3562000,0
25085,26830,577,0,0,0,0,.00nan,0,0
25085,31893,577,82,38,2,36,.947,3600000,0
25085,31909,572,0,0,0,0,.00nan,0,0
25086,2024,569,80,35,2,33,.943,3600000,0
25086,2826,571,0,0,0,0,.00nan,0,0
25086,10167,569,0,0,0,0,.00nan,0,0
25086,26709,571,79,31,3,28,.903,3558000,0
25087,10111,576,52,25,4,21,.840,3900000,0
25087,10252,565,46,25,4,21,.840,3900000,0
25087,15209,565,0,0,0,0,.00nan,0,0
25087,15305,576,0,0,0,0,.00nan,0,0
25088,9960,578,73,30,2,28,.933,3600000,0
25088,14561,578,0,0,0,0,.00nan,0,0
25088,15191,562,68,32,3,29,.906,3546000,0
25088,29939,562,0,0,0,0,.00nan,0,0
25089,988,568,0,0,0,0,.00nan,0,0
25089,5079,574,47,22,3,19,.864,3587000,0
25089,7095,574,0,0,0,0,.00nan,0,0
25089,30896,568,68,27,2,25,.926,3600000,0
25090,2826,571,94,21,0,21,1000,3600000,0
25090,4520,575,60,25,2,23,.920,3517000,0
25090,10231,575,0,0,0,0,.00nan,0,0
25090,26709,571,0,0,0,0,.00nan,0,0
25091,5566,570,90,19,0,19,1000,3600000,0
25091,26830,577,54,41,5,36,.878,3293000,0
25091,31893,577,39,1,1,0,.000,307000,0
25091,52471,570,0,0,0,0,.00nan,0,0
25092,514,566,50,37,4,33,.892,3600000,0
25092,10111,576,0,0,0,0,.00nan,0,0
25092,15305,576,66,30,3,27,.900,3600000,0
25092,32749,566,0,0,0,0,.00nan,0,0
25093,2024,569,49,6,1,5,.833,281000,0
25093,10167,569,41,40,6,34,.850,3319000,0
25093,32024,573,0,0,0,0,.00nan,0,0
25093,38070,573,46,26,4,22,.846,3600000,0
25094,677,564,72,22,2,20,.909,3547000,0
25094,10180,564,0,0,0,0,.00nan,0,0
25094,15191,562,0,0,0,0,.00nan,0,0
25094,29939,562,99,36,1,35,.972,3600000,0
25095,9960,578,0,0,0,0,.00nan,0,0
25095,14561,578,42,17,3,14,.824,3545000,0
25095,15143,572,95,40,2,38,.950,3600000,0
25095,31909,572,0,0,0,0,.00nan,0,0
25096,677,564,85,32,1,31,.969,3900000,0
25096,10111,576,0,0,0,0,.00nan,0,0
25096,10180,564,0,0,0,0,.00nan,0,0
25096,15305,576,74,25,1,24,.960,3900000,0
25098,26830,577,0,0,0,0,.00nan,0,0
25098,31893,577,56,27,3,24,.889,3600000,0
25098,32024,573,55,17,2,15,.882,3600000,0
25098,38070,573,0,0,0,0,.00nan,0,0
25099,988,568,53,36,5,31,.861,3570000,0
25099,5566,570,69,37,4,33,.892,3600000,0
25099,30896,568,0,0,0,0,.00nan,0,0
25099,52471,570,0,0,0,0,.00nan,0,0
25100,4520,575,62,45,6,39,.867,3600000,0
25100,10231,575,0,0,0,0,.00nan,0,0
25100,15191,562,0,0,0,0,.00nan,0,0
25100,29939,562,73,34,4,30,.882,3600000,0
25101,2826,571,41,32,6,26,.813,3600000,0
25101,26709,571,0,0,0,0,.00nan,0,0
25101,26830,577,0,0,0,0,.00nan,0,0
25101,31893,577,94,31,1,30,.968,3600000,0
25102,9960,578,0,0,0,0,.00nan,0,0
25102,10252,565,0,0,0,0,.00nan,0,0
25102,14561,578,65,40,5,35,.875,3600000,0
25102,15209,565,65,35,4,31,.886,3600000,0
25103,5079,574,0,0,0,0,.00nan,0,0
25103,7095,574,87,17,0,17,1000,3600000,0
25103,10111,576,0,0,0,0,.00nan,0,0
25103,15305,576,50,41,6,35,.854,3600000,0
25104,2024,569,0,0,0,0,.00nan,0,0
25104,4520,575,84,35,2,33,.943,3900000,0
25104,10167,569,58,22,2,20,.909,3900000,0
25104,10231,575,0,0,0,0,.00nan,0,0
25105,514,566,70,19,1,18,.947,3600000,0
25105,26830,577,88,45,3,42,.933,3517000,0
25105,31893,577,0,0,0,0,.00nan,0,0
25105,32749,566,0,0,0,0,.00nan,0,0
25106,5566,570,0,0,0,0,.00nan,0,0
25106,15143,572,51,28,3,25,.893,3600000,0
25106,31909,572,0,0,0,0,.00nan,0,0
25106,52471,570,58,22,2,20,.909,3600000,0
25107,5079,574,0,0,0,0,.00nan,0,0
25107,7095,574,47,21,3,18,.857,3548000,0
25107,10111,576,67,27,2,25,.926,3600000,0
25107,15305,576,0,0,0,0,.00nan,0,0
25108,2024,569,77,34,2,32,.941,3600000,0
25108,4520,575,0,0,0,0,.00nan,0,0
25108,10167,569,0,0,0,0,.00nan,0,0
25108,10231,575,56,28,3,25,.893,3529000,0
25109,2826,571,0,0,0,0,.00nan,0,0
25109,15143,572,0,0,0,0,.00nan,0,0
25109,26709,571,48,32,4,28,.875,3600000,0
25109,31909,572,95,37,1,36,.973,3600000,0
25110,514,566,0,0,0,0,.00nan,0,0
25110,10252,565,0,0,0,0,.00nan,0,0
25110,15209,565,61,18,1,17,.944,3600000,0
25110,32749,566,73,44,4,40,.909,3600000,0
25111,677,564,100,34,0,34,1000,3600000,0
25111,10180,564,0,0,0,0,.00nan,0,0
25111,32024,573,0,0,0,0,.00nan,0,0
25111,38070,573,52,17,2,15,.882,3545000,0
25112,988,568,0,0,0,0,.00nan,0,0
25112,9960,578,50,23,3,20,.870,3600000,0
25112,14561,578,0,0,0,0,.00nan,0,0
25112,30896,568,52,34,4,30,.882,3544000,0
25451,10111,576,68,27,2,25,.926,3600000,0
25451,15305,576,0,0,0,0,.00nan,0,0
25451,26830,577,0,0,0,0,.00nan,0,0
25451,31893,577,43,28,5,23,.821,3600000,0
25453,677,564,80,33,2,31,.939,3600000,0
25453,1073,571,0,0,0,0,.00nan,0,0
25453,10180,564,0,0,0,0,.00nan,0,0
25453,26709,571,59,36,4,32,.889,3536000,0
25455,4520,575,47,23,4,19,.826,3575000,0
25455,7095,574,58,28,3,25,.893,3600000,0
25455,32108,574,0,0,0,0,.00nan,0,0
25455,34500,575,0,0,0,0,.00nan,0,0
25457,2024,569,53,24,3,21,.875,3569000,0
25457,9960,578,0,0,0,0,.00nan,0,0
25457,10167,569,0,0,0,0,.00nan,0,0
25457,14561,578,58,21,2,19,.905,3600000,0
25459,10252,565,65,44,4,40,.909,3891000,0
25459,15191,562,0,0,0,0,.00nan,0,0
25459,29939,562,64,30,4,26,.867,3900000,0
25459,40928,565,0,0,0,0,.00nan,0,0
25461,514,566,0,0,0,0,.00nan,0,0
25461,988,568,85,39,2,37,.949,3600000,0
25461,30896,568,0,0,0,0,.00nan,0,0
25461,32749,566,42,20,3,17,.850,3598000,0
25463,15143,572,0,0,0,0,.00nan,0,0
25463,31909,572,41,25,4,21,.840,3544000,0
25463,32024,573,0,0,0,0,.00nan,0,0
25463,38070,573,63,27,3,24,.889,3600000,0
25465,4520,575,0,0,0,0,.00nan,0,0
25465,5566,570,0,0,0,0,.00nan,0,0
25465,34500,575,75,31,2,29,.935,3600000,0
25465,52471,570,61,27,3,24,.889,3592000,0
25467,988,568,0,0,0,0,.00nan,0,0
25467,30896,568,60,24,2,22,.917,3549000,0
25467,32024,573,82,29,1,28,.966,3600000,0
25467,38070,573,0,0,0,0,.00nan,0,0
25469,10111,576,0,0,0,0,.00nan,0,0
25469,15305,576,52,21,3,18,.857,3600000,0
25469,26830,577,86,51,5,46,.902,3562000,0
25469,31893,577,0,0,0,0,.00nan,0,0
25471,514,566,64,25,2,23,.920,3600000,0
25471,677,564,0,0,0,0,.00nan,0,0
25471,10180,564,55,36,4,32,.889,3600000,0
25471,32749,566,0,0,0,0,.00nan,0,0
25473,7095,574,0,0,0,0,.00nan,0,0
25473,15143,572,71,28,2,26,.929,3600000,0
25473,31909,572,0,0,0,0,.00nan,0,0
25473,32108,574,45,22,4,18,.818,3568000,0
25475,2024,569,0,0,0,0,.00nan,0,0
25475,10167,569,92,27,0,27,1000,3600000,0
25475,10252,565,0,0,0,0,.00nan,0,0
25475,40928,565,69,37,3,34,.919,3600000,0
25477,1073,571,0,0,0,0,.00nan,0,0
25477,9960,578,64,19,1,18,.947,3600000,0
25477,14561,578,0,0,0,0,.00nan,0,0
25477,26709,571,68,36,3,33,.917,3600000,0
25479,677,564,20,21,6,15,.714,3600000,0
25479,10180,564,0,0,0,0,.00nan,0,0
25479,10252,565,100,45,1,44,.978,3600000,0
25479,40928,565,0,0,0,0,.00nan,0,0
25483,2024,569,0,0,0,0,.00nan,0,0
25483,10167,569,80,38,3,35,.921,3600000,0
25483,15143,572,0,0,0,0,.00nan,0,0
25483,31909,572,52,30,4,26,.867,3553000,0
25485,1073,571,0,0,0,0,.00nan,0,0
25485,10111,576,59,25,3,22,.880,3557000,0
25485,15305,576,0,0,0,0,.00nan,0,0
25485,26709,571,100,41,2,39,.951,3600000,0
25487,988,568,0,0,0,0,.00nan,0,0
25487,15191,562,0,0,0,0,.00nan,0,0
25487,29939,562,86,38,2,36,.947,3900000,0
25487,30896,568,63,18,2,16,.889,3900000,0
25497,15191,562,98,34,1,33,.971,3600000,0
25497,26830,577,0,0,0,0,.00nan,0,0
25497,29939,562,0,0,0,0,.00nan,0,0
25497,31893,577,94,42,2,40,.952,3592000,0
25501,1073,571,15,23,6,17,.739,2838000,0
25501,9960,578,76,34,3,31,.912,3600000,0
25501,14561,578,0,0,0,0,.00nan,0,0
25501,26709,571,53,3,0,3,1000,762000,0
25503,2024,569,99,45,2,43,.956,3622000,0
25503,10111,576,0,0,0,0,.00nan,0,0
25503,10167,569,0,0,0,0,.00nan,0,0
25503,15305,576,47,18,3,15,.833,3622000,0
25505,988,568,75,26,2,24,.923,3642000,0
25505,10252,565,0,0,0,0,.00nan,0,0
25505,30896,568,0,0,0,0,.00nan,0,0
25505,40928,565,75,30,3,27,.900,3638000,0
25507,2024,569,98,35,2,33,.943,3562000,0
25507,9960,578,0,0,0,0,.00nan,0,0
25507,10167,569,0,0,0,0,.00nan,0,0
25507,14561,578,83,31,1,30,.968,3600000,0
25513,514,566,0,0,0,0,.00nan,0,0
25513,1073,571,0,0,0,0,.00nan,0,0
25513,26709,571,55,31,4,27,.871,3600000,0
25513,32749,566,95,22,0,22,1000,3600000,0
25515,10111,576,64,16,1,15,.938,3600000,0
25515,15191,562,0,0,0,0,.00nan,0,0
25515,15305,576,0,0,0,0,.00nan,0,0
25515,29939,562,71,40,3,37,.925,3543000,0
25517,988,568,0,0,0,0,.00nan,0,0
25517,15143,572,97,59,4,55,.932,3600000,0
25517,30896,568,81,22,1,21,.955,3600000,0
25517,31909,572,0,0,0,0,.00nan,0,0
25519,10252,565,64,30,3,27,.900,3566000,0
25519,26830,577,0,0,0,0,.00nan,0,0
25519,31893,577,100,44,2,42,.955,3600000,0
25519,40928,565,0,0,0,0,.00nan,0,0
25521,10252,565,76,38,3,35,.921,3600000,0
25521,32024,573,0,0,0,0,.00nan,0,0
25521,38070,573,92,24,0,24,1000,3600000,0
25521,40928,565,0,0,0,0,.00nan,0,0
25523,1073,571,0,0,0,0,.00nan,0,0
25523,4520,575,82,30,2,28,.933,3549000,0
25523,10231,575,0,0,0,0,.00nan,0,0
25523,26709,571,91,48,1,47,.979,3600000,0
25525,988,568,69,31,3,28,.903,3588000,0
25525,15143,572,100,36,1,35,.972,3600000,0
25525,30896,568,0,0,0,0,.00nan,0,0
25525,31909,572,0,0,0,0,.00nan,0,0
25527,9960,578,72,32,3,29,.906,3576000,0
25527,10111,576,0,0,0,0,.00nan,0,0
25527,14561,578,0,0,0,0,.00nan,0,0
25527,15305,576,60,14,1,13,.929,3600000,0
25529,677,564,0,0,0,0,.00nan,0,0
25529,2024,569,0,0,0,0,.00nan,0,0
25529,10167,569,61,23,4,19,.826,3600000,0
25529,10180,564,34,26,5,21,.808,3562000,0
25531,514,566,0,0,0,0,.00nan,0,0
25531,7095,574,85,18,0,18,1000,3600000,0
25531,32108,574,0,0,0,0,.00nan,0,0
25531,32749,566,44,30,4,26,.867,3600000,0
25533,5566,570,84,12,0,12,1000,3600000,0
25533,26830,577,0,0,0,0,.00nan,0,0
25533,31893,577,86,31,2,29,.935,3600000,0
25533,52471,570,0,0,0,0,.00nan,0,0
25535,1073,571,61,44,5,39,.886,3600000,0
25535,5566,570,74,26,2,24,.923,3600000,0
25535,26709,571,0,0,0,0,.00nan,0,0
25535,52471,570,0,0,0,0,.00nan,0,0
25537,7095,574,88,18,0,18,1000,3600000,0
25537,10252,565,0,0,0,0,.00nan,0,0
25537,32108,574,0,0,0,0,.00nan,0,0
25537,40928,565,97,42,2,40,.952,3600000,0
25539,988,568,0,0,0,0,.00nan,0,0
25539,15143,572,0,0,0,0,.00nan,0,0
25539,30896,568,76,23,1,22,.957,3544000,0
25539,31909,572,100,39,0,39,1000,3600000,0
25541,514,566,79,29,1,28,.966,3900000,0
25541,4520,575,0,0,0,0,.00nan,0,0
25541,10231,575,89,31,1,30,.968,3900000,0
25541,32749,566,0,0,0,0,.00nan,0,0
25543,677,564,77,32,2,30,.938,3900000,0
25543,10111,576,72,23,2,21,.913,3900000,0
25543,10180,564,0,0,0,0,.00nan,0,0
25543,15305,576,0,0,0,0,.00nan,0,0
25545,9960,578,0,0,0,0,.00nan,0,0
25545,14561,578,58,22,3,19,.864,3546000,0
25545,26830,577,78,34,2,32,.941,3600000,0
25545,31893,577,0,0,0,0,.00nan,0,0
25547,2024,569,55,34,4,30,.882,3548000,0
25547,10167,569,0,0,0,0,.00nan,0,0
25547,32024,573,0,0,0,0,.00nan,0,0
25547,38070,573,64,22,2,20,.909,3600000,0
25548,5572,877,0,0,0,0,.00nan,0,0
25548,16214,897,0,0,0,0,.00nan,0,0
25548,16257,897,79,32,3,29,.906,3600000,0
25548,19111,877,60,21,2,19,.905,3600000,0
25549,19167,893,0,0,0,0,.00nan,0,0
25549,19811,893,42,33,5,28,.848,3600000,0
25549,21244,874,75,25,1,24,.960,3600000,0
25549,24201,874,0,0,0,0,.00nan,0,0
25550,6729,891,0,0,0,0,.00nan,0,0
25550,9227,891,71,35,3,32,.914,3600000,0
25550,9389,883,0,0,0,0,.00nan,0,0
25550,18836,883,100,27,0,27,1000,3600000,0
25551,4102,887,56,31,4,27,.871,3600000,0
25551,14645,881,0,0,0,0,.00nan,0,0
25551,19129,881,51,41,6,35,.854,3544000,0
25551,46886,887,0,0,0,0,.00nan,0,0
25552,8953,882,100,54,3,51,.944,3861000,0
25552,16392,876,49,28,4,24,.857,3861000,0
25552,20635,882,0,0,0,0,.00nan,0,0
25552,25495,876,0,0,0,0,.00nan,0,0
25553,2865,879,51,7,1,6,.857,379000,0
25553,16442,879,16,22,6,16,.727,3172000,0
25553,18367,892,0,0,0,0,.00nan,0,0
25553,20737,892,36,24,5,19,.792,3600000,0
25554,1360,875,91,36,2,34,.944,3553000,0
25554,13869,878,68,15,1,14,.933,3600000,0
25554,19075,875,0,0,0,0,.00nan,0,0
25554,19112,878,0,0,0,0,.00nan,0,0
25555,1360,875,96,40,2,38,.950,3600000,0
25555,2865,879,0,0,0,0,.00nan,0,0
25555,16442,879,60,24,3,21,.875,3590000,0
25555,19075,875,0,0,0,0,.00nan,0,0
25556,14645,881,0,0,0,0,.00nan,0,0
25556,19129,881,43,27,5,22,.815,3600000,0
25556,21244,874,81,26,1,25,.962,3600000,0
25556,24201,874,0,0,0,0,.00nan,0,0
25557,5572,877,80,33,2,31,.939,3600000,0
25557,18367,892,52,31,4,27,.871,3583000,0
25557,19111,877,0,0,0,0,.00nan,0,0
25557,20737,892,0,0,0,0,.00nan,0,0
25558,1360,875,68,49,5,44,.898,3600000,0
25558,4102,887,0,0,0,0,.00nan,0,0
25558,19075,875,0,0,0,0,.00nan,0,0
25558,46886,887,52,24,3,21,.875,3600000,0
25559,6729,891,95,31,1,30,.968,3600000,0
25559,8953,882,0,0,0,0,.00nan,0,0
25559,9227,891,0,0,0,0,.00nan,0,0
25559,20635,882,64,27,2,25,.926,3561000,0
25560,13869,878,0,0,0,0,.00nan,0,0
25560,16392,876,73,41,3,38,.927,3574000,0
25560,19112,878,45,12,2,10,.833,3600000,0
25560,25495,876,0,0,0,0,.00nan,0,0
25561,9389,883,0,0,0,0,.00nan,0,0
25561,18836,883,63,26,2,24,.923,3757000,0
25561,19167,893,73,32,3,29,.906,3757000,0
25561,19811,893,0,0,0,0,.00nan,0,0
25562,2865,879,77,23,1,22,.957,3600000,0
25562,16214,897,66,33,3,30,.909,3522000,0
25562,16257,897,0,0,0,0,.00nan,0,0
25562,16442,879,0,0,0,0,.00nan,0,0
25563,8953,882,0,0,0,0,.00nan,0,0
25563,9389,883,0,0,0,0,.00nan,0,0
25563,18836,883,56,30,4,26,.867,3576000,0
25563,20635,882,69,31,3,28,.903,3600000,0
25564,2865,879,0,0,0,0,.00nan,0,0
25564,14645,881,63,27,3,24,.889,3900000,0
25564,16442,879,75,37,3,34,.919,3900000,0
25564,19129,881,0,0,0,0,.00nan,0,0
25565,5572,877,37,28,5,23,.821,2369000,0
25565,13869,878,0,0,0,0,.00nan,0,0
25565,19111,877,67,17,1,16,.941,1231000,0
25565,19112,878,71,26,3,23,.885,3600000,0
25566,18367,892,75,29,2,27,.931,3600000,0
25566,19167,893,0,0,0,0,.00nan,0,0
25566,19811,893,76,38,3,35,.921,3573000,0
25566,20737,892,0,0,0,0,.00nan,0,0
25567,1360,875,82,40,3,37,.925,3563000,0
25567,6729,891,65,21,2,19,.905,3600000,0
25567,9227,891,0,0,0,0,.00nan,0,0
25567,19075,875,0,0,0,0,.00nan,0,0
25568,16214,897,78,32,2,30,.938,3600000,0
25568,16257,897,0,0,0,0,.00nan,0,0
25568,21244,874,0,0,0,0,.00nan,0,0
25568,24201,874,53,38,4,34,.895,3538000,0
25569,9389,883,0,0,0,0,.00nan,0,0
25569,18367,892,54,46,5,41,.891,3600000,0
25569,18836,883,69,16,1,15,.938,3600000,0
25569,20737,892,0,0,0,0,.00nan,0,0
25570,4102,887,45,39,6,33,.846,2698000,0
25570,16392,876,51,15,2,13,.867,3600000,0
25570,25495,876,0,0,0,0,.00nan,0,0
25570,46886,887,63,10,0,10,1000,902000,0
25571,1360,875,77,36,3,33,.917,3600000,0
25571,14645,881,42,19,4,15,.789,3600000,0
25571,19075,875,0,0,0,0,.00nan,0,0
25571,19129,881,0,0,0,0,.00nan,0,0
25572,1360,875,79,37,2,35,.946,3545000,0
25572,14645,881,0,0,0,0,.00nan,0,0
25572,19075,875,0,0,0,0,.00nan,0,0
25572,19129,881,88,31,1,30,.968,3600000,0
25573,4102,887,0,0,0,0,.00nan,0,0
25573,18367,892,0,0,0,0,.00nan,0,0
25573,20737,892,68,25,3,22,.880,3900000,0
25573,46886,887,70,38,3,35,.921,3900000,0
25574,2865,879,70,33,3,30,.909,3900000,0
25574,8953,882,0,0,0,0,.00nan,0,0
25574,16442,879,0,0,0,0,.00nan,0,0
25574,20635,882,73,37,3,34,.919,3900000,0
25575,5572,877,37,34,6,28,.824,3600000,0
25575,19111,877,0,0,0,0,.00nan,0,0
25575,19167,893,100,28,0,28,1000,3600000,0
25575,19811,893,0,0,0,0,.00nan,0,0
25576,6729,891,0,0,0,0,.00nan,0,0
25576,9227,891,88,45,3,42,.933,3600000,0
25576,13869,878,0,0,0,0,.00nan,0,0
25576,19112,878,77,20,1,19,.950,3600000,0
25577,16214,897,0,0,0,0,.00nan,0,0
25577,16257,897,81,40,2,38,.950,3600000,0
25577,16392,876,48,32,5,27,.844,3600000,0
25577,25495,876,0,0,0,0,.00nan,0,0
25578,9389,883,0,0,0,0,.00nan,0,0
25578,18836,883,74,27,2,25,.926,3600000,0
25578,21244,874,53,23,3,20,.870,3593000,0
25578,24201,874,0,0,0,0,.00nan,0,0
25579,16392,876,70,19,1,18,.947,3900000,0
25579,19167,893,94,36,1,35,.972,3900000,0
25579,19811,893,0,0,0,0,.00nan,0,0
25579,25495,876,0,0,0,0,.00nan,0,0
25580,8953,882,59,34,4,30,.882,3515000,0
25580,20635,882,0,0,0,0,.00nan,0,0
25580,21244,874,83,27,2,25,.926,3600000,0
25580,24201,874,0,0,0,0,.00nan,0,0
25581,14645,881,76,22,1,21,.955,3600000,0
25581,16214,897,50,38,5,33,.868,3600000,0
25581,16257,897,0,0,0,0,.00nan,0,0
25581,19129,881,0,0,0,0,.00nan,0,0
25582,4102,887,54,43,6,37,.860,3025000,0
25582,5572,877,0,0,0,0,.00nan,0,0
25582,19111,877,94,18,0,18,1000,3600000,0
25582,46886,887,48,7,1,6,.857,575000,0
25583,1360,875,75,43,4,39,.907,3572000,0
25583,18367,892,71,28,2,26,.929,3600000,0
25583,19075,875,0,0,0,0,.00nan,0,0
25583,20737,892,0,0,0,0,.00nan,0,0
25584,2865,879,96,49,0,49,1000,3900000,0
25584,6729,891,100,28,0,28,1000,3900000,0
25584,9227,891,0,0,0,0,.00nan,0,0
25584,16442,879,0,0,0,0,.00nan,0,0
25585,9389,883,96,21,0,21,1000,3600000,0
25585,13869,878,0,0,0,0,.00nan,0,0
25585,18836,883,0,0,0,0,.00nan,0,0
25585,19112,878,74,33,3,30,.909,3600000,0
25586,4102,887,0,0,0,0,.00nan,0,0
25586,9389,883,0,0,0,0,.00nan,0,0
25586,18836,883,74,21,1,20,.952,3600000,0
25586,46886,887,38,33,6,27,.818,3600000,0
25587,6729,891,98,47,3,44,.936,3600000,0
25587,9227,891,0,0,0,0,.00nan,0,0
25587,14645,881,0,0,0,0,.00nan,0,0
25587,19129,881,59,36,4,32,.889,3550000,0
25588,2865,879,0,0,0,0,.00nan,0,0
25588,16442,879,86,34,3,31,.912,3523000,0
25588,19167,893,0,0,0,0,.00nan,0,0
25588,19811,893,80,23,1,22,.957,3600000,0
25589,8953,882,0,0,0,0,.00nan,0,0
25589,13869,878,57,32,4,28,.875,3353000,0
25589,19112,878,57,5,0,5,1000,229000,0
25589,20635,882,97,41,2,39,.951,3600000,0
25590,16392,876,89,37,2,35,.946,3600000,0
25590,18367,892,92,19,0,19,1000,3600000,0
25590,20737,892,0,0,0,0,.00nan,0,0
25590,25495,876,0,0,0,0,.00nan,0,0
25591,1360,875,98,56,3,53,.946,3600000,0
25591,16214,897,0,0,0,0,.00nan,0,0
25591,16257,897,93,20,0,20,1000,3600000,0
25591,19075,875,0,0,0,0,.00nan,0,0
25592,5572,877,58,8,0,8,1000,1054000,0
25592,19111,877,33,35,6,29,.829,2546000,0
25592,21244,874,81,23,1,22,.957,3600000,0
25592,24201,874,0,0,0,0,.00nan,0,0
25593,5572,877,0,0,0,0,.00nan,0,0
25593,8953,882,0,0,0,0,.00nan,0,0
25593,19111,877,42,21,4,17,.810,3552000,0
25593,20635,882,54,24,3,21,.875,3600000,0
25594,4102,887,0,0,0,0,.00nan,0,0
25594,13869,878,0,0,0,0,.00nan,0,0
25594,19112,878,56,34,4,30,.882,3564000,0
25594,46886,887,90,39,2,37,.949,3600000,0
25595,14645,881,0,0,0,0,.00nan,0,0
25595,19129,881,88,41,3,38,.927,3900000,0
25595,19167,893,62,34,3,31,.912,3900000,0
25595,19811,893,0,0,0,0,.00nan,0,0
25596,16214,897,0,0,0,0,.00nan,0,0
25596,16257,897,94,33,1,32,.970,3823000,0
25596,18367,892,100,26,0,26,1000,3823000,0
25596,20737,892,0,0,0,0,.00nan,0,0
25597,1360,875,98,53,3,50,.943,3580000,0
25597,9389,883,54,7,1,6,.857,3600000,0
25597,18836,883,0,0,0,0,.00nan,0,0
25597,19075,875,0,0,0,0,.00nan,0,0
25598,2865,879,85,30,1,29,.967,3600000,0
25598,16392,876,66,32,3,29,.906,3596000,0
25598,16442,879,0,0,0,0,.00nan,0,0
25598,25495,876,0,0,0,0,.00nan,0,0
25599,6729,891,79,34,3,31,.912,3600000,0
25599,9227,891,0,0,0,0,.00nan,0,0
25599,21244,874,87,16,0,16,1000,3600000,0
25599,24201,874,0,0,0,0,.00nan,0,0
25601,2865,879,0,0,0,0,.00nan,0,0
25601,16442,879,85,30,1,29,.967,3595000,0
25601,21244,874,100,28,0,28,1000,3600000,0
25601,24201,874,0,0,0,0,.00nan,0,0
25605,6729,891,40,22,4,18,.818,3572000,0
25605,9227,891,0,0,0,0,.00nan,0,0
25605,16392,876,68,33,3,30,.909,3600000,0
25605,25495,876,0,0,0,0,.00nan,0,0
25607,5572,877,48,19,3,16,.842,3552000,0
25607,14645,881,0,0,0,0,.00nan,0,0
25607,19111,877,0,0,0,0,.00nan,0,0
25607,19129,881,90,35,1,34,.971,3600000,0
25608,9389,883,59,21,2,19,.905,3547000,0
25608,16392,876,96,35,1,34,.971,3600000,0
25608,18836,883,0,0,0,0,.00nan,0,0
25608,25495,876,0,0,0,0,.00nan,0,0
25609,13869,878,0,0,0,0,.00nan,0,0
25609,16214,897,0,0,0,0,.00nan,0,0
25609,16257,897,91,46,2,44,.957,3600000,0
25609,19112,878,88,26,1,25,.962,3600000,0
25610,6729,891,73,34,2,32,.941,3600000,0
25610,9227,891,0,0,0,0,.00nan,0,0
25610,18367,892,32,17,4,13,.765,3527000,0
25610,20737,892,0,0,0,0,.00nan,0,0
25611,8953,882,0,0,0,0,.00nan,0,0
25611,19167,893,62,33,4,29,.879,3541000,0
25611,19811,893,0,0,0,0,.00nan,0,0
25611,20635,882,74,41,3,38,.927,3600000,0
25612,4102,887,51,2,0,2,1000,640000,0
25612,21244,874,69,23,2,21,.913,3600000,0
25612,24201,874,0,0,0,0,.00nan,0,0
25612,46886,887,18,23,6,17,.739,2960000,0
25615,2865,879,49,43,5,38,.884,3900000,0
25615,9389,883,0,0,0,0,.00nan,0,0
25615,16442,879,0,0,0,0,.00nan,0,0
25615,18836,883,56,37,5,32,.865,3900000,0
25616,5572,877,97,30,2,28,.933,3600000,0
25616,6729,891,43,27,4,23,.852,3562000,0
25616,9227,891,0,0,0,0,.00nan,0,0
25616,19111,877,0,0,0,0,.00nan,0,0
25617,1360,875,97,40,2,38,.950,3544000,0
25617,16392,876,73,22,1,21,.955,3600000,0
25617,19075,875,0,0,0,0,.00nan,0,0
25617,23979,876,0,0,0,0,.00nan,0,0
25618,4102,887,98,25,0,25,1000,3600000,0
25618,19167,893,69,36,3,33,.917,3600000,0
25618,19811,893,0,0,0,0,.00nan,0,0
25618,46886,887,0,0,0,0,.00nan,0,0
25619,8953,882,78,24,1,23,.958,3900000,0
25619,16214,897,0,0,0,0,.00nan,0,0
25619,16257,897,94,34,1,33,.971,3900000,0
25619,20635,882,0,0,0,0,.00nan,0,0
25620,14645,881,0,0,0,0,.00nan,0,0
25620,18367,892,80,26,1,25,.962,3600000,0
25620,19129,881,60,44,5,39,.886,3600000,0
25620,20737,892,0,0,0,0,.00nan,0,0
25621,19112,878,64,32,2,30,.938,3563000,0
25621,21244,874,0,0,0,0,.00nan,0,0
25621,24201,874,100,32,0,32,1000,3600000,0
25621,40275,878,0,0,0,0,.00nan,0,0
25622,9389,883,0,0,0,0,.00nan,0,0
25622,14645,881,0,0,0,0,.00nan,0,0
25622,18836,883,43,18,3,15,.833,3551000,0
25622,19129,881,93,41,2,39,.951,3600000,0
25623,2865,879,77,30,2,28,.933,3600000,0
25623,5572,877,0,0,0,0,.00nan,0,0
25623,16442,879,0,0,0,0,.00nan,0,0
25623,19111,877,82,37,3,34,.919,3569000,0
25624,18367,892,40,31,5,26,.839,3600000,0
25624,19112,878,0,0,0,0,.00nan,0,0
25624,20737,892,0,0,0,0,.00nan,0,0
25624,40275,878,75,30,2,28,.933,3600000,0
25625,6729,891,73,28,2,26,.929,3600000,0
25625,9227,891,0,0,0,0,.00nan,0,0
25625,16214,897,62,45,5,40,.889,3600000,0
25625,16257,897,0,0,0,0,.00nan,0,0
25626,16392,876,59,33,4,29,.879,3600000,0
25626,21244,874,0,0,0,0,.00nan,0,0
25626,23979,876,0,0,0,0,.00nan,0,0
25626,24201,874,94,36,1,35,.972,3600000,0
25627,4102,887,76,29,2,27,.931,3600000,0
25627,8953,882,0,0,0,0,.00nan,0,0
25627,20635,882,70,41,4,37,.902,3600000,0
25627,46886,887,0,0,0,0,.00nan,0,0
25628,1360,875,78,38,3,35,.921,3600000,0
25628,19075,875,0,0,0,0,.00nan,0,0
25628,19167,893,57,16,1,15,.938,981000,0
25628,19811,893,22,26,6,20,.769,2619000,0
25913,2865,879,40,34,6,28,.824,3065000,0
25913,13869,878,0,0,0,0,.00nan,0,0
25913,16442,879,54,3,0,3,1000,478000,0
25913,19112,878,64,32,4,28,.875,3600000,0
25921,1360,875,67,40,4,36,.900,3900000,0
25921,14645,881,78,21,0,21,1000,2131000,0
25921,19075,875,0,0,0,0,.00nan,0,0
25921,19129,881,40,24,4,20,.833,1769000,0
25935,13869,878,78,38,3,35,.921,3600000,0
25935,16392,876,56,36,6,30,.833,3600000,0
25935,19112,878,0,0,0,0,.00nan,0,0
25935,25495,876,0,0,0,0,.00nan,0,0
25941,14645,881,0,0,0,0,.00nan,0,0
25941,16214,897,59,33,4,29,.879,3600000,0
25941,16257,897,0,0,0,0,.00nan,0,0
25941,19129,881,71,34,3,31,.912,3600000,0
25943,1360,875,0,0,0,0,.00nan,0,0
25943,16392,876,32,25,5,20,.800,3600000,0
25943,19075,875,100,39,1,38,.974,3600000,0
25943,25495,876,0,0,0,0,.00nan,0,0
25945,4102,887,0,0,0,0,.00nan,0,0
25945,19167,893,0,0,0,0,.00nan,0,0
25945,19811,893,81,43,3,40,.930,3600000,0
25945,46886,887,43,26,4,22,.846,3541000,0
25947,9389,883,0,0,0,0,.00nan,0,0
25947,18367,892,0,0,0,0,.00nan,0,0
25947,18836,883,87,32,1,31,.969,3900000,0
25947,20737,892,72,24,1,23,.958,3900000,0
25949,2865,879,0,0,0,0,.00nan,0,0
25949,5572,877,43,3,1,2,.667,1272000,0
25949,16442,879,25,22,5,17,.773,3600000,0
25949,19111,877,34,26,5,21,.808,2328000,0
25951,6729,891,0,0,0,0,.00nan,0,0
25951,9227,891,53,21,3,18,.857,3599000,0
25951,21244,874,0,0,0,0,.00nan,0,0
25951,24201,874,79,26,1,25,.962,3600000,0
25953,8953,882,0,0,0,0,.00nan,0,0
25953,13869,878,0,0,0,0,.00nan,0,0
25953,19112,878,98,45,3,42,.933,3600000,0
25953,20635,882,91,28,1,27,.964,3600000,0
25955,1360,875,90,48,3,45,.938,3545000,0
25955,16392,876,0,0,0,0,.00nan,0,0
25955,19075,875,0,0,0,0,.00nan,0,0
25955,25495,876,81,23,1,22,.957,3600000,0
25957,4102,887,96,35,1,34,.971,3600000,0
25957,14645,881,68,32,3,29,.906,3533000,0
25957,19129,881,0,0,0,0,.00nan,0,0
25957,46886,887,0,0,0,0,.00nan,0,0
25959,6729,891,88,37,2,35,.946,3559000,0
25959,9227,891,0,0,0,0,.00nan,0,0
25959,18367,892,56,9,1,8,.889,3600000,0
25959,20737,892,0,0,0,0,.00nan,0,0
25961,9389,883,77,34,3,31,.912,3682000,0
25961,13869,878,84,31,2,29,.935,3682000,0
25961,18836,883,0,0,0,0,.00nan,0,0
25961,19112,878,0,0,0,0,.00nan,0,0
25963,19167,893,89,27,2,25,.926,3600000,0
25963,19811,893,0,0,0,0,.00nan,0,0
25963,21244,874,58,33,4,29,.879,3600000,0
25963,24201,874,0,0,0,0,.00nan,0,0
25965,2865,879,100,27,0,27,1000,3600000,0
25965,8953,882,78,34,2,32,.941,3600000,0
25965,16442,879,0,0,0,0,.00nan,0,0
25965,20635,882,0,0,0,0,.00nan,0,0
25967,5572,877,76,37,2,35,.946,3600000,0
25967,16214,897,0,0,0,0,.00nan,0,0
25967,16257,897,85,45,3,42,.933,3548000,0
25967,19111,877,0,0,0,0,.00nan,0,0
25969,4102,887,92,29,1,28,.966,3579000,0
25969,18367,892,0,0,0,0,.00nan,0,0
25969,20737,892,100,27,0,27,1000,3600000,0
25969,46886,887,0,0,0,0,.00nan,0,0
25971,9389,883,75,21,1,20,.952,3600000,0
25971,18836,883,0,0,0,0,.00nan,0,0
25971,19167,893,0,0,0,0,.00nan,0,0
25971,19811,893,65,30,3,27,.900,3543000,0
25973,1360,875,95,44,2,42,.955,3600000,0
25973,14645,881,0,0,0,0,.00nan,0,0
25973,19075,875,0,0,0,0,.00nan,0,0
25973,19129,881,62,16,1,15,.938,3600000,0
25975,6729,891,0,0,0,0,.00nan,0,0
25975,9227,891,63,30,3,27,.900,3534000,0
25975,16392,876,68,16,1,15,.938,3600000,0
25975,25495,876,0,0,0,0,.00nan,0,0
25977,5572,877,94,30,1,29,.967,3600000,0
25977,13869,878,0,0,0,0,.00nan,0,0
25977,19111,877,0,0,0,0,.00nan,0,0
25977,19112,878,58,28,3,25,.893,3600000,0
25979,2865,879,86,32,2,30,.938,3600000,0
25979,16442,879,0,0,0,0,.00nan,0,0
25979,21244,874,50,23,3,20,.870,3600000,0
25979,24201,874,0,0,0,0,.00nan,0,0
25981,8953,882,0,0,0,0,.00nan,0,0
25981,16214,897,0,0,0,0,.00nan,0,0
25981,16257,897,67,28,2,26,.929,3564000,0
25981,20635,882,91,33,1,32,.970,3600000,0
25983,18367,892,0,0,0,0,.00nan,0,0
25983,19167,893,98,23,0,23,1000,3600000,0
25983,19811,893,0,0,0,0,.00nan,0,0
25983,20737,892,84,29,1,28,.966,3577000,0
25985,1360,875,0,0,0,0,.00nan,0,0
25985,4102,887,0,0,0,0,.00nan,0,0
25985,19075,875,99,44,2,42,.955,3600000,0
25985,46886,887,77,37,3,34,.919,3596000,0
25987,5572,877,0,0,0,0,.00nan,0,0
25987,19111,877,75,26,2,24,.923,3600000,0
25987,21244,874,0,0,0,0,.00nan,0,0
25987,24201,874,44,22,4,18,.818,3552000,0
25989,9389,883,0,0,0,0,.00nan,0,0
25989,13869,878,78,39,3,36,.923,3600000,0
25989,18836,883,77,22,2,20,.909,3600000,0
25989,19112,878,0,0,0,0,.00nan,0,0
25991,2865,879,0,0,0,0,.00nan,0,0
25991,8953,882,70,23,1,22,.957,3600000,0
25991,16442,879,53,23,3,20,.870,3543000,0
25991,20635,882,0,0,0,0,.00nan,0,0
25993,6729,891,84,24,1,23,.958,3600000,0
25993,9227,891,0,0,0,0,.00nan,0,0
25993,14645,881,65,29,3,26,.897,3600000,0
25993,19129,881,0,0,0,0,.00nan,0,0
25995,16214,897,86,36,3,33,.917,3529000,0
25995,16257,897,0,0,0,0,.00nan,0,0
25995,16392,876,0,0,0,0,.00nan,0,0
25995,25495,876,76,24,1,23,.958,3600000,0
25997,13869,878,0,0,0,0,.00nan,0,0
25997,19112,878,99,31,1,30,.968,3900000,0
25997,19167,893,98,41,1,40,.976,3900000,0
25997,19811,893,0,0,0,0,.00nan,0,0
25999,2865,879,41,33,5,28,.848,3600000,0
25999,9389,883,0,0,0,0,.00nan,0,0
25999,16442,879,0,0,0,0,.00nan,0,0
25999,18836,883,81,27,2,25,.926,3600000,0
26001,16392,876,74,25,2,23,.920,3600000,0
26001,18367,892,77,25,1,24,.960,3600000,0
26001,20737,892,0,0,0,0,.00nan,0,0
26001,25495,876,0,0,0,0,.00nan,0,0
26003,6729,891,0,0,0,0,.00nan,0,0
26003,9227,891,89,33,2,31,.939,3600000,0
26003,16214,897,79,30,1,29,.967,3600000,0
26003,16257,897,0,0,0,0,.00nan,0,0
26005,1360,875,0,0,0,0,.00nan,0,0
26005,5572,877,76,25,1,24,.960,3600000,0
26005,19075,875,86,37,2,35,.946,3577000,0
26005,19111,877,0,0,0,0,.00nan,0,0
26007,8953,882,0,0,0,0,.00nan,0,0
26007,14645,881,0,0,0,0,.00nan,0,0
26007,19129,881,63,30,3,27,.900,3600000,0
26007,20635,882,50,37,5,32,.865,3514000,0
26009,4102,887,0,0,0,0,.00nan,0,0
26009,21244,874,0,0,0,0,.00nan,0,0
26009,24201,874,60,38,4,34,.895,3544000,0
26009,46886,887,81,32,2,30,.938,3600000,0
26010,1259,511,0,0,0,0,.00nan,0,0
26010,15686,512,0,0,0,0,.00nan,0,0
26010,17781,512,100,27,0,27,1000,3600000,0
26010,30828,511,81,23,1,22,.957,3556000,0
26011,10492,1477,0,0,0,0,.00nan,0,0
26011,29280,1477,62,29,3,26,.897,3600000,0
26011,30229,523,41,32,6,26,.813,3118000,0
26011,53146,523,51,2,0,2,1000,482000,0
26012,3101,514,89,40,2,38,.950,3585000,0
26012,15782,513,65,18,1,17,.944,3600000,0
26012,29898,513,0,0,0,0,.00nan,0,0
26012,32674,514,0,0,0,0,.00nan,0,0
26013,1494,2193,0,0,0,0,.00nan,0,0
26013,10640,520,63,29,4,25,.862,3600000,0
26013,12482,520,0,0,0,0,.00nan,0,0
26013,15358,2193,100,33,0,33,1000,3600000,0
26014,10629,518,66,24,2,22,.917,3572000,0
26014,20860,518,0,0,0,0,.00nan,0,0
26014,30415,524,0,0,0,0,.00nan,0,0
26014,52881,524,73,24,1,23,.958,3600000,0
26015,378,516,0,0,0,0,.00nan,0,0
26015,1320,516,85,42,3,39,.929,3600000,0
26015,12219,515,0,0,0,0,.00nan,0,0
26015,52900,515,69,20,1,19,.950,3600000,0
26016,2246,519,50,28,4,24,.857,3564000,0
26016,15207,1872,63,26,3,23,.885,3600000,0
26016,19873,519,0,0,0,0,.00nan,0,0
26016,25505,1872,0,0,0,0,.00nan,0,0
26017,15207,1872,61,27,3,24,.889,3573000,0
26017,15686,512,0,0,0,0,.00nan,0,0
26017,17781,512,93,37,2,35,.946,3600000,0
26017,25505,1872,0,0,0,0,.00nan,0,0
26018,2246,519,0,0,0,0,.00nan,0,0
26018,12219,515,0,0,0,0,.00nan,0,0
26018,19873,519,68,24,2,22,.917,3600000,0
26018,52900,515,77,42,4,38,.905,3600000,0
26019,10640,520,64,24,2,22,.917,3600000,0
26019,12482,520,0,0,0,0,.00nan,0,0
26019,15782,513,0,0,0,0,.00nan,0,0
26019,29898,513,56,30,3,27,.900,3600000,0
26020,3101,514,75,18,1,17,.944,3600000,0
26020,30415,524,0,0,0,0,.00nan,0,0
26020,32674,514,0,0,0,0,.00nan,0,0
26020,52881,524,54,30,3,27,.900,3581000,0
26021,12202,511,0,0,0,0,.00nan,0,0
26021,30229,523,0,0,0,0,.00nan,0,0
26021,30828,511,75,25,1,24,.960,3600000,0
26021,53146,523,73,33,3,30,.909,3562000,0
26022,1494,2193,0,0,0,0,.00nan,0,0
26022,10629,518,0,0,0,0,.00nan,0,0
26022,15358,2193,52,31,4,27,.871,3596000,0
26022,20860,518,56,16,2,14,.875,3600000,0
26023,378,516,0,0,0,0,.00nan,0,0
26023,1320,516,83,23,1,22,.957,3600000,0
26023,10492,1477,0,0,0,0,.00nan,0,0
26023,29280,1477,76,41,3,38,.927,3584000,0
26024,10629,518,0,0,0,0,.00nan,0,0
26024,10640,520,48,26,4,22,.846,3600000,0
26024,12482,520,0,0,0,0,.00nan,0,0
26024,20860,518,49,45,6,39,.867,3600000,0
26025,10599,1477,89,36,2,34,.944,3600000,0
26025,15686,512,0,0,0,0,.00nan,0,0
26025,17781,512,57,23,3,20,.870,3559000,0
26025,29280,1477,0,0,0,0,.00nan,0,0
26026,2246,519,65,24,2,22,.917,3583000,0
26026,15782,513,100,32,0,32,1000,3600000,0
26026,19873,519,0,0,0,0,.00nan,0,0
26026,29898,513,0,0,0,0,.00nan,0,0
26027,1494,2193,0,0,0,0,.00nan,0,0
26027,15358,2193,76,37,3,34,.919,3600000,0
26027,30229,523,89,30,1,29,.967,3600000,0
26027,53146,523,0,0,0,0,.00nan,0,0
26028,378,516,0,0,0,0,.00nan,0,0
26028,1320,516,47,31,5,26,.839,3600000,0
26028,30415,524,0,0,0,0,.00nan,0,0
26028,52881,524,72,29,2,27,.931,3600000,0
26029,12202,511,0,0,0,0,.00nan,0,0
26029,12219,515,66,21,3,18,.857,3600000,0
26029,30828,511,65,49,5,44,.898,3600000,0
26029,52900,515,0,0,0,0,.00nan,0,0
26030,3101,514,60,13,1,12,.923,3586000,0
26030,15207,1872,0,0,0,0,.00nan,0,0
26030,25505,1872,100,30,0,30,1000,3600000,0
26030,32674,514,0,0,0,0,.00nan,0,0
26031,10629,518,0,0,0,0,.00nan,0,0
26031,15686,512,0,0,0,0,.00nan,0,0
26031,17781,512,53,29,4,25,.862,3600000,0
26031,20860,518,51,36,5,31,.861,3587000,0
26032,12219,515,0,0,0,0,.00nan,0,0
26032,15207,1872,0,0,0,0,.00nan,0,0
26032,25505,1872,69,21,1,20,.952,3600000,0
26032,52900,515,50,30,5,25,.833,3600000,0
26033,2246,519,0,0,0,0,.00nan,0,0
26033,12202,511,0,0,0,0,.00nan,0,0
26033,19873,519,88,37,2,35,.946,3900000,0
26033,30828,511,71,25,2,23,.920,3900000,0
26034,3101,514,69,32,3,29,.906,3600000,0
26034,10599,1477,42,24,4,20,.833,2351000,0
26034,29280,1477,51,2,0,2,1000,1208000,0
26034,32674,514,0,0,0,0,.00nan,0,0
26035,15782,513,31,20,5,15,.750,3600000,0
26035,29898,513,0,0,0,0,.00nan,0,0
26035,30229,523,78,28,2,26,.929,3600000,0
26035,53146,523,0,0,0,0,.00nan,0,0
26036,378,516,0,0,0,0,.00nan,0,0
26036,1320,516,77,24,1,23,.958,3600000,0
26036,1494,2193,0,0,0,0,.00nan,0,0
26036,15358,2193,73,24,2,22,.917,3587000,0
26037,10640,520,51,26,4,22,.846,3581000,0
26037,12482,520,0,0,0,0,.00nan,0,0
26037,30415,524,55,23,3,20,.870,3600000,0
26037,52881,524,0,0,0,0,.00nan,0,0
26038,10599,1477,87,27,1,26,.963,3868000,0
26038,12202,511,0,0,0,0,.00nan,0,0
26038,29280,1477,0,0,0,0,.00nan,0,0
26038,30828,511,77,28,2,26,.929,3868000,0
26039,12219,515,94,35,1,34,.971,3900000,0
26039,15782,513,81,24,1,23,.958,3900000,0
26039,29898,513,0,0,0,0,.00nan,0,0
26039,52900,515,0,0,0,0,.00nan,0,0
26040,1494,2193,81,34,2,32,.941,3600000,0
26040,2246,519,67,40,4,36,.900,3521000,0
26040,15358,2193,0,0,0,0,.00nan,0,0
26040,19873,519,0,0,0,0,.00nan,0,0
26041,15686,512,0,0,0,0,.00nan,0,0
26041,17781,512,76,34,2,32,.941,3600000,0
26041,30415,524,0,0,0,0,.00nan,0,0
26041,52881,524,49,30,4,26,.867,3538000,0
26042,15207,1872,49,23,4,19,.826,3527000,0
26042,25505,1872,0,0,0,0,.00nan,0,0
26042,30229,523,76,30,2,28,.933,3600000,0
26042,53146,523,0,0,0,0,.00nan,0,0
26043,378,516,0,0,0,0,.00nan,0,0
26043,1320,516,67,36,4,32,.889,3548000,0
26043,10629,518,74,25,2,23,.920,3600000,0
26043,20860,518,0,0,0,0,.00nan,0,0
26044,3101,514,96,37,1,36,.973,3600000,0
26044,10640,520,97,32,2,30,.938,3555000,0
26044,12482,520,0,0,0,0,.00nan,0,0
26044,32674,514,0,0,0,0,.00nan,0,0
26045,2246,519,0,0,0,0,.00nan,0,0
26045,19873,519,64,26,3,23,.885,3600000,0
26045,30415,524,0,0,0,0,.00nan,0,0
26045,52881,524,97,20,0,20,1000,3600000,0
26046,10629,518,71,31,2,29,.935,3900000,0
26046,20860,518,0,0,0,0,.00nan,0,0
26046,30229,523,98,38,2,36,.947,3899000,0
26046,53146,523,0,0,0,0,.00nan,0,0
26047,15686,512,0,0,0,0,.00nan,0,0
26047,15782,513,0,0,0,0,.00nan,0,0
26047,17781,512,48,27,3,24,.889,3555000,0
26047,29898,513,78,28,2,26,.929,3600000,0
26048,1494,2193,77,40,3,37,.925,3566000,0
26048,3101,514,0,0,0,0,.00nan,0,0
26048,15358,2193,0,0,0,0,.00nan,0,0
26048,32674,514,71,19,1,18,.947,3600000,0
26049,10599,1477,66,30,3,27,.900,3547000,0
26049,12219,515,81,28,1,27,.964,3600000,0
26049,29280,1477,0,0,0,0,.00nan,0,0
26049,52900,515,0,0,0,0,.00nan,0,0
26050,12202,511,54,28,4,24,.857,3600000,0
26050,15207,1872,80,19,1,18,.947,3600000,0
26050,25505,1872,0,0,0,0,.00nan,0,0
26050,30828,511,0,0,0,0,.00nan,0,0
26051,378,516,0,0,0,0,.00nan,0,0
26051,1320,516,61,35,5,30,.857,3600000,0
26051,10640,520,70,18,1,17,.944,3600000,0
26051,12482,520,0,0,0,0,.00nan,0,0
26052,1494,2193,72,30,3,27,.900,3572000,0
26052,12219,515,69,20,2,18,.900,3600000,0
26052,15358,2193,0,0,0,0,.00nan,0,0
26052,52900,515,0,0,0,0,.00nan,0,0
26053,10640,520,89,30,1,29,.967,3600000,0
26053,12482,520,0,0,0,0,.00nan,0,0
26053,15686,512,61,9,0,9,1000,752000,0
26053,17781,512,29,25,6,19,.760,2848000,0
26054,12202,511,0,0,0,0,.00nan,0,0
26054,30415,524,0,0,0,0,.00nan,0,0
26054,30828,511,59,32,4,28,.875,3600000,0
26054,52881,524,92,34,1,33,.971,3600000,0
26055,3101,514,70,22,1,21,.955,3600000,0
26055,10629,518,0,0,0,0,.00nan,0,0
26055,20860,518,62,26,2,24,.923,3570000,0
26055,32674,514,0,0,0,0,.00nan,0,0
26056,378,516,0,0,0,0,.00nan,0,0
26056,1320,516,57,19,2,17,.895,3600000,0
26056,30229,523,0,0,0,0,.00nan,0,0
26056,53146,523,80,27,1,26,.963,3600000,0
26057,2246,519,63,21,2,19,.905,3615000,0
26057,10599,1477,0,0,0,0,.00nan,0,0
26057,19873,519,0,0,0,0,.00nan,0,0
26057,29280,1477,65,25,3,22,.880,3615000,0
26058,15207,1872,66,34,4,30,.882,3829000,0
26058,15782,513,69,34,3,31,.912,3829000,0
26058,25505,1872,0,0,0,0,.00nan,0,0
26058,29898,513,0,0,0,0,.00nan,0,0
26059,10640,520,59,32,4,28,.875,3537000,0
26059,12482,520,0,0,0,0,.00nan,0,0
26059,30229,523,74,29,2,27,.931,3600000,0
26059,53146,523,0,0,0,0,.00nan,0,0
26060,1494,2193,50,31,4,27,.871,3578000,0
26060,11913,2193,0,0,0,0,.00nan,0,0
26060,15686,512,74,26,2,24,.923,3600000,0
26060,17781,512,0,0,0,0,.00nan,0,0
26061,378,516,0,0,0,0,.00nan,0,0
26061,1320,516,64,42,4,38,.905,3859000,0
26061,3101,514,62,38,4,34,.895,3900000,0
26061,32674,514,0,0,0,0,.00nan,0,0
26062,12219,515,81,39,3,36,.923,3558000,0
26062,30415,524,0,0,0,0,.00nan,0,0
26062,52881,524,79,22,1,21,.955,3600000,0
26062,52900,515,0,0,0,0,.00nan,0,0
26063,12202,511,0,0,0,0,.00nan,0,0
26063,15782,513,76,25,1,24,.960,3600000,0
26063,29898,513,0,0,0,0,.00nan,0,0
26063,30828,511,57,33,4,29,.879,3600000,0
26064,2246,519,70,23,2,21,.913,3600000,0
26064,10629,518,0,0,0,0,.00nan,0,0
26064,19873,519,0,0,0,0,.00nan,0,0
26064,20860,518,52,32,4,28,.875,3555000,0
26065,10599,1477,0,0,0,0,.00nan,0,0
26065,15207,1872,0,0,0,0,.00nan,0,0
26065,25505,1872,100,25,0,25,1000,3600000,0
26065,29280,1477,98,38,1,37,.974,3600000,0
26066,1494,2193,52,30,4,26,.867,3600000,0
26066,11913,2193,0,0,0,0,.00nan,0,0
26066,12202,511,97,31,1,30,.968,3600000,0
26066,30828,511,0,0,0,0,.00nan,0,0
26067,2246,519,56,19,2,17,.895,3547000,0
26067,10640,520,100,47,1,46,.979,3600000,0
26067,12482,520,0,0,0,0,.00nan,0,0
26067,19873,519,0,0,0,0,.00nan,0,0
26068,15207,1872,0,0,0,0,.00nan,0,0
26068,25505,1872,76,37,3,34,.919,3600000,0
26068,30415,524,0,0,0,0,.00nan,0,0
26068,52881,524,83,18,0,18,1000,3600000,0
26069,3101,514,76,20,1,19,.950,3600000,0
26069,30229,523,98,39,2,37,.949,3573000,0
26069,32674,514,0,0,0,0,.00nan,0,0
26069,53146,523,0,0,0,0,.00nan,0,0
26070,10629,518,0,0,0,0,.00nan,0,0
26070,12219,515,0,0,0,0,.00nan,0,0
26070,20860,518,85,45,3,42,.933,3576000,0
26070,52900,515,82,25,1,24,.960,3600000,0
26071,378,516,51,18,2,16,.889,3563000,0
26071,1320,516,0,0,0,0,.00nan,0,0
26071,15686,512,95,32,1,31,.969,3600000,0
26071,17781,512,0,0,0,0,.00nan,0,0
26072,10599,1477,63,36,4,32,.889,3593000,0
26072,15782,513,77,37,3,34,.919,3600000,0
26072,29280,1477,0,0,0,0,.00nan,0,0
26072,29898,513,0,0,0,0,.00nan,0,0
26073,10599,1477,86,38,2,36,.947,3600000,0
26073,29280,1477,0,0,0,0,.00nan,0,0
26073,30415,524,0,0,0,0,.00nan,0,0
26073,52881,524,75,25,1,24,.960,3600000,0
26074,3101,514,54,24,3,21,.875,3586000,0
26074,15686,512,0,0,0,0,.00nan,0,0
26074,17781,512,98,31,1,30,.968,3600000,0
26074,32674,514,0,0,0,0,.00nan,0,0
26076,10640,520,30,22,5,17,.773,3600000,0
26076,12219,515,0,0,0,0,.00nan,0,0
26076,12482,520,0,0,0,0,.00nan,0,0
26076,52900,515,63,34,4,30,.882,3600000,0
26080,1494,2193,0,0,0,0,.00nan,0,0
26080,15207,1872,0,0,0,0,.00nan,0,0
26080,15358,2193,96,21,0,21,1000,3600000,0
26080,25505,1872,86,33,1,32,.970,3551000,0
26081,10599,1477,69,33,3,30,.909,3232000,0
26081,10640,520,76,31,3,28,.903,3600000,0
26081,12482,520,0,0,0,0,.00nan,0,0
26081,29280,1477,26,6,3,3,.500,368000,0
26082,3101,514,0,0,0,0,.00nan,0,0
26082,12219,515,69,27,2,25,.926,3600000,0
26082,32674,514,82,50,4,46,.920,3534000,0
26082,52900,515,0,0,0,0,.00nan,0,0
26083,15782,513,90,30,2,28,.933,3900000,0
26083,29898,513,0,0,0,0,.00nan,0,0
26083,30415,524,0,0,0,0,.00nan,0,0
26083,52881,524,72,31,2,29,.935,3900000,0
26084,15686,512,0,0,0,0,.00nan,0,0
26084,17781,512,53,19,2,17,.895,3600000,0
26084,30229,523,78,38,3,35,.921,3543000,0
26084,53146,523,0,0,0,0,.00nan,0,0
26086,378,516,0,0,0,0,.00nan,0,0
26086,1320,516,100,37,2,35,.946,3600000,0
26086,2246,519,46,23,3,20,.870,3600000,0
26086,19873,519,0,0,0,0,.00nan,0,0
26087,10599,1477,0,0,0,0,.00nan,0,0
26087,10629,518,62,29,3,26,.897,3610000,0
26087,20860,518,0,0,0,0,.00nan,0,0
26087,29280,1477,59,30,4,26,.867,3610000,0
26088,378,516,58,35,4,31,.886,3562000,0
26088,1320,516,0,0,0,0,.00nan,0,0
26088,15782,513,80,41,3,38,.927,3600000,0
26088,29898,513,0,0,0,0,.00nan,0,0
26089,1494,2193,0,0,0,0,.00nan,0,0
26089,15358,2193,63,43,5,38,.884,3600000,0
26089,30415,524,0,0,0,0,.00nan,0,0
26089,52881,524,71,27,1,26,.963,3600000,0
26090,12219,515,0,0,0,0,.00nan,0,0
26090,30229,523,82,42,3,39,.929,3570000,0
26090,52900,515,72,29,2,27,.931,3600000,0
26090,53146,523,0,0,0,0,.00nan,0,0
26092,2246,519,48,41,6,35,.854,3600000,0
26092,15686,512,0,0,0,0,.00nan,0,0
26092,17781,512,59,31,4,27,.871,3600000,0
26092,19873,519,0,0,0,0,.00nan,0,0
26093,10640,520,99,18,0,18,1000,3600000,0
26093,12482,520,0,0,0,0,.00nan,0,0
26093,15207,1872,84,28,1,27,.964,3554000,0
26093,25505,1872,0,0,0,0,.00nan,0,0
26094,30229,523,52,29,4,25,.862,3734000,0
26094,30415,524,0,0,0,0,.00nan,0,0
26094,52881,524,47,22,3,19,.864,3734000,0
26094,53146,523,0,0,0,0,.00nan,0,0
26095,12219,515,0,0,0,0,.00nan,0,0
26095,15686,512,0,0,0,0,.00nan,0,0
26095,17781,512,84,10,0,10,1000,3600000,0
26095,52900,515,75,40,3,37,.925,3600000,0
26096,1494,2193,100,41,0,41,1000,3600000,0
26096,10599,1477,49,15,3,12,.800,3600000,0
26096,15358,2193,0,0,0,0,.00nan,0,0
26096,29280,1477,0,0,0,0,.00nan,0,0
26097,2246,519,69,20,2,18,.900,3900000,0
26097,3101,514,97,46,2,44,.957,3900000,0
26097,19873,519,0,0,0,0,.00nan,0,0
26097,32674,514,0,0,0,0,.00nan,0,0
26098,10629,518,0,0,0,0,.00nan,0,0
26098,15782,513,84,28,1,27,.964,3600000,0
26098,20860,518,80,30,2,28,.933,3545000,0
26098,29898,513,0,0,0,0,.00nan,0,0
26099,378,516,0,0,0,0,.00nan,0,0
26099,1320,516,37,21,4,17,.810,3600000,0
26099,15207,1872,89,34,2,32,.941,3600000,0
26099,25505,1872,0,0,0,0,.00nan,0,0
26100,10640,520,70,26,2,24,.923,3898000,0
26100,12202,511,0,0,0,0,.00nan,0,0
26100,12482,520,0,0,0,0,.00nan,0,0
26100,30828,511,91,38,2,36,.947,3900000,0
26102,2246,519,0,0,0,0,.00nan,0,0
26102,15207,1872,0,0,0,0,.00nan,0,0
26102,19873,519,60,22,2,20,.909,3600000,0
26102,25505,1872,50,28,4,24,.857,3600000,0
26103,1494,2193,62,27,3,24,.889,3600000,0
26103,10640,520,0,0,0,0,.00nan,0,0
26103,12482,520,90,23,0,23,1000,3600000,0
26103,15358,2193,0,0,0,0,.00nan,0,0
26104,3101,514,39,22,4,18,.818,3621000,0
26104,15782,513,0,0,0,0,.00nan,0,0
26104,29898,513,57,35,5,30,.857,3621000,0
26104,32674,514,0,0,0,0,.00nan,0,0
26105,10599,1477,84,29,1,28,.966,3600000,0
26105,29280,1477,0,0,0,0,.00nan,0,0
26105,30229,523,59,35,5,30,.857,3600000,0
26105,53146,523,0,0,0,0,.00nan,0,0
26106,10629,518,77,32,3,29,.906,3600000,0
26106,20860,518,0,0,0,0,.00nan,0,0
26106,30415,524,0,0,0,0,.00nan,0,0
26106,52881,524,54,25,4,21,.840,3556000,0
26107,378,516,60,27,3,24,.889,3513000,0
26107,1320,516,0,0,0,0,.00nan,0,0
26107,12219,515,95,33,1,32,.970,3600000,0
26107,52900,515,0,0,0,0,.00nan,0,0
26379,3101,514,89,30,1,29,.967,3564000,0
26379,15686,512,0,0,0,0,.00nan,0,0
26379,17781,512,91,21,0,21,1000,3600000,0
26379,32674,514,0,0,0,0,.00nan,0,0
26381,10640,520,77,23,1,22,.957,3600000,0
26381,12482,520,0,0,0,0,.00nan,0,0
26381,15207,1872,0,0,0,0,.00nan,0,0
26381,25505,1872,71,31,3,28,.903,3594000,0
26383,378,516,0,0,0,0,.00nan,0,0
26383,1320,516,49,35,5,30,.857,3600000,0
26383,30415,524,54,19,2,17,.895,3600000,0
26383,52881,524,0,0,0,0,.00nan,0,0
26391,3101,514,92,30,1,29,.967,3900000,0
26391,30415,524,91,33,1,32,.970,3900000,0
26391,32674,514,0,0,0,0,.00nan,0,0
26391,52881,524,0,0,0,0,.00nan,0,0
26395,2246,519,47,26,4,22,.846,3600000,0
26395,15686,512,0,0,0,0,.00nan,0,0
26395,17781,512,99,21,0,21,1000,3600000,0
26395,19873,519,0,0,0,0,.00nan,0,0
26399,10640,520,72,33,3,30,.909,3546000,0
26399,12482,520,0,0,0,0,.00nan,0,0
26399,15207,1872,79,35,2,33,.943,3600000,0
26399,25505,1872,0,0,0,0,.00nan,0,0
26403,3101,514,0,0,0,0,.00nan,0,0
26403,10640,520,52,26,4,22,.846,3600000,0
26403,12482,520,0,0,0,0,.00nan,0,0
26403,32674,514,65,13,1,12,.923,3600000,0
26409,378,516,0,0,0,0,.00nan,0,0
26409,1320,516,79,24,1,23,.958,3600000,0
26409,30415,524,0,0,0,0,.00nan,0,0
26409,52881,524,80,41,3,38,.927,3541000,0
26411,2246,519,0,0,0,0,.00nan,0,0
26411,15358,2193,60,48,5,43,.896,3600000,0
26411,15946,2193,0,0,0,0,.00nan,0,0
26411,19873,519,85,37,1,36,.973,3600000,0
26413,10599,1477,100,28,0,28,1000,3900000,0
26413,15207,1872,0,0,0,0,.00nan,0,0
26413,25505,1872,97,31,0,31,1000,3900000,0
26413,29280,1477,0,0,0,0,.00nan,0,0
26417,2246,519,0,0,0,0,.00nan,0,0
26417,15207,1872,0,0,0,0,.00nan,0,0
26417,19873,519,80,20,1,19,.950,3600000,0
26417,25505,1872,95,41,2,39,.951,3544000,0
26419,15358,2193,73,25,2,23,.920,3600000,0
26419,15946,2193,0,0,0,0,.00nan,0,0
26419,30415,524,21,32,7,25,.781,2789000,0
26419,52881,524,63,10,0,10,1000,811000,0
26421,10599,1477,61,31,3,28,.903,3586000,0
26421,29280,1477,0,0,0,0,.00nan,0,0
26421,30229,523,65,28,2,26,.929,3600000,0
26421,53146,523,0,0,0,0,.00nan,0,0
26423,1259,511,0,0,0,0,.00nan,0,0
26423,4056,513,0,0,0,0,.00nan,0,0
26423,15782,513,60,35,4,31,.886,3600000,0
26423,30828,511,74,23,1,22,.957,3600000,0
26425,3101,514,51,13,2,11,.846,3600000,0
26425,15686,512,0,0,0,0,.00nan,0,0
26425,17781,512,85,48,4,44,.917,3584000,0
26425,32674,514,0,0,0,0,.00nan,0,0
26427,378,516,72,30,3,27,.900,3600000,0
26427,1320,516,0,0,0,0,.00nan,0,0
26427,10629,518,94,25,0,25,1000,3600000,0
26427,20860,518,0,0,0,0,.00nan,0,0
26429,7146,515,0,0,0,0,.00nan,0,0
26429,10640,520,38,25,4,21,.840,2010000,0
26429,12482,520,63,18,1,17,.944,1590000,0
26429,52900,515,90,27,1,26,.963,3600000,0
26431,10629,518,0,0,0,0,.00nan,0,0
26431,15358,2193,0,0,0,0,.00nan,0,0
26431,15946,2193,73,34,3,31,.912,3900000,0
26431,20860,518,56,22,3,19,.864,3900000,0
26433,4056,513,73,27,2,25,.926,3900000,0
26433,15207,1872,62,29,2,27,.931,3900000,0
26433,15782,513,0,0,0,0,.00nan,0,0
26433,25505,1872,0,0,0,0,.00nan,0,0
26435,7146,515,21,25,6,19,.760,3600000,0
26435,30415,524,0,0,0,0,.00nan,0,0
26435,52881,524,99,40,1,39,.975,3600000,0
26435,52900,515,0,0,0,0,.00nan,0,0
26437,2246,519,44,31,5,26,.839,2122000,0
26437,15686,512,43,26,5,21,.808,3600000,0
26437,17781,512,0,0,0,0,.00nan,0,0
26437,19873,519,48,13,2,11,.846,1402000,0
26439,10640,520,76,24,1,23,.958,3600000,0
26439,12482,520,0,0,0,0,.00nan,0,0
26439,30229,523,0,0,0,0,.00nan,0,0
26439,53146,523,72,35,3,32,.914,3598000,0
26441,1259,511,0,0,0,0,.00nan,0,0
26441,10599,1477,0,0,0,0,.00nan,0,0
26441,29280,1477,89,54,4,50,.926,3600000,0
26441,30828,511,38,28,5,23,.821,3553000,0
26443,378,516,0,0,0,0,.00nan,0,0
26443,1320,516,84,43,3,40,.930,3600000,0
26443,3101,514,0,0,0,0,.00nan,0,0
26443,32674,514,16,21,6,15,.714,3600000,0
26445,2246,519,0,0,0,0,.00nan,0,0
26445,15686,512,0,0,0,0,.00nan,0,0
26445,17781,512,76,24,2,22,.917,3600000,0
26445,19873,519,58,38,5,33,.868,3600000,0
26447,3101,514,46,22,4,18,.818,3586000,0
26447,30229,523,94,36,2,34,.944,3600000,0
26447,32674,514,0,0,0,0,.00nan,0,0
26447,53146,523,0,0,0,0,.00nan,0,0
26449,10640,520,56,16,2,14,.875,3585000,0
26449,12482,520,0,0,0,0,.00nan,0,0
26449,30415,524,100,36,0,36,1000,3600000,0
26449,52881,524,0,0,0,0,.00nan,0,0
26451,378,516,0,0,0,0,.00nan,0,0
26451,1320,516,48,20,3,17,.850,3564000,0
26451,15207,1872,0,0,0,0,.00nan,0,0
26451,25505,1872,69,21,2,19,.905,3600000,0
26453,15358,2193,71,16,1,15,.938,3600000,0
26453,15946,2193,0,0,0,0,.00nan,0,0
26453,30453,515,0,0,0,0,.00nan,0,0
26453,52900,515,67,25,2,23,.920,3548000,0
26455,1259,511,0,0,0,0,.00nan,0,0
26455,10599,1477,0,0,0,0,.00nan,0,0
26455,29280,1477,56,35,4,31,.886,3600000,0
26455,30828,511,81,22,1,21,.955,3600000,0
26457,4056,513,0,0,0,0,.00nan,0,0
26457,10629,518,82,34,2,32,.941,3600000,0
26457,15782,513,96,49,4,45,.918,3545000,0
26457,20860,518,0,0,0,0,.00nan,0,0
26459,378,516,68,31,2,29,.935,3565000,0
26459,1320,516,0,0,0,0,.00nan,0,0
26459,2246,519,79,26,1,25,.962,3600000,0
26459,19873,519,0,0,0,0,.00nan,0,0
26461,15358,2193,0,0,0,0,.00nan,0,0
26461,15946,2193,87,35,2,33,.943,3577000,0
26461,30453,515,100,36,0,36,1000,3600000,0
26461,52900,515,0,0,0,0,.00nan,0,0
26463,30229,523,0,0,0,0,.00nan,0,0
26463,30415,524,68,22,1,21,.955,3600000,0
26463,52881,524,0,0,0,0,.00nan,0,0
26463,53146,523,82,36,2,34,.944,3569000,0
26465,4056,513,67,18,1,17,.944,3600000,0
26465,15207,1872,76,47,4,43,.915,3600000,0
26465,15782,513,0,0,0,0,.00nan,0,0
26465,25505,1872,0,0,0,0,.00nan,0,0
26467,10629,518,0,0,0,0,.00nan,0,0
26467,10640,520,0,0,0,0,.00nan,0,0
26467,12482,520,91,33,1,32,.970,3600000,0
26467,20860,518,63,25,2,23,.920,3600000,0
26469,1259,511,0,0,0,0,.00nan,0,0
26469,3101,514,0,0,0,0,.00nan,0,0
26469,30828,511,100,42,1,41,.976,3900000,0
26469,32674,514,96,30,1,29,.967,3900000,0
26471,10599,1477,100,30,0,30,1000,3634000,0
26471,15686,512,78,21,1,20,.952,3634000,0
26471,17781,512,0,0,0,0,.00nan,0,0
26471,29280,1477,0,0,0,0,.00nan,0,0
26472,2081,631,0,0,0,0,.00nan,0,0
26472,9614,631,62,31,5,26,.839,3515000,0
26472,12002,625,0,0,0,0,.00nan,0,0
26472,26255,625,78,32,3,29,.906,3600000,0
26473,2040,646,0,0,0,0,.00nan,0,0
26473,4401,635,70,39,5,34,.872,3600000,0
26473,10141,635,0,0,0,0,.00nan,0,0
26473,13135,646,73,20,1,19,.950,3600000,0
26474,3122,636,85,47,3,44,.936,3548000,0
26474,8507,636,0,0,0,0,.00nan,0,0
26474,9551,627,0,0,0,0,.00nan,0,0
26474,41088,627,76,24,1,23,.958,3600000,0
26475,8348,634,0,0,0,0,.00nan,0,0
26475,10184,651,61,44,5,39,.886,3600000,0
26475,13123,634,85,39,2,37,.949,3600000,0
26475,68648,651,0,0,0,0,.00nan,0,0
26476,5109,1838,98,37,1,36,.973,3600000,0
26476,12059,1838,0,0,0,0,.00nan,0,0
26476,13896,642,0,0,0,0,.00nan,0,0
26476,40902,642,45,35,5,30,.857,3600000,0
26477,17623,628,83,26,1,25,.962,3600000,0
26477,21503,632,89,41,2,39,.951,3582000,0
26477,41085,632,0,0,0,0,.00nan,0,0
26477,41363,628,0,0,0,0,.00nan,0,0
26478,8409,626,0,0,0,0,.00nan,0,0
26478,10935,626,98,50,2,48,.960,3570000,0
26478,15103,633,0,0,0,0,.00nan,0,0
26478,21986,633,71,22,1,21,.955,3600000,0
26479,3831,629,0,0,0,0,.00nan,0,0
26479,8348,634,0,0,0,0,.00nan,0,0
26479,10436,629,58,42,5,37,.881,3571000,0
26479,13123,634,37,17,4,13,.765,3600000,0
26480,5109,1838,57,25,3,22,.880,3600000,0
26480,8409,626,0,0,0,0,.00nan,0,0
26480,10935,626,75,45,5,40,.889,3571000,0
26480,12059,1838,0,0,0,0,.00nan,0,0
26481,2081,631,0,0,0,0,.00nan,0,0
26481,9614,631,63,28,3,25,.893,3543000,0
26481,15103,633,0,0,0,0,.00nan,0,0
26481,21986,633,86,37,2,35,.946,3600000,0
26482,12002,625,0,0,0,0,.00nan,0,0
26482,17623,628,79,52,5,47,.904,3563000,0
26482,26255,625,62,26,3,23,.885,3600000,0
26482,41363,628,0,0,0,0,.00nan,0,0
26483,10184,651,62,34,4,30,.882,3590000,0
26483,21503,632,100,54,2,52,.963,3600000,0
26483,41085,632,0,0,0,0,.00nan,0,0
26483,68648,651,0,0,0,0,.00nan,0,0
26484,9551,627,57,29,3,26,.897,3600000,0
26484,13896,642,81,43,4,39,.907,3569000,0
26484,40902,642,0,0,0,0,.00nan,0,0
26484,41088,627,0,0,0,0,.00nan,0,0
26485,3122,636,86,37,2,35,.946,3900000,0
26485,4401,635,84,30,2,28,.933,3900000,0
26485,8507,636,0,0,0,0,.00nan,0,0
26485,10141,635,0,0,0,0,.00nan,0,0
26486,9551,627,0,0,0,0,.00nan,0,0
26486,12002,625,0,0,0,0,.00nan,0,0
26486,26255,625,83,28,2,26,.929,3600000,0
26486,41088,627,67,37,4,33,.892,3600000,0
26487,8348,634,0,0,0,0,.00nan,0,0
26487,13123,634,55,41,6,35,.854,3600000,0
26487,21503,632,63,15,1,14,.933,3600000,0
26487,41085,632,0,0,0,0,.00nan,0,0
26488,2081,631,0,0,0,0,.00nan,0,0
26488,3122,636,71,36,4,32,.889,3541000,0
26488,8507,636,0,0,0,0,.00nan,0,0
26488,9614,631,56,25,3,22,.880,3600000,0
26489,4401,635,66,39,5,34,.872,3600000,0
26489,13896,642,73,34,3,31,.912,3600000,0
26489,40902,642,0,0,0,0,.00nan,0,0
26489,43012,635,0,0,0,0,.00nan,0,0
26490,3831,629,0,0,0,0,.00nan,0,0
26490,10436,629,59,26,3,23,.885,3600000,0
26490,15103,633,0,0,0,0,.00nan,0,0
26490,21986,633,78,26,2,24,.923,3600000,0
26491,10184,651,48,37,6,31,.838,3560000,0
26491,17623,628,62,36,4,32,.889,3600000,0
26491,41363,628,0,0,0,0,.00nan,0,0
26491,68648,651,0,0,0,0,.00nan,0,0
26492,2040,646,79,27,2,25,.926,3900000,0
26492,8409,626,0,0,0,0,.00nan,0,0
26492,10935,626,73,28,2,26,.929,3890000,0
26492,13135,646,0,0,0,0,.00nan,0,0
26493,2040,646,52,26,4,22,.846,3600000,0
26493,2081,631,21,25,6,19,.760,3251000,0
26493,9614,631,51,2,0,2,1000,265000,0
26493,13135,646,0,0,0,0,.00nan,0,0
26494,3831,629,0,0,0,0,.00nan,0,0
26494,10436,629,100,44,1,43,.977,3600000,0
26494,17623,628,42,22,4,18,.818,3600000,0
26494,41363,628,0,0,0,0,.00nan,0,0
26495,3122,636,50,34,4,30,.882,3563000,0
26495,8409,626,0,0,0,0,.00nan,0,0
26495,8507,636,0,0,0,0,.00nan,0,0
26495,10935,626,64,23,2,21,.913,3600000,0
26496,13896,642,0,0,0,0,.00nan,0,0
26496,15103,633,39,20,4,16,.800,3600000,0
26496,21986,633,0,0,0,0,.00nan,0,0
26496,40902,642,44,33,5,28,.848,3574000,0
26497,5109,1838,0,0,0,0,.00nan,0,0
26497,12059,1838,53,33,5,28,.848,3608000,0
26497,21503,632,27,6,3,3,.500,484000,0
26497,41085,632,57,12,1,11,.917,3124000,0
26498,8348,634,0,0,0,0,.00nan,0,0
26498,9551,627,0,0,0,0,.00nan,0,0
26498,13123,634,64,47,6,41,.872,3600000,0
26498,41088,627,87,32,1,31,.969,3600000,0
26499,4401,635,52,33,4,29,.879,3574000,0
26499,12002,625,0,0,0,0,.00nan,0,0
26499,26255,625,72,28,2,26,.929,3600000,0
26499,43012,635,0,0,0,0,.00nan,0,0
26500,3831,629,0,0,0,0,.00nan,0,0
26500,5109,1838,72,16,1,15,.938,3600000,0
26500,10436,629,88,43,3,40,.930,3516000,0
26500,12059,1838,0,0,0,0,.00nan,0,0
26501,2040,646,80,25,1,24,.960,3600000,0
26501,10184,651,18,8,4,4,.500,1021000,0
26501,13135,646,0,0,0,0,.00nan,0,0
26501,68648,651,39,15,3,12,.800,2579000,0
26502,8409,626,0,0,0,0,.00nan,0,0
26502,10935,626,54,33,5,28,.848,3600000,0
26502,17623,628,27,32,6,26,.813,3172000,0
26502,41363,628,53,3,0,3,1000,428000,0
26503,9551,627,0,0,0,0,.00nan,0,0
26503,21503,632,40,24,4,20,.833,3581000,0
26503,41085,632,0,0,0,0,.00nan,0,0
26503,41088,627,74,34,3,31,.912,3600000,0
26504,8348,634,0,0,0,0,.00nan,0,0
26504,13123,634,92,39,1,38,.974,3900000,0
26504,13896,642,0,0,0,0,.00nan,0,0
26504,40902,642,80,26,1,25,.962,3900000,0
26505,2081,631,0,0,0,0,.00nan,0,0
26505,4401,635,81,41,3,38,.927,3900000,0
26505,9614,631,68,27,3,24,.889,3900000,0
26505,43012,635,0,0,0,0,.00nan,0,0
26506,12002,625,0,0,0,0,.00nan,0,0
26506,15103,633,0,0,0,0,.00nan,0,0
26506,21986,633,60,35,4,31,.886,3567000,0
26506,26255,625,58,26,3,23,.885,3600000,0
26507,10184,651,76,47,5,42,.894,3900000,0
26507,15103,633,25,22,5,17,.773,3900000,0
26507,21986,633,0,0,0,0,.00nan,0,0
26507,68648,651,0,0,0,0,.00nan,0,0
26508,5109,1838,77,32,3,29,.906,3746000,0
26508,12059,1838,0,0,0,0,.00nan,0,0
26508,17623,628,0,0,0,0,.00nan,0,0
26508,41363,628,61,31,4,27,.871,3746000,0
26509,2040,646,0,0,0,0,.00nan,0,0
26509,3122,636,77,51,6,45,.882,3600000,0
26509,8507,636,0,0,0,0,.00nan,0,0
26509,13135,646,80,27,1,26,.963,3600000,0
26510,8348,634,0,0,0,0,.00nan,0,0
26510,12002,625,0,0,0,0,.00nan,0,0
26510,13123,634,85,46,4,42,.913,3577000,0
26510,26255,625,69,21,2,19,.905,3600000,0
26511,2081,631,90,28,1,27,.964,3600000,0
26511,9614,631,0,0,0,0,.00nan,0,0
26511,21503,632,57,32,4,28,.875,3600000,0
26511,41085,632,0,0,0,0,.00nan,0,0
26512,8409,626,0,0,0,0,.00nan,0,0
26512,9551,627,0,0,0,0,.00nan,0,0
26512,10935,626,51,34,5,29,.853,3600000,0
26512,41088,627,74,24,1,23,.958,3600000,0
26513,3831,629,89,30,1,29,.967,3612000,0
26513,4401,635,72,24,2,22,.917,3612000,0
26513,10436,629,0,0,0,0,.00nan,0,0
26513,43012,635,0,0,0,0,.00nan,0,0
26514,2040,646,93,30,1,29,.967,3600000,0
26514,13135,646,0,0,0,0,.00nan,0,0
26514,21503,632,81,39,2,37,.949,3534000,0
26514,41085,632,0,0,0,0,.00nan,0,0
26515,2081,631,44,19,3,16,.842,3552000,0
26515,9614,631,0,0,0,0,.00nan,0,0
26515,10184,651,93,38,2,36,.947,3600000,0
26515,68648,651,0,0,0,0,.00nan,0,0
26516,3831,629,0,0,0,0,.00nan,0,0
26516,10436,629,77,31,2,29,.935,3600000,0
26516,13896,642,0,0,0,0,.00nan,0,0
26516,40902,642,57,35,4,31,.886,3546000,0
26517,15103,633,0,0,0,0,.00nan,0,0
26517,17623,628,94,27,1,26,.963,3600000,0
26517,21986,633,74,34,3,31,.912,3552000,0
26517,41363,628,0,0,0,0,.00nan,0,0
26518,3122,636,71,44,5,39,.886,3600000,0
26518,8507,636,0,0,0,0,.00nan,0,0
26518,12002,625,0,0,0,0,.00nan,0,0
26518,26255,625,69,31,3,28,.903,3600000,0
26519,5109,1838,0,0,0,0,.00nan,0,0
26519,9551,627,0,0,0,0,.00nan,0,0
26519,12059,1838,97,52,4,48,.923,3600000,0
26519,41088,627,71,18,1,17,.944,3600000,0
26520,4401,635,66,30,2,28,.933,3600000,0
26520,8409,626,0,0,0,0,.00nan,0,0
26520,10935,626,67,36,3,33,.917,3576000,0
26520,43012,635,0,0,0,0,.00nan,0,0
26521,2040,646,70,24,2,22,.917,3600000,0
26521,13135,646,0,0,0,0,.00nan,0,0
26521,17623,628,82,41,3,38,.927,3560000,0
26521,41363,628,0,0,0,0,.00nan,0,0
26522,3122,636,79,32,2,30,.938,3900000,0
26522,3831,629,0,0,0,0,.00nan,0,0
26522,8507,636,0,0,0,0,.00nan,0,0
26522,10436,629,97,46,2,44,.957,3900000,0
26523,4401,635,0,0,0,0,.00nan,0,0
26523,5109,1838,100,36,0,36,1000,3600000,0
26523,12059,1838,0,0,0,0,.00nan,0,0
26523,43012,635,78,23,1,22,.957,3548000,0
26524,2081,631,0,0,0,0,.00nan,0,0
26524,8348,634,0,0,0,0,.00nan,0,0
26524,9614,631,67,18,1,17,.944,3600000,0
26524,13123,634,98,46,2,44,.957,3600000,0
26525,8409,626,0,0,0,0,.00nan,0,0
26525,10935,626,58,33,4,29,.879,3524000,0
26525,13896,642,64,21,2,19,.905,3600000,0
26525,40902,642,0,0,0,0,.00nan,0,0
26526,12002,625,0,0,0,0,.00nan,0,0
26526,21503,632,56,30,4,26,.867,3799000,0
26526,26255,625,58,24,3,21,.875,3799000,0
26526,41085,632,0,0,0,0,.00nan,0,0
26527,9551,627,0,0,0,0,.00nan,0,0
26527,10184,651,77,54,6,48,.889,3087000,0
26527,41088,627,96,23,0,23,1000,3600000,0
26527,68648,651,61,10,0,10,1000,513000,0
26528,2040,646,0,0,0,0,.00nan,0,0
26528,13135,646,58,19,2,17,.895,3600000,0
26528,15103,633,0,0,0,0,.00nan,0,0
26528,21986,633,87,32,3,29,.906,3600000,0
26529,3122,636,71,35,3,32,.914,3600000,0
26529,8507,636,0,0,0,0,.00nan,0,0
26529,13896,642,0,0,0,0,.00nan,0,0
26529,40902,642,33,25,5,20,.800,3550000,0
26530,2081,631,55,20,4,16,.800,3600000,0
26530,5109,1838,87,33,1,32,.970,3600000,0
26530,9614,631,0,0,0,0,.00nan,0,0
26530,12059,1838,0,0,0,0,.00nan,0,0
26531,10184,651,32,35,6,29,.829,2618000,0
26531,12002,625,92,17,0,17,1000,3600000,0
26531,26255,625,0,0,0,0,.00nan,0,0
26531,68648,651,49,10,1,9,.900,982000,0
26532,8348,634,0,0,0,0,.00nan,0,0
26532,8409,626,50,16,2,14,.875,1378000,0
26532,10935,626,24,23,6,17,.739,2222000,0
26532,13123,634,53,26,4,22,.846,3600000,0
26533,3831,629,0,0,0,0,.00nan,0,0
26533,9551,627,0,0,0,0,.00nan,0,0
26533,10436,629,94,41,2,39,.951,3600000,0
26533,41088,627,70,27,3,24,.889,3545000,0
26534,4401,635,0,0,0,0,.00nan,0,0
26534,21503,632,75,33,4,29,.879,3103000,0
26534,41085,632,46,7,1,6,.857,493000,0
26534,43012,635,71,35,4,31,.886,3600000,0
26535,2081,631,86,33,2,31,.939,3600000,0
26535,8409,626,71,37,3,34,.919,3532000,0
26535,9614,631,0,0,0,0,.00nan,0,0
26535,10935,626,0,0,0,0,.00nan,0,0
26536,2040,646,69,32,3,29,.906,3600000,0
26536,8348,634,0,0,0,0,.00nan,0,0
26536,13123,634,92,40,2,38,.950,3600000,0
26536,13135,646,0,0,0,0,.00nan,0,0
26537,3831,629,0,0,0,0,.00nan,0,0
26537,10436,629,73,28,2,26,.929,3600000,0
26537,21503,632,77,41,3,38,.927,3549000,0
26537,41085,632,0,0,0,0,.00nan,0,0
26538,5109,1838,72,25,2,23,.920,3600000,0
26538,10184,651,49,19,3,16,.842,3586000,0
26538,12059,1838,0,0,0,0,.00nan,0,0
26538,68648,651,0,0,0,0,.00nan,0,0
26539,3122,636,58,27,3,24,.889,3600000,0
26539,8507,636,0,0,0,0,.00nan,0,0
26539,15103,633,0,0,0,0,.00nan,0,0
26539,21986,633,57,28,5,23,.821,3514000,0
26540,12002,625,80,22,1,21,.955,3600000,0
26540,13896,642,0,0,0,0,.00nan,0,0
26540,26255,625,0,0,0,0,.00nan,0,0
26540,40902,642,39,33,6,27,.818,3600000,0
26541,9551,627,0,0,0,0,.00nan,0,0
26541,17623,628,72,32,3,29,.906,3643000,0
26541,41088,627,81,33,2,31,.939,3636000,0
26541,41363,628,0,0,0,0,.00nan,0,0
26542,5109,1838,0,0,0,0,.00nan,0,0
26542,8348,634,0,0,0,0,.00nan,0,0
26542,12059,1838,66,25,2,23,.920,3600000,0
26542,13123,634,55,30,4,26,.867,3522000,0
26543,2040,646,99,40,2,38,.950,3680000,0
26543,13135,646,0,0,0,0,.00nan,0,0
26543,13896,642,0,0,0,0,.00nan,0,0
26543,40902,642,72,23,3,20,.870,3680000,0
26544,3122,636,0,0,0,0,.00nan,0,0
26544,8507,636,92,46,3,43,.935,3600000,0
26544,21503,632,56,32,4,28,.875,3546000,0
26544,41085,632,0,0,0,0,.00nan,0,0
26545,9551,627,0,0,0,0,.00nan,0,0
26545,15103,633,0,0,0,0,.00nan,0,0
26545,21986,633,64,40,4,36,.900,3900000,0
26545,41088,627,60,26,4,22,.846,3900000,0
26546,2081,631,0,0,0,0,.00nan,0,0
26546,9614,631,100,35,1,34,.971,3600000,0
26546,17623,628,54,38,5,33,.868,3600000,0
26546,41363,628,0,0,0,0,.00nan,0,0
26547,4401,635,59,35,4,31,.886,3600000,0
26547,10184,651,33,25,5,20,.800,3593000,0
26547,43012,635,0,0,0,0,.00nan,0,0
26547,68648,651,0,0,0,0,.00nan,0,0
26548,3831,629,59,5,0,5,1000,854000,0
26548,8409,626,0,0,0,0,.00nan,0,0
26548,10436,629,18,27,7,20,.741,2746000,0
26548,10935,626,47,33,4,29,.879,3600000,0
26549,3122,636,12,41,9,32,.780,2840000,0
26549,8348,634,0,0,0,0,.00nan,0,0
26549,8507,636,46,4,1,3,.750,760000,0
26549,13123,634,59,28,3,25,.893,3600000,0
26550,2040,646,74,27,2,25,.926,3600000,0
26550,9551,627,0,0,0,0,.00nan,0,0
26550,13135,646,0,0,0,0,.00nan,0,0
26550,41088,627,64,31,3,28,.903,3543000,0
26551,13896,642,56,26,4,22,.846,3577000,0
26551,21503,632,77,39,3,36,.923,3600000,0
26551,40902,642,0,0,0,0,.00nan,0,0
26551,41085,632,0,0,0,0,.00nan,0,0
26552,5109,1838,93,36,1,35,.972,3600000,0
26552,12059,1838,0,0,0,0,.00nan,0,0
26552,15103,633,0,0,0,0,.00nan,0,0
26552,21986,633,74,32,2,30,.938,3547000,0
26553,8409,626,51,22,3,19,.864,1255000,0
26553,10184,651,60,36,5,31,.861,3600000,0
26553,10935,626,38,20,4,16,.800,2294000,0
26553,68648,651,0,0,0,0,.00nan,0,0
26554,3831,629,0,0,0,0,.00nan,0,0
26554,10436,629,92,44,3,41,.932,3600000,0
26554,12002,625,27,41,8,33,.805,3600000,0
26554,26255,625,0,0,0,0,.00nan,0,0
26555,691,635,0,0,0,0,.00nan,0,0
26555,4401,635,74,49,5,44,.898,3600000,0
26555,17623,628,0,0,0,0,.00nan,0,0
26555,41363,628,70,24,2,22,.917,3600000,0
26556,3831,629,0,0,0,0,.00nan,0,0
26556,10184,651,0,0,0,0,.00nan,0,0
26556,10436,629,61,39,4,35,.897,3600000,0
26556,68648,651,82,29,1,28,.966,3600000,0
26557,2040,646,91,25,1,24,.960,3600000,0
26557,5109,1838,0,0,0,0,.00nan,0,0
26557,12059,1838,28,23,5,18,.783,3600000,0
26557,13135,646,0,0,0,0,.00nan,0,0
26558,8348,634,0,0,0,0,.00nan,0,0
26558,13123,634,68,30,3,27,.900,3600000,0
26558,15103,633,0,0,0,0,.00nan,0,0
26558,21986,633,33,34,6,28,.824,3600000,0
26559,2081,631,0,0,0,0,.00nan,0,0
26559,9614,631,56,15,2,13,.867,3600000,0
26559,13896,642,89,54,4,50,.926,3585000,0
26559,40902,642,0,0,0,0,.00nan,0,0
26561,8409,626,0,0,0,0,.00nan,0,0
26561,10935,626,94,58,4,54,.931,3600000,0
26561,12002,625,0,0,0,0,.00nan,0,0
26561,26255,625,72,24,2,22,.917,3600000,0
26563,8348,634,0,0,0,0,.00nan,0,0
26563,13123,634,56,35,5,30,.857,3600000,0
26563,17623,628,41,19,4,15,.789,3600000,0
26563,41363,628,0,0,0,0,.00nan,0,0
26564,691,635,0,0,0,0,.00nan,0,0
26564,4401,635,40,34,5,29,.853,3600000,0
26564,15103,633,0,0,0,0,.00nan,0,0
26564,21986,633,94,37,2,35,.946,3600000,0
26565,10184,651,97,61,4,57,.934,3600000,0
26565,13896,642,0,0,0,0,.00nan,0,0
26565,40902,642,59,23,3,20,.870,3600000,0
26565,68648,651,0,0,0,0,.00nan,0,0
26566,8409,626,0,0,0,0,.00nan,0,0
26566,10935,626,99,46,1,45,.978,3600000,0
26566,21503,632,57,26,3,23,.885,3527000,0
26566,41085,632,0,0,0,0,.00nan,0,0
26567,2040,646,60,42,5,37,.881,3600000,0
26567,12002,625,0,0,0,0,.00nan,0,0
26567,13135,646,0,0,0,0,.00nan,0,0
26567,26255,625,91,32,2,30,.938,3600000,0
26568,3122,636,65,39,4,35,.897,3600000,0
26568,5109,1838,99,35,1,34,.971,3600000,0
26568,8507,636,0,0,0,0,.00nan,0,0
26568,12059,1838,0,0,0,0,.00nan,0,0
26569,2081,631,96,34,1,33,.971,3600000,0
26569,3831,629,0,0,0,0,.00nan,0,0
26569,9614,631,0,0,0,0,.00nan,0,0
26569,10436,629,57,24,2,22,.917,3541000,0
26570,15103,633,0,0,0,0,.00nan,0,0
26570,21503,632,78,37,3,34,.919,3600000,0
26570,21986,633,67,32,4,28,.875,3552000,0
26570,41085,632,0,0,0,0,.00nan,0,0
26571,2040,646,87,31,1,30,.968,3600000,0
26571,3831,629,49,1,0,1,1000,312000,0
26571,10436,629,58,48,7,41,.854,3288000,0
26571,13135,646,0,0,0,0,.00nan,0,0
26572,13896,642,63,34,4,30,.882,3588000,0
26572,17623,628,64,32,3,29,.906,3600000,0
26572,40902,642,0,0,0,0,.00nan,0,0
26572,41363,628,0,0,0,0,.00nan,0,0
26573,3122,636,86,33,1,32,.970,3706000,0
26573,8507,636,0,0,0,0,.00nan,0,0
26573,10184,651,85,35,2,33,.943,3706000,0
26573,68648,651,0,0,0,0,.00nan,0,0
26574,5109,1838,0,0,0,0,.00nan,0,0
26574,12002,625,0,0,0,0,.00nan,0,0
26574,12059,1838,86,32,2,30,.938,3900000,0
26574,26255,625,57,22,2,20,.909,3900000,0
26575,2081,631,0,0,0,0,.00nan,0,0
26575,9551,627,0,0,0,0,.00nan,0,0
26575,9614,631,77,28,2,26,.929,3600000,0
26575,41088,627,24,35,7,28,.800,3600000,0
26576,691,635,0,0,0,0,.00nan,0,0
26576,4401,635,80,37,3,34,.919,3600000,0
26576,8348,634,67,24,2,22,.917,3600000,0
26576,13123,634,0,0,0,0,.00nan,0,0
26577,2040,646,0,0,0,0,.00nan,0,0
26577,10184,651,77,28,2,26,.929,3600000,0
26577,13135,646,64,41,4,37,.902,3541000,0
26577,68648,651,0,0,0,0,.00nan,0,0
26578,691,635,0,0,0,0,.00nan,0,0
26578,4401,635,55,11,1,10,.909,3600000,0
26578,5109,1838,44,38,6,32,.842,3600000,0
26578,12059,1838,0,0,0,0,.00nan,0,0
26580,8348,634,0,0,0,0,.00nan,0,0
26580,8409,626,51,2,0,2,1000,352000,0
26580,10935,626,72,44,6,38,.864,3248000,0
26580,13123,634,68,24,2,22,.917,3600000,0
26581,2081,631,32,17,4,13,.765,2278000,0
26581,9614,631,49,11,2,9,.818,1284000,0
26581,12002,625,60,40,5,35,.875,3600000,0
26581,26255,625,0,0,0,0,.00nan,0,0
26582,13896,642,0,0,0,0,.00nan,0,0
26582,21503,632,0,0,0,0,.00nan,0,0
26582,40902,642,70,23,2,21,.913,3600000,0
26582,41085,632,68,33,3,30,.909,3553000,0
26583,3831,629,0,0,0,0,.00nan,0,0
26583,10436,629,76,29,2,27,.931,3600000,0
26583,15103,633,0,0,0,0,.00nan,0,0
26583,21986,633,52,25,4,21,.840,3529000,0
26893,8409,626,77,39,4,35,.897,3600000,0
26893,10935,626,0,0,0,0,.00nan,0,0
26893,21986,633,65,44,5,39,.886,3581000,0
26893,67013,633,0,0,0,0,.00nan,0,0
26895,2040,646,49,30,4,26,.867,3600000,0
26895,3831,629,0,0,0,0,.00nan,0,0
26895,10436,629,64,29,3,26,.897,3600000,0
26895,13135,646,0,0,0,0,.00nan,0,0
26899,5109,1838,65,21,2,19,.905,3600000,0
26899,8348,634,0,0,0,0,.00nan,0,0
26899,12059,1838,0,0,0,0,.00nan,0,0
26899,13123,634,77,38,3,35,.921,3559000,0
26903,10184,651,64,32,4,28,.875,3900000,0
26903,21503,632,28,23,4,19,.826,3900000,0
26903,41085,632,0,0,0,0,.00nan,0,0
26903,68648,651,0,0,0,0,.00nan,0,0
26907,2040,646,0,0,0,0,.00nan,0,0
26907,8409,626,0,0,0,0,.00nan,0,0
26907,10935,626,56,41,5,36,.878,3600000,0
26907,13135,646,91,21,0,21,1000,3600000,0
26909,5109,1838,0,0,0,0,.00nan,0,0
26909,12059,1838,71,35,2,33,.943,3600000,0
26909,21503,632,0,0,0,0,.00nan,0,0
26909,41085,632,38,22,4,18,.818,3572000,0
26913,3122,636,98,29,0,29,1000,3600000,0
26913,8507,636,0,0,0,0,.00nan,0,0
26913,13896,642,63,15,1,14,.933,3574000,0
26913,40902,642,0,0,0,0,.00nan,0,0
26917,3831,629,38,43,7,36,.837,3600000,0
26917,10436,629,0,0,0,0,.00nan,0,0
26917,12002,625,0,0,0,0,.00nan,0,0
26917,26255,625,87,28,1,27,.964,3600000,0
26921,4401,635,83,36,2,34,.944,3600000,0
26921,10141,635,0,0,0,0,.00nan,0,0
26921,10184,651,64,30,3,27,.900,3548000,0
26921,68648,651,0,0,0,0,.00nan,0,0
26927,8348,634,0,0,0,0,.00nan,0,0
26927,13123,634,88,39,2,37,.949,3550000,0
26927,13896,642,0,0,0,0,.00nan,0,0
26927,40902,642,89,33,1,32,.970,3600000,0
26929,2040,646,0,0,0,0,.00nan,0,0
26929,12002,625,0,0,0,0,.00nan,0,0
26929,13135,646,67,45,4,41,.911,3550000,0
26929,26255,625,40,15,3,12,.800,3600000,0
26933,3831,629,0,0,0,0,.00nan,0,0
26933,5109,1838,98,39,1,38,.974,3600000,0
26933,10436,629,47,19,3,16,.842,3551000,0
26933,12059,1838,0,0,0,0,.00nan,0,0
26935,8348,634,0,0,0,0,.00nan,0,0
26935,13123,634,100,56,4,52,.929,3900000,0
26935,17623,628,64,37,4,33,.892,3900000,0
26935,41363,628,0,0,0,0,.00nan,0,0
26937,2040,646,0,0,0,0,.00nan,0,0
26937,9551,627,76,29,2,27,.931,3574000,0
26937,13135,646,90,33,1,32,.970,3600000,0
26937,41088,627,0,0,0,0,.00nan,0,0
26939,21503,632,65,40,4,36,.900,3523000,0
26939,21986,633,80,32,2,30,.938,3600000,0
26939,41085,632,0,0,0,0,.00nan,0,0
26939,67013,633,0,0,0,0,.00nan,0,0
26941,3122,636,56,37,5,32,.865,3600000,0
26941,4401,635,74,30,2,28,.933,3600000,0
26941,8507,636,0,0,0,0,.00nan,0,0
26941,10141,635,0,0,0,0,.00nan,0,0
26943,3831,629,0,0,0,0,.00nan,0,0
26943,10436,629,100,35,0,35,1000,3600000,0
26943,13896,642,97,37,1,36,.973,3583000,0
26943,40902,642,0,0,0,0,.00nan,0,0
26945,5109,1838,0,0,0,0,.00nan,0,0
26945,8409,626,50,31,5,26,.839,3600000,0
26945,10935,626,0,0,0,0,.00nan,0,0
26945,12059,1838,89,31,1,30,.968,3600000,0
26947,2081,631,0,0,0,0,.00nan,0,0
26947,9614,631,55,19,2,17,.895,3600000,0
26947,10184,651,0,0,0,0,.00nan,0,0
26947,68648,651,89,43,3,40,.930,3568000,0
26949,4401,635,0,0,0,0,.00nan,0,0
26949,8409,626,0,0,0,0,.00nan,0,0
26949,10141,635,69,43,5,38,.884,3600000,0
26949,10935,626,82,27,1,26,.963,3600000,0
26953,2040,646,100,34,1,33,.971,3600000,0
26953,5109,1838,73,40,3,37,.925,3548000,0
26953,12059,1838,0,0,0,0,.00nan,0,0
26953,13135,646,0,0,0,0,.00nan,0,0
26955,8348,634,89,46,3,43,.935,3600000,0
26955,12002,625,58,15,2,13,.867,3600000,0
26955,13123,634,0,0,0,0,.00nan,0,0
26955,26255,625,0,0,0,0,.00nan,0,0
26957,3122,636,0,0,0,0,.00nan,0,0
26957,8507,636,79,25,1,24,.960,3600000,0
26957,15103,633,0,0,0,0,.00nan,0,0
26957,21986,633,50,33,5,28,.848,3600000,0
26963,3831,629,0,0,0,0,.00nan,0,0
26963,10436,629,99,36,1,35,.972,3600000,0
26963,13896,642,65,36,4,32,.889,3600000,0
26963,40902,642,0,0,0,0,.00nan,0,0
26967,8348,634,0,0,0,0,.00nan,0,0
26967,8409,626,64,29,2,27,.931,3544000,0
26967,10935,626,0,0,0,0,.00nan,0,0
26967,13123,634,94,27,1,26,.963,3600000,0
26969,3122,636,80,46,3,43,.935,3600000,0
26969,8507,636,0,0,0,0,.00nan,0,0
26969,12002,625,43,4,1,3,.750,895000,0
26969,26255,625,30,26,6,20,.769,2705000,0
26971,10184,651,61,41,5,36,.878,3591000,0
26971,21503,632,72,36,3,33,.917,3600000,0
26971,41085,632,0,0,0,0,.00nan,0,0
26971,68648,651,0,0,0,0,.00nan,0,0
26973,2040,646,0,0,0,0,.00nan,0,0
26973,4401,635,54,28,4,24,.857,3600000,0
26973,10141,635,0,0,0,0,.00nan,0,0
26973,13135,646,36,32,5,27,.844,3581000,0
26977,8348,634,31,33,6,27,.818,3600000,0
26977,8409,626,39,23,4,19,.826,2781000,0
26977,10935,626,21,12,4,8,.667,751000,0
26977,13123,634,0,0,0,0,.00nan,0,0
26981,12002,625,52,28,4,24,.857,3900000,0
26981,15103,633,0,0,0,0,.00nan,0,0
26981,21986,633,54,32,4,28,.875,3900000,0
26981,26255,625,0,0,0,0,.00nan,0,0
26983,2040,646,99,42,2,40,.952,3900000,0
26983,13135,646,0,0,0,0,.00nan,0,0
26983,21503,632,0,0,0,0,.00nan,0,0
26983,41085,632,82,39,2,37,.949,3900000,0
26985,5109,1838,0,0,0,0,.00nan,0,0
26985,10184,651,0,0,0,0,.00nan,0,0
26985,12059,1838,72,42,4,38,.905,3600000,0
26985,68648,651,54,23,3,20,.870,3600000,0
26990,10269,834,65,19,2,17,.895,3545000,0
26990,10354,834,0,0,0,0,.00nan,0,0
26990,10387,828,0,0,0,0,.00nan,0,0
26990,25621,828,90,32,1,31,.969,3600000,0
26991,11635,832,61,32,3,29,.906,3768000,0
26991,19025,838,57,34,4,30,.882,3768000,0
26991,25072,832,0,0,0,0,.00nan,0,0
26991,28372,838,0,0,0,0,.00nan,0,0
26992,11644,844,97,19,0,19,1000,3600000,0
26992,11678,844,0,0,0,0,.00nan,0,0
26992,18972,830,26,36,7,29,.806,3600000,0
26992,28075,830,0,0,0,0,.00nan,0,0
26993,10387,828,0,0,0,0,.00nan,0,0
26993,15244,829,83,13,0,13,1000,3600000,0
26993,25621,828,89,42,2,40,.952,3569000,0
26993,46216,829,0,0,0,0,.00nan,0,0
26994,10488,839,81,15,0,15,1000,3600000,0
26994,11776,835,0,0,0,0,.00nan,0,0
26994,13805,835,89,43,2,41,.953,3570000,0
26994,43348,839,0,0,0,0,.00nan,0,0
26995,10414,831,68,13,0,13,1000,1139000,0
26995,11633,836,74,30,2,28,.933,3600000,0
26995,28885,836,0,0,0,0,.00nan,0,0
26995,44631,831,17,22,6,16,.727,2461000,0
26996,2218,833,0,0,0,0,.00nan,0,0
26996,3153,837,83,30,1,29,.967,3747000,0
26996,10273,837,0,0,0,0,.00nan,0,0
26996,28035,833,74,26,2,24,.923,3747000,0
26997,10414,831,66,34,4,30,.882,3793000,0
26997,18972,830,0,0,0,0,.00nan,0,0
26997,28075,830,53,21,3,18,.857,3793000,0
26997,44631,831,0,0,0,0,.00nan,0,0
26998,11635,832,0,0,0,0,.00nan,0,0
26998,11644,844,75,26,1,25,.962,3900000,0
26998,11678,844,0,0,0,0,.00nan,0,0
26998,25072,832,82,24,1,23,.958,3900000,0
26999,2218,833,66,37,5,32,.865,3600000,0
26999,10488,839,89,28,1,27,.964,3600000,0
26999,28035,833,0,0,0,0,.00nan,0,0
26999,43348,839,0,0,0,0,.00nan,0,0
27000,3153,837,0,0,0,0,.00nan,0,0
27000,10273,837,56,21,2,19,.905,3528000,0
27000,11776,835,100,28,0,28,1000,3600000,0
27000,13805,835,0,0,0,0,.00nan,0,0
27001,15244,829,73,30,2,28,.933,3600000,0
27001,19025,838,0,0,0,0,.00nan,0,0
27001,28372,838,81,30,1,29,.967,3600000,0
27001,46216,829,0,0,0,0,.00nan,0,0
27002,852,848,0,0,0,0,.00nan,0,0
27002,10269,834,93,34,2,32,.941,3596000,0
27002,10354,834,0,0,0,0,.00nan,0,0
27002,13588,848,80,25,1,24,.960,3600000,0
27003,3153,837,85,25,1,24,.960,3600000,0
27003,10273,837,0,0,0,0,.00nan,0,0
27003,11644,844,0,0,0,0,.00nan,0,0
27003,11678,844,65,44,5,39,.886,3600000,0
27004,10488,839,44,31,5,26,.839,3600000,0
27004,11635,832,89,33,2,31,.939,3600000,0
27004,25072,832,0,0,0,0,.00nan,0,0
27004,43348,839,0,0,0,0,.00nan,0,0
27005,852,848,95,23,0,23,1000,3600000,0
27005,11776,835,76,33,2,31,.939,3600000,0
27005,13588,848,0,0,0,0,.00nan,0,0
27005,13805,835,0,0,0,0,.00nan,0,0
27006,10269,834,46,35,6,29,.829,3600000,0
27006,10354,834,0,0,0,0,.00nan,0,0
27006,18972,830,0,0,0,0,.00nan,0,0
27006,28075,830,84,27,1,26,.963,3600000,0
27007,10414,831,58,35,4,31,.886,3600000,0
27007,15244,829,56,37,5,32,.865,3555000,0
27007,44631,831,0,0,0,0,.00nan,0,0
27007,46216,829,0,0,0,0,.00nan,0,0
27008,10387,828,0,0,0,0,.00nan,0,0
27008,11633,836,84,35,2,33,.943,3600000,0
27008,25621,828,63,36,4,32,.889,3581000,0
27008,28885,836,0,0,0,0,.00nan,0,0
27009,2218,833,0,0,0,0,.00nan,0,0
27009,19025,838,0,0,0,0,.00nan,0,0
27009,28035,833,79,25,1,24,.960,3600000,0
27009,28372,838,36,23,5,18,.783,3600000,0
27010,10414,831,0,0,0,0,.00nan,0,0
27010,11644,844,85,26,1,25,.962,3600000,0
27010,11678,844,0,0,0,0,.00nan,0,0
27010,44631,831,57,34,5,29,.853,3600000,0
27011,10269,834,0,0,0,0,.00nan,0,0
27011,10354,834,81,47,4,43,.915,3567000,0
27011,11635,832,65,18,2,16,.889,3600000,0
27011,25072,832,0,0,0,0,.00nan,0,0
27012,852,848,63,29,3,26,.897,3862000,0
27012,3153,837,79,39,4,35,.897,3862000,0
27012,10273,837,0,0,0,0,.00nan,0,0
27012,13588,848,0,0,0,0,.00nan,0,0
27013,18972,830,0,0,0,0,.00nan,0,0
27013,19025,838,0,0,0,0,.00nan,0,0
27013,28075,830,65,19,1,18,.947,3600000,0
27013,28372,838,60,37,5,32,.865,3600000,0
27014,10488,839,49,29,5,24,.828,3900000,0
27014,15244,829,69,43,5,38,.884,3900000,0
27014,43348,839,0,0,0,0,.00nan,0,0
27014,46216,829,0,0,0,0,.00nan,0,0
27015,2218,833,66,17,1,16,.941,3600000,0
27015,11633,836,0,0,0,0,.00nan,0,0
27015,28035,833,0,0,0,0,.00nan,0,0
27015,28885,836,70,23,2,21,.913,3600000,0
27016,2218,833,0,0,0,0,.00nan,0,0
27016,11644,844,0,0,0,0,.00nan,0,0
27016,11678,844,62,33,4,29,.879,3600000,0
27016,28035,833,69,23,1,22,.957,3600000,0
27017,10488,839,0,0,0,0,.00nan,0,0
27017,18972,830,0,0,0,0,.00nan,0,0
27017,28075,830,87,54,4,50,.926,3600000,0
27017,43348,839,65,16,1,15,.938,3600000,0
27018,852,848,0,0,0,0,.00nan,0,0
27018,11635,832,0,0,0,0,.00nan,0,0
27018,13588,848,73,23,2,21,.913,3600000,0
27018,25072,832,59,37,4,33,.892,3582000,0
27019,11633,836,88,35,1,34,.971,3600000,0
27019,11776,835,0,0,0,0,.00nan,0,0
27019,13805,835,99,22,0,22,1000,3600000,0
27019,28885,836,0,0,0,0,.00nan,0,0
27020,10269,834,66,36,5,31,.861,3600000,0
27020,10354,834,0,0,0,0,.00nan,0,0
27020,15244,829,0,0,0,0,.00nan,0,0
27020,46216,829,99,37,1,36,.973,3600000,0
27021,10414,831,69,30,3,27,.900,3600000,0
27021,19025,838,69,33,4,29,.879,3583000,0
27021,28372,838,0,0,0,0,.00nan,0,0
27021,44631,831,0,0,0,0,.00nan,0,0
27022,10387,828,0,0,0,0,.00nan,0,0
27022,11776,835,0,0,0,0,.00nan,0,0
27022,13805,835,93,34,1,33,.971,3600000,0
27022,25621,828,61,20,2,18,.900,3600000,0
27023,10414,831,0,0,0,0,.00nan,0,0
27023,11635,832,74,43,4,39,.907,3600000,0
27023,25072,832,0,0,0,0,.00nan,0,0
27023,44631,831,84,24,1,23,.958,3600000,0
27024,11633,836,80,28,1,27,.964,3600000,0
27024,11644,844,68,32,3,29,.906,3561000,0
27024,11678,844,0,0,0,0,.00nan,0,0
27024,28885,836,0,0,0,0,.00nan,0,0
27025,10387,828,0,0,0,0,.00nan,0,0
27025,10488,839,64,24,2,22,.917,3900000,0
27025,13566,839,0,0,0,0,.00nan,0,0
27025,25621,828,89,37,2,35,.946,3900000,0
27026,3153,837,58,26,3,23,.885,3549000,0
27026,10273,837,0,0,0,0,.00nan,0,0
27026,19025,838,0,0,0,0,.00nan,0,0
27026,28372,838,67,27,2,25,.926,3600000,0
27027,852,848,32,22,5,17,.773,3576000,0
27027,13588,848,0,0,0,0,.00nan,0,0
27027,18972,830,69,38,4,34,.895,3600000,0
27027,28075,830,0,0,0,0,.00nan,0,0
27028,10269,834,70,33,3,30,.909,3860000,0
27028,10354,834,0,0,0,0,.00nan,0,0
27028,11776,835,86,35,2,33,.943,3860000,0
27028,13805,835,0,0,0,0,.00nan,0,0
27029,2218,833,71,26,2,24,.923,3571000,0
27029,15244,829,0,0,0,0,.00nan,0,0
27029,28035,833,0,0,0,0,.00nan,0,0
27029,46216,829,89,29,1,28,.966,3600000,0
27030,10387,828,0,0,0,0,.00nan,0,0
27030,10414,831,0,0,0,0,.00nan,0,0
27030,25621,828,79,21,1,20,.952,3600000,0
27030,44631,831,55,21,3,18,.857,3585000,0
27031,11635,832,54,25,3,22,.880,3664000,0
27031,11776,835,64,34,4,30,.882,3664000,0
27031,13805,835,0,0,0,0,.00nan,0,0
27031,25072,832,0,0,0,0,.00nan,0,0
27032,3153,837,86,28,1,27,.964,3600000,0
27032,10273,837,0,0,0,0,.00nan,0,0
27032,46216,829,0,0,0,0,.00nan,0,0
27032,46269,829,93,42,2,40,.952,3563000,0
27033,852,848,92,20,0,20,1000,3600000,0
27033,11633,836,83,36,2,34,.944,3576000,0
27033,13588,848,0,0,0,0,.00nan,0,0
27033,28885,836,0,0,0,0,.00nan,0,0
27034,10269,834,0,0,0,0,.00nan,0,0
27034,10354,834,80,32,2,30,.938,3600000,0
27034,10488,839,80,36,3,33,.917,3575000,0
27034,13566,839,0,0,0,0,.00nan,0,0
27035,2218,833,20,22,6,16,.727,2437000,0
27035,18972,830,75,35,3,32,.914,3600000,0
27035,28035,833,51,14,2,12,.857,1163000,0
27035,28075,830,0,0,0,0,.00nan,0,0
27036,10269,834,88,47,3,44,.936,3574000,0
27036,10354,834,0,0,0,0,.00nan,0,0
27036,11644,844,0,0,0,0,.00nan,0,0
27036,11678,844,94,39,2,37,.949,3600000,0
27037,10488,839,0,0,0,0,.00nan,0,0
27037,11633,836,97,35,1,34,.971,3900000,0
27037,13566,839,79,18,1,17,.944,3900000,0
27037,28885,836,0,0,0,0,.00nan,0,0
27038,3153,837,59,26,3,23,.885,3600000,0
27038,10273,837,0,0,0,0,.00nan,0,0
27038,10414,831,19,32,7,25,.781,2555000,0
27038,44631,831,59,7,0,7,1000,1045000,0
27039,852,848,93,35,1,34,.971,3900000,0
27039,13588,848,0,0,0,0,.00nan,0,0
27039,19025,838,87,21,1,20,.952,3900000,0
27039,28372,838,0,0,0,0,.00nan,0,0
27040,18972,830,0,0,0,0,.00nan,0,0
27040,28075,830,97,47,1,46,.979,3900000,0
27040,46216,829,69,19,1,18,.947,3900000,0
27040,46269,829,0,0,0,0,.00nan,0,0
27041,2218,833,0,0,0,0,.00nan,0,0
27041,11776,835,0,0,0,0,.00nan,0,0
27041,13805,835,100,37,0,37,1000,3600000,0
27041,28035,833,76,30,2,28,.933,3548000,0
27042,11644,844,26,36,7,29,.806,3600000,0
27042,11678,844,0,0,0,0,.00nan,0,0
27042,19025,838,0,0,0,0,.00nan,0,0
27042,28372,838,48,20,3,17,.850,3600000,0
27043,11633,836,78,31,3,28,.903,3548000,0
27043,11635,832,94,40,2,38,.950,3600000,0
27043,25072,832,0,0,0,0,.00nan,0,0
27043,28885,836,0,0,0,0,.00nan,0,0
27044,3153,837,25,17,5,12,.706,2273000,0
27044,10273,837,44,10,2,8,.800,1327000,0
27044,18972,830,69,26,3,23,.885,3600000,0
27044,28075,830,0,0,0,0,.00nan,0,0
27045,852,848,0,0,0,0,.00nan,0,0
27045,11644,844,72,35,3,32,.914,3600000,0
27045,11678,844,0,0,0,0,.00nan,0,0
27045,13588,848,63,41,4,37,.902,3577000,0
27046,11776,835,0,0,0,0,.00nan,0,0
27046,13805,835,42,34,5,29,.853,3600000,0
27046,46216,829,63,31,3,28,.903,3600000,0
27046,46269,829,0,0,0,0,.00nan,0,0
27047,10269,834,100,41,1,40,.976,3600000,0
27047,10354,834,0,0,0,0,.00nan,0,0
27047,10414,831,0,0,0,0,.00nan,0,0
27047,44631,831,53,29,4,25,.862,3600000,0
27048,2218,833,97,31,1,30,.968,3600000,0
27048,10387,828,0,0,0,0,.00nan,0,0
27048,25621,828,74,32,2,30,.938,3600000,0
27048,28035,833,0,0,0,0,.00nan,0,0
27049,10488,839,43,19,4,15,.789,3900000,0
27049,13566,839,0,0,0,0,.00nan,0,0
27049,19025,838,0,0,0,0,.00nan,0,0
27049,28372,838,53,30,4,26,.867,3900000,0
27050,2218,833,0,0,0,0,.00nan,0,0
27050,10414,831,75,21,1,20,.952,3600000,0
27050,28035,833,68,45,4,41,.911,3600000,0
27050,44631,831,0,0,0,0,.00nan,0,0
27051,11644,844,0,0,0,0,.00nan,0,0
27051,11678,844,100,26,0,26,1000,3900000,0
27051,46216,829,90,26,0,26,1000,3900000,0
27051,46269,829,0,0,0,0,.00nan,0,0
27052,852,848,69,42,5,37,.881,3600000,0
27052,10488,839,0,0,0,0,.00nan,0,0
27052,13566,839,89,30,1,29,.967,3600000,0
27052,13588,848,0,0,0,0,.00nan,0,0
27053,11776,835,54,31,4,27,.871,3719000,0
27053,13805,835,0,0,0,0,.00nan,0,0
27053,19025,838,53,31,5,26,.839,3719000,0
27053,28372,838,0,0,0,0,.00nan,0,0
27054,3153,837,0,0,0,0,.00nan,0,0
27054,10273,837,92,22,0,22,1000,3600000,0
27054,11633,836,0,0,0,0,.00nan,0,0
27054,28885,836,62,33,3,30,.909,3600000,0
27055,11635,832,0,0,0,0,.00nan,0,0
27055,18972,830,69,35,4,31,.886,3600000,0
27055,25072,832,70,25,2,23,.920,3600000,0
27055,28075,830,0,0,0,0,.00nan,0,0
27058,10414,831,66,24,3,21,.875,3900000,0
27058,11776,835,0,0,0,0,.00nan,0,0
27058,13805,835,93,55,3,52,.945,3900000,0
27058,44631,831,0,0,0,0,.00nan,0,0
27059,11633,836,86,18,0,18,1000,3600000,0
27059,18972,830,0,0,0,0,.00nan,0,0
27059,28075,830,75,21,1,20,.952,3543000,0
27059,28885,836,0,0,0,0,.00nan,0,0
27061,10414,831,0,0,0,0,.00nan,0,0
27061,10488,839,87,29,1,28,.966,3600000,0
27061,13566,839,0,0,0,0,.00nan,0,0
27061,44631,831,63,30,3,27,.900,3560000,0
27062,10387,828,0,0,0,0,.00nan,0,0
27062,11644,844,0,0,0,0,.00nan,0,0
27062,11678,844,47,39,6,33,.846,3600000,0
27062,25621,828,80,33,2,31,.939,3600000,0
27063,3153,837,0,0,0,0,.00nan,0,0
27063,10273,837,82,33,2,31,.939,3600000,0
27063,11635,832,68,29,3,26,.897,3560000,0
27063,25072,832,0,0,0,0,.00nan,0,0
27064,11776,835,61,21,2,19,.905,3600000,0
27064,13805,835,0,0,0,0,.00nan,0,0
27064,18972,830,85,46,4,42,.913,3563000,0
27064,28075,830,0,0,0,0,.00nan,0,0
27065,11633,836,69,30,3,27,.900,3600000,0
27065,28885,836,0,0,0,0,.00nan,0,0
27065,46216,829,100,29,0,29,1000,3600000,0
27065,46269,829,0,0,0,0,.00nan,0,0
27066,852,848,66,29,3,26,.897,3900000,0
27066,2218,833,0,0,0,0,.00nan,0,0
27066,13588,848,0,0,0,0,.00nan,0,0
27066,28035,833,75,31,3,28,.903,3865000,0
27067,10269,834,53,39,5,34,.872,3600000,0
27067,10354,834,0,0,0,0,.00nan,0,0
27067,19025,838,0,0,0,0,.00nan,0,0
27067,28372,838,85,26,1,25,.962,3600000,0
27069,11635,832,66,19,2,17,.895,3600000,0
27069,25072,832,0,0,0,0,.00nan,0,0
27069,46216,829,64,30,3,27,.900,3566000,0
27069,46269,829,0,0,0,0,.00nan,0,0
27072,11644,844,34,31,6,25,.806,3600000,0
27072,11678,844,0,0,0,0,.00nan,0,0
27072,11776,835,0,0,0,0,.00nan,0,0
27072,13805,835,64,28,3,25,.893,3600000,0
27073,11633,836,77,27,2,25,.926,3558000,0
27073,19025,838,0,0,0,0,.00nan,0,0
27073,28372,838,100,42,1,41,.976,3600000,0
27073,28885,836,0,0,0,0,.00nan,0,0
27074,2218,833,70,25,2,23,.920,3600000,0
27074,10269,834,0,0,0,0,.00nan,0,0
27074,10354,834,92,46,3,43,.935,3586000,0
27074,28035,833,0,0,0,0,.00nan,0,0
27075,10387,828,73,24,2,22,.917,3579000,0
27075,18972,830,0,0,0,0,.00nan,0,0
27075,25621,828,0,0,0,0,.00nan,0,0
27075,28075,830,99,37,1,36,.973,3600000,0
27076,10414,831,0,0,0,0,.00nan,0,0
27076,11633,836,66,42,5,37,.881,3543000,0
27076,28885,836,0,0,0,0,.00nan,0,0
27076,44631,831,50,24,4,20,.833,3600000,0
27077,11644,844,97,25,0,25,1000,3600000,0
27077,11678,844,0,0,0,0,.00nan,0,0
27077,18972,830,0,0,0,0,.00nan,0,0
27077,28075,830,78,24,1,23,.958,3544000,0
27078,10488,839,65,39,5,34,.872,3600000,0
27078,11776,835,0,0,0,0,.00nan,0,0
27078,13566,839,0,0,0,0,.00nan,0,0
27078,13805,835,79,30,2,28,.933,3600000,0
27079,852,848,59,20,2,18,.900,3600000,0
27079,10269,834,74,43,5,38,.884,3600000,0
27079,10354,834,0,0,0,0,.00nan,0,0
27079,13588,848,0,0,0,0,.00nan,0,0
27080,11635,832,70,31,3,28,.903,3600000,0
27080,19025,838,0,0,0,0,.00nan,0,0
27080,25072,832,0,0,0,0,.00nan,0,0
27080,28372,838,68,34,4,30,.882,3563000,0
27081,10387,828,0,0,0,0,.00nan,0,0
27081,25621,828,43,32,5,27,.844,3600000,0
27081,46216,829,72,27,2,25,.926,3600000,0
27081,46269,829,0,0,0,0,.00nan,0,0
27082,11635,832,0,0,0,0,.00nan,0,0
27082,11644,844,100,25,0,25,1000,3600000,0
27082,11678,844,0,0,0,0,.00nan,0,0
27082,25072,832,58,21,2,19,.905,3524000,0
27083,852,848,0,0,0,0,.00nan,0,0
27083,10387,828,63,30,3,27,.900,3573000,0
27083,13588,848,68,18,1,17,.944,3600000,0
27083,25621,828,0,0,0,0,.00nan,0,0
27084,10414,831,49,29,4,25,.862,3550000,0
27084,18972,830,72,36,3,33,.917,3600000,0
27084,28075,830,0,0,0,0,.00nan,0,0
27084,44631,831,0,0,0,0,.00nan,0,0
27085,19025,838,80,42,3,39,.929,3900000,0
27085,28372,838,0,0,0,0,.00nan,0,0
27085,46216,829,72,33,3,30,.909,3876000,0
27085,46269,829,0,0,0,0,.00nan,0,0
27086,3153,837,0,0,0,0,.00nan,0,0
27086,10273,837,55,24,3,21,.875,3680000,0
27086,11776,835,51,27,4,23,.852,3680000,0
27086,13805,835,0,0,0,0,.00nan,0,0
27087,10269,834,97,46,2,44,.957,3600000,0
27087,10354,834,0,0,0,0,.00nan,0,0
27087,11633,836,0,0,0,0,.00nan,0,0
27087,28885,836,64,16,1,15,.938,3600000,0
27355,10387,828,0,0,0,0,.00nan,0,0
27355,13239,833,0,0,0,0,.00nan,0,0
27355,25621,828,64,30,4,26,.867,3635000,0
27355,28035,833,48,23,3,20,.870,3635000,0
27357,11776,835,0,0,0,0,.00nan,0,0
27357,13805,835,62,29,4,25,.862,3581000,0
27357,18972,830,0,0,0,0,.00nan,0,0
27357,28075,830,55,25,3,22,.880,3600000,0
27359,10414,831,0,0,0,0,.00nan,0,0
27359,44631,831,64,22,2,20,.909,3542000,0
27359,46216,829,0,0,0,0,.00nan,0,0
27359,46269,829,95,39,1,38,.974,3600000,0
27361,6095,838,0,0,0,0,.00nan,0,0
27361,11644,844,0,0,0,0,.00nan,0,0
27361,11678,844,74,33,2,31,.939,3556000,0
27361,19025,838,80,18,0,18,1000,3600000,0
27363,852,848,0,0,0,0,.00nan,0,0
27363,3153,837,100,28,0,28,1000,3900000,0
27363,10273,837,0,0,0,0,.00nan,0,0
27363,13588,848,96,35,0,35,1000,3900000,0
27365,11633,836,76,34,3,31,.912,3600000,0
27365,11635,832,37,20,4,16,.800,3590000,0
27365,25072,832,0,0,0,0,.00nan,0,0
27365,28885,836,0,0,0,0,.00nan,0,0
27367,10269,834,51,34,4,30,.882,3600000,0
27367,10354,834,0,0,0,0,.00nan,0,0
27367,10488,839,62,15,1,14,.933,3600000,0
27367,13566,839,0,0,0,0,.00nan,0,0
27369,6095,838,0,0,0,0,.00nan,0,0
27369,18972,830,29,20,5,15,.750,3600000,0
27369,19025,838,100,42,1,41,.976,3600000,0
27369,28075,830,0,0,0,0,.00nan,0,0
27371,11776,835,69,37,4,33,.892,3808000,0
27371,13805,835,0,0,0,0,.00nan,0,0
27371,46216,829,54,21,3,18,.857,3808000,0
27371,46269,829,0,0,0,0,.00nan,0,0
27373,10387,828,93,44,3,41,.932,3900000,0
27373,10414,831,53,30,3,27,.900,3892000,0
27373,25621,828,0,0,0,0,.00nan,0,0
27373,44631,831,0,0,0,0,.00nan,0,0
27383,10269,834,85,30,2,28,.933,3900000,0
27383,10354,834,0,0,0,0,.00nan,0,0
27383,10414,831,0,0,0,0,.00nan,0,0
27383,44631,831,68,31,2,29,.935,3900000,0
27387,11644,844,0,0,0,0,.00nan,0,0
27387,11678,844,71,42,5,37,.881,3832000,0
27387,46216,829,0,0,0,0,.00nan,0,0
27387,46269,829,33,18,4,14,.778,3832000,0
27391,10387,828,0,0,0,0,.00nan,0,0
27391,18972,830,0,0,0,0,.00nan,0,0
27391,25621,828,79,36,3,33,.917,3589000,0
27391,28075,830,79,29,2,27,.931,3600000,0
27395,11635,832,73,27,2,25,.926,3530000,0
27395,11776,835,0,0,0,0,.00nan,0,0
27395,13805,835,100,34,0,34,1000,3600000,0
27395,25072,832,0,0,0,0,.00nan,0,0
27397,10414,831,63,22,2,20,.909,3667000,0
27397,11633,836,97,38,1,37,.974,3667000,0
27397,28885,836,0,0,0,0,.00nan,0,0
27397,44631,831,0,0,0,0,.00nan,0,0
27399,6095,838,74,32,3,29,.906,3600000,0
27399,19025,838,0,0,0,0,.00nan,0,0
27399,46216,829,43,35,5,30,.857,3571000,0
27399,46269,829,0,0,0,0,.00nan,0,0
27403,10387,828,50,38,5,33,.868,3600000,0
27403,11644,844,70,21,1,20,.952,3600000,0
27403,11678,844,0,0,0,0,.00nan,0,0
27403,25621,828,0,0,0,0,.00nan,0,0
27411,6095,838,0,0,0,0,.00nan,0,0
27411,11776,835,0,0,0,0,.00nan,0,0
27411,13805,835,100,31,0,31,1000,3600000,0
27411,19025,838,48,24,3,21,.875,3600000,0
27413,10414,831,0,0,0,0,.00nan,0,0
27413,18972,830,0,0,0,0,.00nan,0,0
27413,28075,830,68,26,2,24,.923,3520000,0
27413,44631,831,100,25,0,25,1000,3600000,0
27415,10387,828,0,0,0,0,.00nan,0,0
27415,11633,836,64,28,3,25,.893,3900000,0
27415,25621,828,85,42,3,39,.929,3900000,0
27415,28885,836,0,0,0,0,.00nan,0,0
27417,10488,839,35,19,4,15,.789,3600000,0
27417,11644,844,59,7,0,7,1000,474000,0
27417,11678,844,37,29,6,23,.793,3039000,0
27417,43348,839,0,0,0,0,.00nan,0,0
27419,852,848,0,0,0,0,.00nan,0,0
27419,11635,832,0,0,0,0,.00nan,0,0
27419,13588,848,76,22,1,21,.955,3900000,0
27419,25072,832,100,37,1,36,.973,3900000,0
27421,3153,837,98,36,1,35,.972,3600000,0
27421,10273,837,0,0,0,0,.00nan,0,0
27421,46216,829,55,23,3,20,.870,3191000,0
27421,46269,829,29,8,3,5,.625,409000,0
27423,10269,834,0,0,0,0,.00nan,0,0
27423,10354,834,60,31,3,28,.903,3574000,0
27423,13239,833,0,0,0,0,.00nan,0,0
27423,28035,833,61,12,1,11,.917,3600000,0
27425,10387,828,90,51,4,47,.922,3568000,0
27425,10414,831,0,0,0,0,.00nan,0,0
27425,25621,828,0,0,0,0,.00nan,0,0
27425,44631,831,59,22,3,19,.864,3600000,0
27427,852,848,59,29,3,26,.897,3515000,0
27427,13239,833,93,31,1,30,.968,3600000,0
27427,13588,848,0,0,0,0,.00nan,0,0
27427,28035,833,0,0,0,0,.00nan,0,0
27429,10269,834,46,19,3,16,.842,3600000,0
27429,10354,834,0,0,0,0,.00nan,0,0
27429,11635,832,60,37,5,32,.865,3542000,0
27429,25072,832,0,0,0,0,.00nan,0,0
27431,11633,836,0,0,0,0,.00nan,0,0
27431,11776,835,0,0,0,0,.00nan,0,0
27431,13805,835,100,21,0,21,1000,3600000,0
27431,28885,836,77,30,2,28,.933,3554000,0
27433,10488,839,0,0,0,0,.00nan,0,0
27433,11644,844,78,22,1,21,.955,3600000,0
27433,11678,844,0,0,0,0,.00nan,0,0
27433,43348,839,55,22,2,20,.909,3576000,0
27435,6095,838,66,32,3,29,.906,3821000,0
27435,19025,838,0,0,0,0,.00nan,0,0
27435,46216,829,0,0,0,0,.00nan,0,0
27435,46269,829,61,29,4,25,.862,3821000,0
27437,3153,837,0,0,0,0,.00nan,0,0
27437,10273,837,41,18,4,14,.778,3600000,0
27437,18972,830,94,40,1,39,.975,3600000,0
27437,28075,830,0,0,0,0,.00nan,0,0
27439,11633,836,0,0,0,0,.00nan,0,0
27439,15244,829,100,26,0,26,1000,3600000,0
27439,28885,836,73,35,3,32,.914,3600000,0
27439,46216,829,0,0,0,0,.00nan,0,0
27441,10414,831,0,0,0,0,.00nan,0,0
27441,18972,830,0,0,0,0,.00nan,0,0
27441,28075,830,72,30,2,28,.933,3600000,0
27441,44631,831,53,40,5,35,.875,3600000,0
27443,10488,839,84,30,2,28,.933,3900000,0
27443,13239,833,0,0,0,0,.00nan,0,0
27443,28035,833,75,32,2,30,.938,3900000,0
27443,43348,839,0,0,0,0,.00nan,0,0
27445,852,848,100,25,0,25,1000,3600000,0
27445,6095,838,0,0,0,0,.00nan,0,0
27445,13588,848,0,0,0,0,.00nan,0,0
27445,19025,838,78,29,1,28,.966,3600000,0
27447,10387,828,77,24,1,23,.958,3900000,0
27447,11776,835,0,0,0,0,.00nan,0,0
27447,13805,835,75,19,1,18,.947,3900000,0
27447,25621,828,0,0,0,0,.00nan,0,0
27449,3153,837,52,17,3,14,.824,3600000,0
27449,10269,834,0,0,0,0,.00nan,0,0
27449,10273,837,0,0,0,0,.00nan,0,0
27449,10354,834,46,29,4,25,.862,3600000,0
27451,11635,832,48,20,4,16,.800,3888000,0
27451,11644,844,67,32,3,29,.906,3888000,0
27451,11678,844,0,0,0,0,.00nan,0,0
27451,25072,832,0,0,0,0,.00nan,0,0
27452,22860,783,63,38,5,33,.868,3633000,0
27452,32293,2182,0,0,0,0,.00nan,0,0
27452,38024,2182,48,39,6,33,.846,3639000,0
27452,82588,783,0,0,0,0,.00nan,0,0
27453,2768,778,0,0,0,0,.00nan,0,0
27453,32375,778,98,33,2,31,.939,3600000,0
27453,44468,781,42,29,5,24,.828,3600000,0
27453,66629,781,0,0,0,0,.00nan,0,0
27454,10066,796,28,8,3,5,.625,588000,0
27454,28330,794,78,27,1,26,.963,3600000,0
27454,28846,794,0,0,0,0,.00nan,0,0
27454,44580,796,91,24,0,24,1000,2987000,0
27455,263,777,0,0,0,0,.00nan,0,0
27455,2895,776,0,0,0,0,.00nan,0,0
27455,14274,777,39,10,3,7,.700,3600000,0
27455,23243,776,76,49,5,44,.898,3600000,0
27456,10691,792,66,22,2,20,.909,3600000,0
27456,23312,792,0,0,0,0,.00nan,0,0
27456,26903,790,0,0,0,0,.00nan,0,0
27456,62837,790,62,30,3,27,.900,3543000,0
27457,2094,784,0,0,0,0,.00nan,0,0
27457,9995,780,68,19,2,17,.895,3600000,0
27457,29309,784,47,37,6,31,.838,3600000,0
27457,47447,780,0,0,0,0,.00nan,0,0
27458,263,777,100,45,2,43,.956,3600000,0
27458,2768,778,0,0,0,0,.00nan,0,0
27458,14274,777,0,0,0,0,.00nan,0,0
27458,32375,778,56,41,5,36,.878,3600000,0
27459,10066,796,0,0,0,0,.00nan,0,0
27459,10691,792,82,31,2,29,.935,3525000,0
27459,23312,792,0,0,0,0,.00nan,0,0
27459,44580,796,93,23,0,23,1000,3600000,0
27460,2094,784,0,0,0,0,.00nan,0,0
27460,29309,784,63,41,5,36,.878,3675000,0
27460,32293,2182,43,33,6,27,.818,3675000,0
27460,38024,2182,0,0,0,0,.00nan,0,0
27461,22860,783,0,0,0,0,.00nan,0,0
27461,44468,781,87,34,2,32,.941,3600000,0
27461,66629,781,0,0,0,0,.00nan,0,0
27461,82588,783,71,33,3,30,.909,3588000,0
27462,9995,780,74,16,1,15,.938,3600000,0
27462,26903,790,88,41,3,38,.927,3570000,0
27462,47447,780,0,0,0,0,.00nan,0,0
27462,62837,790,0,0,0,0,.00nan,0,0
27463,2895,776,60,35,4,31,.886,3600000,0
27463,23243,776,0,0,0,0,.00nan,0,0
27463,28330,794,0,0,0,0,.00nan,0,0
27463,28846,794,35,26,5,21,.808,3600000,0
27464,2094,784,0,0,0,0,.00nan,0,0
27464,26903,790,100,38,1,37,.974,3600000,0
27464,29309,784,32,27,5,22,.815,3600000,0
27464,62837,790,0,0,0,0,.00nan,0,0
27465,263,777,68,21,2,19,.905,3600000,0
27465,14274,777,0,0,0,0,.00nan,0,0
27465,22860,783,0,0,0,0,.00nan,0,0
27465,82588,783,53,28,4,24,.857,3575000,0
27466,32293,2182,0,0,0,0,.00nan,0,0
27466,38024,2182,37,27,5,22,.815,3600000,0
27466,44468,781,80,28,2,26,.929,3600000,0
27466,66629,781,0,0,0,0,.00nan,0,0
27467,2768,778,0,0,0,0,.00nan,0,0
27467,28330,794,82,27,1,26,.963,3600000,0
27467,28846,794,0,0,0,0,.00nan,0,0
27467,32375,778,68,29,2,27,.931,3572000,0
27468,2895,776,100,34,1,33,.971,3846000,0
27468,10691,792,93,33,2,31,.939,3846000,0
27468,23243,776,0,0,0,0,.00nan,0,0
27468,23312,792,0,0,0,0,.00nan,0,0
27469,9995,780,65,9,0,9,1000,1038000,0
27469,10066,796,0,0,0,0,.00nan,0,0
27469,44580,796,68,24,2,22,.917,3600000,0
27469,47447,780,26,29,6,23,.793,2562000,0
27470,2768,778,0,0,0,0,.00nan,0,0
27470,10691,792,36,26,5,21,.808,3600000,0
27470,23312,792,0,0,0,0,.00nan,0,0
27470,32375,778,75,27,2,25,.926,3600000,0
27471,2094,784,0,0,0,0,.00nan,0,0
27471,10066,796,0,0,0,0,.00nan,0,0
27471,29309,784,66,33,3,30,.909,3600000,0
27471,44580,796,45,32,6,26,.813,3600000,0
27472,26903,790,45,43,6,37,.860,3600000,0
27472,32293,2182,0,0,0,0,.00nan,0,0
27472,38024,2182,39,31,5,26,.839,3600000,0
27472,62837,790,0,0,0,0,.00nan,0,0
27473,22860,783,75,32,3,29,.906,3900000,0
27473,28330,794,0,0,0,0,.00nan,0,0
27473,28846,794,66,33,3,30,.909,3900000,0
27473,82588,783,0,0,0,0,.00nan,0,0
27474,2895,776,91,34,1,33,.971,3600000,0
27474,9995,780,61,29,3,26,.897,3523000,0
27474,23243,776,0,0,0,0,.00nan,0,0
27474,47447,780,0,0,0,0,.00nan,0,0
27475,263,777,77,29,2,27,.931,3900000,0
27475,14274,777,0,0,0,0,.00nan,0,0
27475,44468,781,77,31,2,29,.935,3900000,0
27475,66629,781,0,0,0,0,.00nan,0,0
27476,10066,796,0,0,0,0,.00nan,0,0
27476,26903,790,67,38,5,33,.868,3546000,0
27476,44580,796,69,35,4,31,.886,3600000,0
27476,62837,790,0,0,0,0,.00nan,0,0
27477,28330,794,40,26,4,22,.846,3575000,0
27477,28846,794,0,0,0,0,.00nan,0,0
27477,44468,781,58,17,2,15,.882,3600000,0
27477,66629,781,0,0,0,0,.00nan,0,0
27478,2094,784,0,0,0,0,.00nan,0,0
27478,2895,776,63,35,4,31,.886,3600000,0
27478,23243,776,0,0,0,0,.00nan,0,0
27478,29309,784,54,41,6,35,.854,3600000,0
27479,10691,792,72,32,3,29,.906,3600000,0
27479,22860,783,38,26,5,21,.808,3572000,0
27479,23312,792,0,0,0,0,.00nan,0,0
27479,82588,783,0,0,0,0,.00nan,0,0
27480,263,777,43,23,4,19,.826,3572000,0
27480,14274,777,0,0,0,0,.00nan,0,0
27480,32293,2182,0,0,0,0,.00nan,0,0
27480,38024,2182,100,47,3,44,.936,3600000,0
27481,2768,778,0,0,0,0,.00nan,0,0
27481,9995,780,0,0,0,0,.00nan,0,0
27481,32375,778,54,42,5,37,.881,3900000,0
27481,47447,780,71,45,5,40,.889,3900000,0
27482,2094,784,0,0,0,0,.00nan,0,0
27482,2768,778,70,26,2,24,.923,3600000,0
27482,29309,784,71,37,4,33,.892,3575000,0
27482,32375,778,0,0,0,0,.00nan,0,0
27483,10691,792,59,31,3,28,.903,3600000,0
27483,23312,792,0,0,0,0,.00nan,0,0
27483,44468,781,59,32,4,28,.875,3583000,0
27483,66629,781,0,0,0,0,.00nan,0,0
27484,10066,796,69,35,3,32,.914,3561000,0
27484,32293,2182,0,0,0,0,.00nan,0,0
27484,38024,2182,82,37,2,35,.946,3600000,0
27484,44580,796,0,0,0,0,.00nan,0,0
27485,9995,780,70,22,1,21,.955,3600000,0
27485,22860,783,0,0,0,0,.00nan,0,0
27485,47447,780,0,0,0,0,.00nan,0,0
27485,82588,783,64,37,4,33,.892,3600000,0
27486,2895,776,72,23,1,22,.957,3600000,0
27486,23243,776,0,0,0,0,.00nan,0,0
27486,26903,790,58,39,5,34,.872,3600000,0
27486,62837,790,0,0,0,0,.00nan,0,0
27487,263,777,64,23,2,21,.913,3600000,0
27487,14274,777,0,0,0,0,.00nan,0,0
27487,28330,794,64,32,3,29,.906,3600000,0
27487,28846,794,0,0,0,0,.00nan,0,0
27488,2768,778,0,0,0,0,.00nan,0,0
27488,26903,790,0,0,0,0,.00nan,0,0
27488,32375,778,66,25,4,21,.840,3600000,0
27488,62837,790,57,47,6,41,.872,3539000,0
27489,2094,784,41,9,2,7,.778,1351000,0
27489,22860,783,64,22,2,20,.909,3600000,0
27489,29309,784,32,25,6,19,.760,2249000,0
27489,82588,783,0,0,0,0,.00nan,0,0
27490,9995,780,0,0,0,0,.00nan,0,0
27490,44468,781,60,39,5,34,.872,3600000,0
27490,47447,780,95,22,0,22,1000,3600000,0
27490,66629,781,0,0,0,0,.00nan,0,0
27491,28330,794,77,25,1,24,.960,3600000,0
27491,28846,794,0,0,0,0,.00nan,0,0
27491,32293,2182,0,0,0,0,.00nan,0,0
27491,38024,2182,68,28,2,26,.929,3549000,0
27492,2895,776,34,31,6,25,.806,3600000,0
27492,10066,796,0,0,0,0,.00nan,0,0
27492,23243,776,0,0,0,0,.00nan,0,0
27492,44580,796,99,39,1,38,.974,3600000,0
27493,263,777,81,28,2,26,.929,3600000,0
27493,10691,792,84,47,4,43,.915,3600000,0
27493,14274,777,0,0,0,0,.00nan,0,0
27493,23312,792,0,0,0,0,.00nan,0,0
27494,2094,784,0,0,0,0,.00nan,0,0
27494,29309,784,61,34,3,31,.912,3560000,0
27494,44468,781,90,38,2,36,.947,3600000,0
27494,66629,781,0,0,0,0,.00nan,0,0
27495,10691,792,46,35,5,30,.857,3600000,0
27495,23312,792,0,0,0,0,.00nan,0,0
27495,28330,794,0,0,0,0,.00nan,0,0
27495,28846,794,49,26,4,22,.846,3600000,0
27496,2768,778,0,0,0,0,.00nan,0,0
27496,10066,796,0,0,0,0,.00nan,0,0
27496,32375,778,92,21,0,21,1000,3600000,0
27496,44580,796,61,31,2,29,.935,3518000,0
27497,2895,776,80,34,2,32,.941,3600000,0
27497,23243,776,0,0,0,0,.00nan,0,0
27497,32293,2182,0,0,0,0,.00nan,0,0
27497,38024,2182,83,42,3,39,.929,3600000,0
27498,22860,783,0,0,0,0,.00nan,0,0
27498,26903,790,76,44,4,40,.909,3577000,0
27498,62837,790,0,0,0,0,.00nan,0,0
27498,82588,783,65,28,3,25,.893,3600000,0
27499,263,777,100,29,0,29,1000,3600000,0
27499,9995,780,0,0,0,0,.00nan,0,0
27499,14274,777,0,0,0,0,.00nan,0,0
27499,47447,780,73,36,3,33,.917,3600000,0
27500,26903,790,100,43,2,41,.953,3600000,0
27500,44468,781,54,28,3,25,.893,3549000,0
27500,62837,790,0,0,0,0,.00nan,0,0
27500,66629,781,0,0,0,0,.00nan,0,0
27502,10066,796,36,21,4,17,.810,3600000,0
27502,22860,783,66,33,3,30,.909,3600000,0
27502,44580,796,0,0,0,0,.00nan,0,0
27502,82588,783,0,0,0,0,.00nan,0,0
27503,10691,792,88,18,0,18,1000,3600000,0
27503,23312,792,0,0,0,0,.00nan,0,0
27503,32293,2182,0,0,0,0,.00nan,0,0
27503,38024,2182,51,30,5,25,.833,3600000,0
27504,263,777,0,0,0,0,.00nan,0,0
27504,2094,784,0,0,0,0,.00nan,0,0
27504,14274,777,67,44,5,39,.886,3672000,0
27504,29309,784,87,52,4,48,.923,3672000,0
27505,9995,780,0,0,0,0,.00nan,0,0
27505,28330,794,73,53,5,48,.906,3894000,0
27505,28846,794,0,0,0,0,.00nan,0,0
27505,47447,780,56,34,5,29,.853,3900000,0
27506,10066,796,85,28,1,27,.964,3600000,0
27506,44468,781,40,35,5,30,.857,3600000,0
27506,44580,796,0,0,0,0,.00nan,0,0
27506,66629,781,0,0,0,0,.00nan,0,0
27507,2094,784,0,0,0,0,.00nan,0,0
27507,28330,794,83,29,1,28,.966,3600000,0
27507,28846,794,0,0,0,0,.00nan,0,0
27507,29309,784,77,37,4,33,.892,3600000,0
27509,2895,776,42,32,5,27,.844,3600000,0
27509,22860,783,0,0,0,0,.00nan,0,0
27509,23243,776,0,0,0,0,.00nan,0,0
27509,82588,783,34,34,7,27,.794,3573000,0
27510,9995,780,0,0,0,0,.00nan,0,0
27510,10691,792,92,40,2,38,.950,3900000,0
27510,23312,792,0,0,0,0,.00nan,0,0
27510,47447,780,71,31,2,29,.935,3900000,0
27511,263,777,95,37,1,36,.973,3812000,0
27511,14274,777,0,0,0,0,.00nan,0,0
27511,26903,790,73,32,2,30,.938,3812000,0
27511,62837,790,0,0,0,0,.00nan,0,0
27512,2768,778,57,23,3,20,.870,2470000,0
27512,22860,783,70,28,3,25,.893,3600000,0
27512,32375,778,26,14,4,10,.714,1130000,0
27512,82588,783,0,0,0,0,.00nan,0,0
27513,26903,790,73,40,3,37,.925,3551000,0
27513,28330,794,71,24,2,22,.917,3600000,0
27513,28846,794,0,0,0,0,.00nan,0,0
27513,62837,790,0,0,0,0,.00nan,0,0
27514,9995,780,92,21,0,21,1000,3600000,0
27514,32293,2182,0,0,0,0,.00nan,0,0
27514,38024,2182,51,35,5,30,.857,3600000,0
27514,47447,780,0,0,0,0,.00nan,0,0
27515,263,777,76,36,3,33,.917,3600000,0
27515,10066,796,0,0,0,0,.00nan,0,0
27515,14274,777,0,0,0,0,.00nan,0,0
27515,44580,796,45,25,4,21,.840,3544000,0
27516,2895,776,40,27,5,22,.815,3600000,0
27516,23243,776,0,0,0,0,.00nan,0,0
27516,44468,781,76,33,2,31,.939,3600000,0
27516,66629,781,0,0,0,0,.00nan,0,0
27517,2094,784,0,0,0,0,.00nan,0,0
27517,10691,792,40,29,5,24,.828,3600000,0
27517,23312,792,0,0,0,0,.00nan,0,0
27517,29309,784,84,29,1,28,.966,3600000,0
27519,10066,796,0,0,0,0,.00nan,0,0
27519,28330,794,24,26,7,19,.731,3834000,0
27519,28846,794,0,0,0,0,.00nan,0,0
27519,44580,796,62,39,6,33,.846,3834000,0
27520,22860,783,0,0,0,0,.00nan,0,0
27520,32293,2182,0,0,0,0,.00nan,0,0
27520,38024,2182,66,43,4,39,.907,3900000,0
27520,82588,783,44,20,4,16,.800,3900000,0
27521,10691,792,80,32,2,30,.938,3600000,0
27521,23312,792,0,0,0,0,.00nan,0,0
27521,26903,790,0,0,0,0,.00nan,0,0
27521,62837,790,71,37,3,34,.919,3556000,0
27522,263,777,45,30,5,25,.833,3600000,0
27522,2895,776,25,26,6,20,.769,2967000,0
27522,14274,777,0,0,0,0,.00nan,0,0
27522,23243,776,39,9,2,7,.778,633000,0
27523,2094,784,0,0,0,0,.00nan,0,0
27523,9995,780,67,32,3,29,.906,3600000,0
27523,29309,784,40,25,4,21,.840,3573000,0
27523,47447,780,0,0,0,0,.00nan,0,0
27753,2094,784,0,0,0,0,.00nan,0,0
27753,26903,790,61,20,2,18,.900,3600000,0
27753,29309,784,75,42,4,38,.905,3566000,0
27753,62837,790,0,0,0,0,.00nan,0,0
27755,2895,776,60,24,2,22,.917,3571000,0
27755,23243,776,0,0,0,0,.00nan,0,0
27755,32293,2182,0,0,0,0,.00nan,0,0
27755,38024,2182,99,32,1,31,.969,3600000,0
27757,9995,780,71,24,2,22,.917,3571000,0
27757,44468,781,92,36,1,35,.972,3600000,0
27757,47447,780,0,0,0,0,.00nan,0,0
27757,66629,781,0,0,0,0,.00nan,0,0
27761,22860,783,78,34,2,32,.941,3900000,0
27761,28330,794,73,27,2,25,.926,3900000,0
27761,60283,794,0,0,0,0,.00nan,0,0
27761,82588,783,0,0,0,0,.00nan,0,0
27763,10066,796,0,0,0,0,.00nan,0,0
27763,10691,792,77,32,2,30,.938,3763000,0
27763,23312,792,0,0,0,0,.00nan,0,0
27763,44580,796,87,49,3,46,.939,3763000,0
27765,2094,784,33,29,6,23,.793,3154000,0
27765,28330,794,0,0,0,0,.00nan,0,0
27765,29309,784,60,7,0,7,1000,439000,0
27765,60283,794,46,30,5,25,.833,3600000,0
27767,10691,792,0,0,0,0,.00nan,0,0
27767,22860,783,0,0,0,0,.00nan,0,0
27767,23312,792,58,24,3,21,.875,3600000,0
27767,82588,783,65,45,5,40,.889,3600000,0
27769,10066,796,81,29,1,28,.966,3600000,0
27769,32293,2182,21,9,4,5,.556,858000,0
27769,38024,2182,54,11,2,9,.818,2742000,0
27769,44580,796,0,0,0,0,.00nan,0,0
27771,2895,776,0,0,0,0,.00nan,0,0
27771,9995,780,0,0,0,0,.00nan,0,0
27771,23243,776,58,37,4,33,.892,3574000,0
27771,47447,780,70,31,2,29,.935,3600000,0
27773,26903,790,52,3,0,3,1000,290000,0
27773,44468,781,0,0,0,0,.00nan,0,0
27773,62837,790,44,31,5,26,.839,3310000,0
27773,66629,781,86,30,1,29,.967,3600000,0
27777,2094,784,0,0,0,0,.00nan,0,0
27777,22860,783,0,0,0,0,.00nan,0,0
27777,29309,784,74,18,1,17,.944,3600000,0
27777,82588,783,49,42,5,37,.881,3600000,0
27781,26903,790,0,0,0,0,.00nan,0,0
27781,44468,781,70,37,3,34,.919,3900000,0
27781,62837,790,64,27,3,24,.889,3900000,0
27781,66629,781,0,0,0,0,.00nan,0,0
27783,9995,780,90,24,0,24,1000,3600000,0
27783,11351,777,0,0,0,0,.00nan,0,0
27783,14274,777,53,42,6,36,.857,3600000,0
27783,47447,780,0,0,0,0,.00nan,0,0
27785,10066,796,0,0,0,0,.00nan,0,0
27785,32293,2182,0,0,0,0,.00nan,0,0
27785,38024,2182,66,32,3,29,.906,3600000,0
27785,44580,796,53,31,4,27,.871,3554000,0
27787,2895,776,71,36,4,32,.889,3900000,0
27787,23243,776,0,0,0,0,.00nan,0,0
27787,28330,794,59,33,4,29,.879,3900000,0
27787,60283,794,0,0,0,0,.00nan,0,0
27789,10066,796,0,0,0,0,.00nan,0,0
27789,22860,783,0,0,0,0,.00nan,0,0
27789,44580,796,71,34,3,31,.912,3564000,0
27789,82588,783,60,20,2,18,.900,3600000,0
27791,2895,776,76,38,3,35,.921,3517000,0
27791,23243,776,0,0,0,0,.00nan,0,0
27791,32293,2182,0,0,0,0,.00nan,0,0
27791,38024,2182,72,24,1,23,.958,3600000,0
27793,2094,784,0,0,0,0,.00nan,0,0
27793,29309,784,57,45,6,39,.867,3600000,0
27793,32375,778,61,36,5,31,.861,3600000,0
27793,52598,778,0,0,0,0,.00nan,0,0
27795,11351,777,0,0,0,0,.00nan,0,0
27795,14274,777,83,28,1,27,.964,3600000,0
27795,26903,790,27,26,6,20,.769,2620000,0
27795,62837,790,52,8,1,7,.875,980000,0
27797,9995,780,43,21,4,17,.810,3738000,0
27797,28330,794,80,40,5,35,.875,3738000,0
27797,47447,780,0,0,0,0,.00nan,0,0
27797,60283,794,0,0,0,0,.00nan,0,0
27799,10691,792,20,35,7,28,.800,2989000,0
27799,23312,792,43,3,1,2,.667,611000,0
27799,44468,781,41,16,3,13,.813,3600000,0
27799,66629,781,0,0,0,0,.00nan,0,0
27801,2895,776,0,0,0,0,.00nan,0,0
27801,23243,776,35,26,6,20,.769,3562000,0
27801,32293,2182,65,32,4,28,.875,3600000,0
27801,38024,2182,0,0,0,0,.00nan,0,0
27803,11351,777,0,0,0,0,.00nan,0,0
27803,14274,777,47,23,4,19,.826,3600000,0
27803,44468,781,38,12,3,9,.750,1715000,0
27803,66629,781,14,23,6,17,.739,1885000,0
27805,10691,792,0,0,0,0,.00nan,0,0
27805,22860,783,76,22,1,21,.955,3600000,0
27805,23312,792,64,44,4,40,.909,3600000,0
27805,82588,783,0,0,0,0,.00nan,0,0
27807,9995,780,0,0,0,0,.00nan,0,0
27807,10066,796,71,25,2,23,.920,3600000,0
27807,44580,796,0,0,0,0,.00nan,0,0
27807,47447,780,56,23,3,20,.870,3571000,0
27809,2094,784,94,40,2,38,.950,3600000,0
27809,28330,794,0,0,0,0,.00nan,0,0
27809,29309,784,0,0,0,0,.00nan,0,0
27809,60283,794,47,28,4,24,.857,3517000,0
27811,26903,790,0,0,0,0,.00nan,0,0
27811,32375,778,0,0,0,0,.00nan,0,0
27811,52598,778,57,44,5,39,.886,3795000,0
27811,62837,790,56,30,4,26,.867,3795000,0
27813,2094,784,0,0,0,0,.00nan,0,0
27813,28330,794,86,34,2,32,.941,3900000,0
27813,29309,784,85,38,2,36,.947,3900000,0
27813,60283,794,0,0,0,0,.00nan,0,0
27815,26903,790,79,40,3,37,.925,3600000,0
27815,32375,778,75,27,2,25,.926,3600000,0
27815,52598,778,0,0,0,0,.00nan,0,0
27815,62837,790,0,0,0,0,.00nan,0,0
27817,10691,792,47,23,3,20,.870,3600000,0
27817,23312,792,0,0,0,0,.00nan,0,0
27817,32293,2182,0,0,0,0,.00nan,0,0
27817,38024,2182,41,35,6,29,.829,3600000,0
27819,2895,776,88,42,2,40,.952,3600000,0
27819,11351,777,0,0,0,0,.00nan,0,0
27819,14274,777,61,29,3,26,.897,3548000,0
27819,23243,776,0,0,0,0,.00nan,0,0
27821,9995,780,84,16,0,16,1000,3600000,0
27821,22860,783,0,0,0,0,.00nan,0,0
27821,47447,780,0,0,0,0,.00nan,0,0
27821,82588,783,52,36,5,31,.861,3600000,0
27823,10066,796,0,0,0,0,.00nan,0,0
27823,44468,781,43,22,4,18,.818,3546000,0
27823,44580,796,88,36,2,34,.944,3600000,0
27823,66629,781,0,0,0,0,.00nan,0,0
27825,32375,778,0,0,0,0,.00nan,0,0
27825,44468,781,0,0,0,0,.00nan,0,0
27825,52598,778,78,46,4,42,.913,3600000,0
27825,66629,781,84,24,1,23,.958,3600000,0
27827,26903,790,0,0,0,0,.00nan,0,0
27827,28330,794,0,0,0,0,.00nan,0,0
27827,60283,794,67,32,3,29,.906,3600000,0
27827,62837,790,56,32,5,27,.844,3558000,0
27829,2094,784,29,31,6,25,.806,2756000,0
27829,10066,796,66,18,1,17,.944,3600000,0
27829,29309,784,61,8,0,8,1000,844000,0
27829,44580,796,0,0,0,0,.00nan,0,0
27831,9995,780,83,37,2,35,.946,3600000,0
27831,10691,792,0,0,0,0,.00nan,0,0
27831,23312,792,56,27,3,24,.889,3600000,0
27831,47447,780,0,0,0,0,.00nan,0,0
27833,11351,777,58,20,2,18,.900,3600000,0
27833,14274,777,0,0,0,0,.00nan,0,0
27833,32293,2182,76,36,3,33,.917,3598000,0
27833,38024,2182,0,0,0,0,.00nan,0,0
27835,2895,776,0,0,0,0,.00nan,0,0
27835,22860,783,48,31,4,27,.871,3600000,0
27835,23243,776,95,20,0,20,1000,3600000,0
27835,82588,783,0,0,0,0,.00nan,0,0
27836,13336,2626,0,0,0,0,.00nan,0,0
27836,14123,2626,100,29,0,29,1000,3600000,0
27836,19710,555,74,13,0,13,1000,1389000,0
27836,20630,555,33,23,5,18,.783,2211000,0
27837,10125,1423,44,34,6,28,.824,2830000,0
27837,25306,1423,41,2,1,1,.500,770000,0
27837,28000,561,100,33,0,33,1000,3600000,0
27837,43460,561,0,0,0,0,.00nan,0,0
27838,10837,560,46,14,2,12,.857,3600000,0
27838,13377,552,31,18,5,13,.722,1342000,0
27838,34044,552,35,29,6,23,.793,2258000,0
27838,44608,560,0,0,0,0,.00nan,0,0
27839,13336,2626,0,0,0,0,.00nan,0,0
27839,14123,2626,76,30,2,28,.933,3584000,0
27839,28000,561,93,34,1,33,.971,3600000,0
27839,43460,561,0,0,0,0,.00nan,0,0
27840,13377,552,42,17,3,14,.824,1846000,0
27840,19710,555,0,0,0,0,.00nan,0,0
27840,20630,555,66,22,2,20,.909,3600000,0
27840,34044,552,40,33,6,27,.818,1754000,0
27841,10125,1423,70,26,2,24,.923,3515000,0
27841,10837,560,100,26,0,26,1000,3600000,0
27841,25306,1423,0,0,0,0,.00nan,0,0
27841,44608,560,0,0,0,0,.00nan,0,0
27842,13336,2626,0,0,0,0,.00nan,0,0
27842,14123,2626,80,25,1,24,.960,3600000,0
27842,28000,561,0,0,0,0,.00nan,0,0
27842,43460,561,82,34,2,32,.941,3573000,0
27843,6918,553,0,0,0,0,.00nan,0,0
27843,10489,553,100,34,0,34,1000,3600000,0
27843,10837,560,67,36,4,32,.889,3600000,0
27843,44608,560,0,0,0,0,.00nan,0,0
27845,10125,1423,0,0,0,0,.00nan,0,0
27845,19710,555,0,0,0,0,.00nan,0,0
27845,20630,555,45,34,5,29,.853,3600000,0
27845,25306,1423,94,46,4,42,.913,3600000,0
27846,5946,556,0,0,0,0,.00nan,0,0
27846,10837,560,53,27,3,24,.889,3900000,0
27846,17274,556,75,32,3,29,.906,3900000,0
27846,44608,560,0,0,0,0,.00nan,0,0
27847,5946,556,0,0,0,0,.00nan,0,0
27847,17274,556,85,21,0,21,1000,3600000,0
27847,34044,552,35,7,2,5,.714,659000,0
27847,47508,552,41,37,6,31,.838,2941000,0
27848,457,558,0,0,0,0,.00nan,0,0
27848,1698,558,47,31,5,26,.839,3900000,0
27848,19710,555,0,0,0,0,.00nan,0,0
27848,20630,555,54,37,5,32,.865,3900000,0
27849,457,558,0,0,0,0,.00nan,0,0
27849,1698,558,82,24,1,23,.958,3600000,0
27849,13336,2626,0,0,0,0,.00nan,0,0
27849,14123,2626,43,35,6,29,.829,3600000,0
27850,6918,553,0,0,0,0,.00nan,0,0
27850,10489,553,55,31,5,26,.839,3600000,0
27850,28000,561,60,53,7,46,.868,3600000,0
27850,43460,561,0,0,0,0,.00nan,0,0
27851,6918,553,0,0,0,0,.00nan,0,0
27851,10489,553,69,27,2,25,.926,3600000,0
27851,19710,555,0,0,0,0,.00nan,0,0
27851,20630,555,72,47,5,42,.894,3600000,0
27852,457,558,0,0,0,0,.00nan,0,0
27852,1698,558,85,39,2,37,.949,3600000,0
27852,10125,1423,0,0,0,0,.00nan,0,0
27852,25306,1423,34,32,6,26,.813,3600000,0
27853,10837,560,41,26,4,22,.846,3600000,0
27853,13336,2626,0,0,0,0,.00nan,0,0
27853,14123,2626,92,43,3,40,.930,3600000,0
27853,44608,560,0,0,0,0,.00nan,0,0
27854,19710,555,86,29,1,28,.966,3600000,0
27854,20630,555,0,0,0,0,.00nan,0,0
27854,34044,552,49,30,4,26,.867,3600000,0
27854,47508,552,0,0,0,0,.00nan,0,0
27855,457,558,0,0,0,0,.00nan,0,0
27855,1698,558,30,28,6,22,.786,3600000,0
27855,10125,1423,52,22,3,19,.864,3600000,0
27855,25306,1423,0,0,0,0,.00nan,0,0
27856,10125,1423,0,0,0,0,.00nan,0,0
27856,10837,560,0,0,0,0,.00nan,0,0
27856,25306,1423,84,35,1,34,.971,3600000,0
27856,44608,560,78,42,3,39,.929,3579000,0
27858,6918,553,67,38,4,34,.895,3583000,0
27858,9103,554,0,0,0,0,.00nan,0,0
27858,10489,553,0,0,0,0,.00nan,0,0
27858,25538,554,69,31,3,28,.903,3600000,0
27859,5946,556,0,0,0,0,.00nan,0,0
27859,13336,2626,0,0,0,0,.00nan,0,0
27859,14123,2626,50,22,3,19,.864,3600000,0
27859,17274,556,100,27,0,27,1000,3600000,0
27863,10125,2626,0,0,0,0,.00nan,0,0
27863,13336,2626,69,45,5,40,.889,3538000,0
27863,19710,555,0,0,0,0,.00nan,0,0
27863,20630,555,69,29,3,26,.897,3600000,0
27864,6918,553,41,21,4,17,.810,3600000,0
27864,10489,553,0,0,0,0,.00nan,0,0
27864,28000,561,40,31,6,25,.806,2121000,0
27864,43460,561,50,7,1,6,.857,1479000,0
27865,9103,554,0,0,0,0,.00nan,0,0
27865,13336,2626,0,0,0,0,.00nan,0,0
27865,14123,2626,30,20,5,15,.750,3600000,0
27865,25538,554,79,29,2,27,.931,3600000,0
27866,10837,560,61,18,2,16,.889,3600000,0
27866,34044,552,0,0,0,0,.00nan,0,0
27866,44608,560,0,0,0,0,.00nan,0,0
27866,47508,552,60,38,5,33,.868,3600000,0
27867,5946,556,0,0,0,0,.00nan,0,0
27867,10125,1423,0,0,0,0,.00nan,0,0
27867,17274,556,75,31,2,29,.935,3600000,0
27867,25306,1423,76,25,1,24,.960,3600000,0
27868,457,558,0,0,0,0,.00nan,0,0
27868,1698,558,61,31,3,28,.903,3561000,0
27868,6918,553,0,0,0,0,.00nan,0,0
27868,10489,553,80,35,2,33,.943,3600000,0
27872,5946,556,0,0,0,0,.00nan,0,0
27872,17274,556,16,26,6,20,.769,3600000,0
27872,28000,561,61,31,3,28,.903,3600000,0
27872,43460,561,0,0,0,0,.00nan,0,0
27873,6918,553,0,0,0,0,.00nan,0,0
27873,10489,553,50,31,5,26,.839,3600000,0
27873,10837,560,0,0,0,0,.00nan,0,0
27873,44608,560,98,44,2,42,.955,3600000,0
27874,9103,554,0,0,0,0,.00nan,0,0
27874,25538,554,91,42,3,39,.929,3600000,0
27874,34044,552,90,34,1,33,.971,3600000,0
27874,47508,552,0,0,0,0,.00nan,0,0
27875,9103,554,0,0,0,0,.00nan,0,0
27875,25306,1423,0,0,0,0,.00nan,0,0
27875,25538,554,81,38,3,35,.921,3577000,0
27875,45036,1423,80,20,1,19,.950,3600000,0
28107,10125,1423,0,0,0,0,.00nan,0,0
28107,13336,2626,0,0,0,0,.00nan,0,0
28107,14123,2626,55,19,2,17,.895,3600000,0
28107,25306,1423,34,36,6,30,.833,3600000,0
28109,10744,556,0,0,0,0,.00nan,0,0
28109,17274,556,62,32,3,29,.906,3900000,0
28109,28000,561,60,30,3,27,.900,3900000,0
28109,43460,561,0,0,0,0,.00nan,0,0
28111,9103,554,85,35,2,33,.943,3573000,0
28111,10837,560,0,0,0,0,.00nan,0,0
28111,25538,554,0,0,0,0,.00nan,0,0
28111,44608,560,100,36,1,35,.972,3600000,0
28113,457,558,76,23,1,22,.957,3600000,0
28113,1698,558,0,0,0,0,.00nan,0,0
28113,13377,552,0,0,0,0,.00nan,0,0
28113,34044,552,34,37,7,30,.811,3600000,0
28117,9103,554,0,0,0,0,.00nan,0,0
28117,13336,2626,50,13,2,11,.846,3600000,0
28117,14123,2626,0,0,0,0,.00nan,0,0
28117,25538,554,84,49,5,44,.898,3600000,0
28119,10125,1423,79,30,1,29,.967,3600000,0
28119,10837,560,65,34,3,31,.912,3582000,0
28119,25306,1423,0,0,0,0,.00nan,0,0
28119,44608,560,0,0,0,0,.00nan,0,0
28121,13377,552,100,43,2,41,.953,3600000,0
28121,28000,561,0,0,0,0,.00nan,0,0
28121,34044,552,0,0,0,0,.00nan,0,0
28121,43460,561,59,29,3,26,.897,3588000,0
28123,255,553,0,0,0,0,.00nan,0,0
28123,457,558,0,0,0,0,.00nan,0,0
28123,1698,558,85,32,2,30,.938,3600000,0
28123,10489,553,65,31,3,28,.903,3543000,0
28127,457,558,61,21,2,19,.905,3515000,0
28127,1698,558,0,0,0,0,.00nan,0,0
28127,28000,561,100,34,0,34,1000,3600000,0
28127,43460,561,0,0,0,0,.00nan,0,0
28129,255,553,0,0,0,0,.00nan,0,0
28129,10489,553,84,39,4,35,.897,3688000,0
28129,19455,555,0,0,0,0,.00nan,0,0
28129,20630,555,56,26,3,23,.885,3688000,0
28131,10125,1423,0,0,0,0,.00nan,0,0
28131,10837,560,64,18,1,17,.944,2166000,0
28131,25306,1423,49,31,4,27,.871,3600000,0
28131,44608,560,22,11,4,7,.636,1419000,0
28133,10744,556,100,37,0,37,1000,3600000,0
28133,13377,552,0,0,0,0,.00nan,0,0
28133,17274,556,0,0,0,0,.00nan,0,0
28133,34044,552,76,24,2,22,.917,3590000,0
28135,9103,554,65,33,4,29,.879,3900000,0
28135,13336,2626,0,0,0,0,.00nan,0,0
28135,14123,2626,44,25,4,21,.840,3900000,0
28135,25538,554,0,0,0,0,.00nan,0,0
28137,9103,554,0,0,0,0,.00nan,0,0
28137,10744,556,51,18,3,15,.833,3600000,0
28137,17274,556,0,0,0,0,.00nan,0,0
28137,25538,554,51,35,5,30,.857,3533000,0
28139,13336,2626,81,23,2,21,.913,3600000,0
28139,13377,552,26,25,6,19,.760,1810000,0
28139,14123,2626,0,0,0,0,.00nan,0,0
28139,34044,552,56,22,3,19,.864,1790000,0
28141,255,553,71,39,3,36,.923,3557000,0
28141,457,558,0,0,0,0,.00nan,0,0
28141,1698,558,67,29,2,27,.931,3600000,0
28141,10489,553,0,0,0,0,.00nan,0,0
28143,10125,1423,14,29,7,22,.759,2955000,0
28143,10837,560,80,37,3,34,.919,3600000,0
28143,25306,1423,62,7,0,7,1000,645000,0
28143,44608,560,0,0,0,0,.00nan,0,0
28145,19455,555,42,20,4,16,.800,3600000,0
28145,20630,555,0,0,0,0,.00nan,0,0
28145,28000,561,68,47,5,42,.894,3561000,0
28145,43460,561,0,0,0,0,.00nan,0,0
28147,10125,1423,0,0,0,0,.00nan,0,0
28147,13377,552,0,0,0,0,.00nan,0,0
28147,25306,1423,42,30,5,25,.833,3600000,0
28147,34044,552,94,45,1,44,.978,3600000,0
28149,6918,553,58,32,4,28,.875,3518000,0
28149,10489,553,0,0,0,0,.00nan,0,0
28149,10744,556,0,0,0,0,.00nan,0,0
28149,17274,556,55,19,2,17,.895,3600000,0
28151,457,558,0,0,0,0,.00nan,0,0
28151,1698,558,81,23,1,22,.957,3600000,0
28151,9103,554,67,34,3,31,.912,3531000,0
28151,25538,554,0,0,0,0,.00nan,0,0
28153,13336,2626,75,11,0,11,1000,949000,0
28153,14123,2626,10,24,7,17,.708,2651000,0
28153,28000,561,0,0,0,0,.00nan,0,0
28153,43460,561,87,44,3,41,.932,3600000,0
28176,4209,4922,0,0,0,0,.00nan,0,0
28176,27142,4922,76,35,3,32,.914,3584000,0
28176,37072,1096,0,0,0,0,.00nan,0,0
28176,38650,1096,59,25,2,23,.920,3600000,0
28177,5078,72,0,0,0,0,.00nan,0,0
28177,8066,1095,64,31,4,27,.871,3549000,0
28177,36017,72,64,29,3,26,.897,3600000,0
28177,38665,1095,0,0,0,0,.00nan,0,0
28178,3553,71,76,28,2,26,.929,3600000,0
28178,34595,157,53,25,3,22,.880,3547000,0
28178,40386,157,0,0,0,0,.00nan,0,0
28178,76924,71,0,0,0,0,.00nan,0,0
28179,15244,78,0,0,0,0,.00nan,0,0
28179,17060,85,0,0,0,0,.00nan,0,0
28179,40094,78,87,37,3,34,.919,3600000,0
28179,40227,85,48,35,5,30,.857,3559000,0
28180,3779,82,68,37,4,33,.892,3600000,0
28180,24385,82,0,0,0,0,.00nan,0,0
28180,35813,77,72,24,1,23,.958,3600000,0
28180,38659,77,0,0,0,0,.00nan,0,0
28181,16928,4620,0,0,0,0,.00nan,0,0
28181,34329,4245,43,23,4,19,.826,3511000,0
28181,34684,4620,100,46,2,44,.957,3600000,0
28181,34911,4245,0,0,0,0,.00nan,0,0
28182,24381,151,94,28,1,27,.964,3600000,0
28182,29275,80,73,31,3,28,.903,3550000,0
28182,31424,151,0,0,0,0,.00nan,0,0
28182,52870,80,0,0,0,0,.00nan,0,0
28183,4234,149,70,19,1,18,.947,3600000,0
28183,22743,149,0,0,0,0,.00nan,0,0
28183,30246,152,89,48,4,44,.917,3600000,0
28183,32611,152,0,0,0,0,.00nan,0,0
28184,12786,4922,59,20,3,17,.850,3600000,0
28184,37072,1096,37,35,7,28,.800,3102000,0
28184,38650,1096,53,3,0,3,1000,498000,0
28184,59454,4922,0,0,0,0,.00nan,0,0
28185,8066,1095,0,0,0,0,.00nan,0,0
28185,35457,4921,0,0,0,0,.00nan,0,0
28185,40447,4921,46,23,4,19,.826,3545000,0
28185,54787,1095,93,42,3,39,.929,3600000,0
28186,6093,1097,0,0,0,0,.00nan,0,0
28186,26532,1097,67,29,3,26,.897,3592000,0
28186,29650,76,0,0,0,0,.00nan,0,0
28186,33404,76,94,27,1,26,.963,3600000,0
28187,3553,71,0,0,0,0,.00nan,0,0
28187,34595,157,0,0,0,0,.00nan,0,0
28187,40386,157,90,33,1,32,.970,3600000,0
28187,76924,71,50,29,4,25,.862,3585000,0
28188,8247,75,98,41,2,39,.951,3600000,0
28188,32574,74,0,0,0,0,.00nan,0,0
28188,34196,74,77,38,3,35,.921,3600000,0
28188,35048,75,0,0,0,0,.00nan,0,0
28189,5078,72,0,0,0,0,.00nan,0,0
28189,35573,2564,74,28,2,26,.929,3590000,0
28189,36017,72,75,25,1,24,.960,3600000,0
28189,50383,2564,0,0,0,0,.00nan,0,0
28190,84,81,76,28,1,27,.964,3600000,0
28190,496,158,0,0,0,0,.00nan,0,0
28190,32605,81,0,0,0,0,.00nan,0,0
28190,41821,158,67,30,2,28,.933,3595000,0
28191,16928,4620,75,29,1,28,.966,3900000,0
28191,32580,4245,0,0,0,0,.00nan,0,0
28191,34684,4620,0,0,0,0,.00nan,0,0
28191,34911,4245,72,22,1,21,.955,3900000,0
28192,15244,78,73,24,1,23,.958,3600000,0
28192,40094,78,0,0,0,0,.00nan,0,0
28192,40227,85,0,0,0,0,.00nan,0,0
28192,63494,85,76,37,2,35,.946,3600000,0
28193,3779,82,0,0,0,0,.00nan,0,0
28193,24385,82,61,35,4,31,.886,3600000,0
28193,34591,77,0,0,0,0,.00nan,0,0
28193,38659,77,100,32,0,32,1000,3600000,0
28194,4234,149,0,0,0,0,.00nan,0,0
28194,22743,149,54,23,3,20,.870,3600000,0
28194,36324,152,0,0,0,0,.00nan,0,0
28194,52454,152,89,48,4,44,.917,3573000,0
28195,41,73,91,36,2,34,.944,3600000,0
28195,4661,73,0,0,0,0,.00nan,0,0
28195,8191,69,0,0,0,0,.00nan,0,0
28195,40477,69,47,29,5,24,.828,3600000,0
28196,9230,67,0,0,0,0,.00nan,0,0
28196,16896,67,80,39,2,37,.949,3600000,0
28196,34604,4920,44,16,3,13,.813,3572000,0
28196,36342,4920,0,0,0,0,.00nan,0,0
28197,12786,4922,0,0,0,0,.00nan,0,0
28197,29650,76,87,28,1,27,.964,3600000,0
28197,33404,76,0,0,0,0,.00nan,0,0
28197,59454,4922,76,29,2,27,.931,3600000,0
28198,6093,1097,87,19,0,19,1000,3600000,0
28198,26532,1097,0,0,0,0,.00nan,0,0
28198,34591,77,64,35,4,31,.886,3600000,0
28198,38659,77,0,0,0,0,.00nan,0,0
28199,16928,4620,0,0,0,0,.00nan,0,0
28199,32580,4245,98,24,0,24,1000,3600000,0
28199,34684,4620,35,23,5,18,.783,3600000,0
28199,34911,4245,0,0,0,0,.00nan,0,0
28200,15244,78,0,0,0,0,.00nan,0,0
28200,40094,78,72,29,3,26,.897,3576000,0
28200,40227,85,85,26,1,25,.962,3600000,0
28200,63494,85,0,0,0,0,.00nan,0,0
28201,8247,75,0,0,0,0,.00nan,0,0
28201,32574,74,60,34,4,30,.882,3600000,0
28201,34196,74,0,0,0,0,.00nan,0,0
28201,35048,75,51,32,5,27,.844,3586000,0
28202,41,73,0,0,0,0,.00nan,0,0
28202,4661,73,71,38,3,35,.921,3600000,0
28202,8191,69,75,30,2,28,.933,3600000,0
28202,40477,69,0,0,0,0,.00nan,0,0
28203,9230,67,49,29,4,25,.862,3600000,0
28203,16896,67,0,0,0,0,.00nan,0,0
28203,34604,4920,0,0,0,0,.00nan,0,0
28203,36342,4920,100,31,1,30,.968,3600000,0
29185,5073,76,0,0,0,0,.00nan,0,0
29185,5078,72,0,0,0,0,.00nan,0,0
29185,36017,72,49,20,3,17,.850,3600000,0
29185,39158,76,50,32,5,27,.844,3516000,0
29187,17034,158,51,2,0,2,1000,371000,0
29187,32580,4245,59,16,1,15,.938,3600000,0
29187,34911,4245,0,0,0,0,.00nan,0,0
29187,50194,158,46,43,7,36,.837,3229000,0
29189,8066,1095,0,0,0,0,.00nan,0,0
29189,36893,77,0,0,0,0,.00nan,0,0
29189,38659,77,97,33,1,32,.970,3600000,0
29189,38665,1095,48,30,4,26,.867,3600000,0
29191,14342,75,0,0,0,0,.00nan,0,0
29191,29275,80,38,32,6,26,.813,3600000,0
29191,35048,75,73,33,2,31,.939,3600000,0
29191,52870,80,0,0,0,0,.00nan,0,0
29193,8191,69,60,32,4,28,.875,3535000,0
29193,34604,4920,58,21,2,19,.905,3600000,0
29193,36342,4920,0,0,0,0,.00nan,0,0
29193,40477,69,0,0,0,0,.00nan,0,0
29195,24381,151,87,46,4,42,.913,3900000,0
29195,31424,151,0,0,0,0,.00nan,0,0
29195,35457,4921,46,31,4,27,.871,3900000,0
29195,40447,4921,0,0,0,0,.00nan,0,0
29197,30246,152,74,43,5,38,.884,3600000,0
29197,32611,152,0,0,0,0,.00nan,0,0
29197,34595,157,83,15,0,15,1000,3600000,0
29197,40386,157,0,0,0,0,.00nan,0,0
29199,4661,73,92,46,3,43,.935,3544000,0
29199,9230,67,0,0,0,0,.00nan,0,0
29199,16896,67,70,28,2,26,.929,3600000,0
29199,30429,73,0,0,0,0,.00nan,0,0
29201,3779,82,0,0,0,0,.00nan,0,0
29201,16928,4620,0,0,0,0,.00nan,0,0
29201,24385,82,63,29,3,26,.897,3900000,0
29201,34684,4620,77,38,3,35,.921,3900000,0
29203,3553,71,93,39,2,37,.949,3900000,0
29203,17060,85,0,0,0,0,.00nan,0,0
29203,40227,85,92,41,2,39,.951,3900000,0
29203,76924,71,0,0,0,0,.00nan,0,0
29205,4209,4922,0,0,0,0,.00nan,0,0
29205,22743,149,44,24,4,20,.833,3600000,0
29205,23965,149,0,0,0,0,.00nan,0,0
29205,27142,4922,62,38,5,33,.868,3579000,0
29207,3654,81,41,35,6,29,.829,3246000,0
29207,32605,81,52,2,0,2,1000,354000,0
29207,35573,2564,67,26,3,23,.885,3600000,0
29207,50383,2564,0,0,0,0,.00nan,0,0
29209,14114,1097,72,31,2,29,.935,3545000,0
29209,26532,1097,0,0,0,0,.00nan,0,0
29209,37072,1096,99,37,1,36,.973,3600000,0
29209,38650,1096,0,0,0,0,.00nan,0,0
29211,15244,78,0,0,0,0,.00nan,0,0
29211,32574,74,0,0,0,0,.00nan,0,0
29211,34196,74,71,30,3,27,.900,3600000,0
29211,40094,78,54,24,4,20,.833,3600000,0
29213,24381,151,0,0,0,0,.00nan,0,0
29213,31424,151,73,30,2,28,.933,3550000,0
29213,34604,4920,0,0,0,0,.00nan,0,0
29213,36342,4920,79,25,1,24,.960,3600000,0
29215,29275,80,0,0,0,0,.00nan,0,0
29215,32574,74,100,40,1,39,.975,3600000,0
29215,34196,74,0,0,0,0,.00nan,0,0
29215,52870,80,71,24,2,22,.917,3600000,0
29217,5078,72,65,22,3,19,.864,3600000,0
29217,15244,78,100,38,0,38,1000,3600000,0
29217,36017,72,0,0,0,0,.00nan,0,0
29217,40094,78,0,0,0,0,.00nan,0,0
29219,17060,85,92,24,1,23,.958,3600000,0
29219,37072,1096,0,0,0,0,.00nan,0,0
29219,38650,1096,51,28,4,24,.857,3600000,0
29219,40227,85,0,0,0,0,.00nan,0,0
29221,3553,71,0,0,0,0,.00nan,0,0
29221,36893,77,93,33,2,31,.939,3900000,0
29221,38659,77,0,0,0,0,.00nan,0,0
29221,76924,71,86,35,2,33,.943,3900000,0
29223,5073,76,60,34,4,30,.882,3600000,0
29223,34595,157,58,36,5,31,.861,3600000,0
29223,39158,76,0,0,0,0,.00nan,0,0
29223,40386,157,0,0,0,0,.00nan,0,0
29225,8191,69,0,0,0,0,.00nan,0,0
29225,14342,75,32,32,6,26,.813,3600000,0
29225,35048,75,0,0,0,0,.00nan,0,0
29225,40477,69,100,25,0,25,1000,3600000,0
29227,4661,73,0,0,0,0,.00nan,0,0
29227,22743,149,0,0,0,0,.00nan,0,0
29227,23965,149,47,34,4,30,.882,3900000,0
29227,30429,73,86,46,4,42,.913,3900000,0
29229,3654,81,0,0,0,0,.00nan,0,0
29229,4209,4922,61,29,3,26,.897,3600000,0
29229,27142,4922,0,0,0,0,.00nan,0,0
29229,32605,81,54,37,5,32,.865,3564000,0
29231,17034,158,61,28,3,25,.893,3600000,0
29231,35573,2564,0,0,0,0,.00nan,0,0
29231,50194,158,0,0,0,0,.00nan,0,0
29231,50383,2564,74,30,2,28,.933,3600000,0
29233,14114,1097,0,0,0,0,.00nan,0,0
29233,26532,1097,96,30,1,29,.967,3600000,0
29233,32580,4245,0,0,0,0,.00nan,0,0
29233,34911,4245,78,38,3,35,.921,3534000,0
29235,16928,4620,76,31,2,29,.935,3600000,0
29235,30246,152,0,0,0,0,.00nan,0,0
29235,32611,152,71,37,3,34,.919,3600000,0
29235,34684,4620,0,0,0,0,.00nan,0,0
29237,8066,1095,69,27,2,25,.926,3600000,0
29237,35457,4921,0,0,0,0,.00nan,0,0
29237,38665,1095,0,0,0,0,.00nan,0,0
29237,40447,4921,51,36,6,30,.833,3600000,0
29239,3779,82,57,23,3,20,.870,3600000,0
29239,9230,67,67,42,5,37,.881,3590000,0
29239,16896,67,0,0,0,0,.00nan,0,0
29239,24385,82,0,0,0,0,.00nan,0,0
29241,3779,82,89,21,0,21,1000,3600000,0
29241,8066,1095,0,0,0,0,.00nan,0,0
29241,24385,82,0,0,0,0,.00nan,0,0
29241,38665,1095,83,36,3,33,.917,3600000,0
29243,16928,4620,0,0,0,0,.00nan,0,0
29243,22743,149,45,17,3,14,.824,3600000,0
29243,23965,149,0,0,0,0,.00nan,0,0
29243,34684,4620,100,35,0,35,1000,3600000,0
29245,24381,151,82,35,2,33,.943,3900000,0
29245,31424,151,0,0,0,0,.00nan,0,0
29245,35573,2564,78,36,2,34,.944,3900000,0
29245,50383,2564,0,0,0,0,.00nan,0,0
29247,32574,74,0,0,0,0,.00nan,0,0
29247,34196,74,78,30,2,28,.933,3600000,0
29247,35457,4921,72,20,1,19,.950,3600000,0
29247,40447,4921,0,0,0,0,.00nan,0,0
29249,4209,4922,50,0,0,0,.00nan,273000,0
29249,27142,4922,47,38,6,32,.842,3327000,0
29249,29275,80,6,23,8,15,.652,3584000,0
29249,52870,80,0,0,0,0,.00nan,0,0
29251,14114,1097,67,27,2,25,.926,3600000,0
29251,26532,1097,0,0,0,0,.00nan,0,0
29251,34604,4920,76,21,1,20,.952,3600000,0
29251,36342,4920,0,0,0,0,.00nan,0,0
29253,5078,72,0,0,0,0,.00nan,0,0
29253,9230,67,0,0,0,0,.00nan,0,0
29253,16896,67,83,30,2,28,.933,3900000,0
29253,36017,72,69,25,2,23,.920,3900000,0
29255,3553,71,54,28,3,25,.893,3900000,0
29255,37072,1096,74,35,3,32,.914,3900000,0
29255,38650,1096,0,0,0,0,.00nan,0,0
29255,76924,71,0,0,0,0,.00nan,0,0
29257,17034,158,56,23,3,20,.870,3600000,0
29257,30246,152,69,53,5,48,.906,3600000,0
29257,32611,152,0,0,0,0,.00nan,0,0
29257,50194,158,0,0,0,0,.00nan,0,0
29259,14342,75,0,0,0,0,.00nan,0,0
29259,32580,4245,0,0,0,0,.00nan,0,0
29259,34911,4245,82,25,1,24,.960,3600000,0
29259,35048,75,67,47,4,43,.915,3600000,0
29261,3654,81,82,43,3,40,.930,3539000,0
29261,17060,85,0,0,0,0,.00nan,0,0
29261,32605,81,0,0,0,0,.00nan,0,0
29261,40227,85,88,28,1,27,.964,3600000,0
29263,4661,73,76,36,3,33,.917,3518000,0
29263,15244,78,78,25,1,24,.960,3600000,0
29263,30429,73,0,0,0,0,.00nan,0,0
29263,40094,78,0,0,0,0,.00nan,0,0
29265,34595,157,0,0,0,0,.00nan,0,0
29265,36893,77,56,5,0,5,1000,262000,0
29265,38659,77,29,51,9,42,.824,3338000,0
29265,40386,157,48,27,4,23,.852,3600000,0
29267,5073,76,0,0,0,0,.00nan,0,0
29267,8191,69,62,11,1,10,.909,1397000,0
29267,39158,76,100,35,2,33,.943,3600000,0
29267,40477,69,16,13,5,8,.615,2203000,0
29269,8066,1095,49,37,5,32,.865,3600000,0
29269,32580,4245,58,24,3,21,.875,3600000,0
29269,34911,4245,0,0,0,0,.00nan,0,0
29269,38665,1095,0,0,0,0,.00nan,0,0
29271,8191,69,73,10,0,10,1000,3600000,0
29271,30246,152,72,41,4,37,.902,3600000,0
29271,32611,152,0,0,0,0,.00nan,0,0
29271,40477,69,0,0,0,0,.00nan,0,0
29273,5078,72,0,0,0,0,.00nan,0,0
29273,24381,151,73,30,2,28,.933,3600000,0
29273,31424,151,0,0,0,0,.00nan,0,0
29273,36017,72,55,29,4,25,.862,3587000,0
29275,3654,81,35,32,6,26,.813,2990000,0
29275,22743,149,88,36,2,34,.944,3600000,0
29275,23965,149,0,0,0,0,.00nan,0,0
29275,32605,81,47,8,1,7,.875,610000,0
29277,3553,71,60,37,5,32,.865,3600000,0
29277,14114,1097,0,0,0,0,.00nan,0,0
29277,26532,1097,74,20,1,19,.950,3600000,0
29277,76924,71,0,0,0,0,.00nan,0,0
29279,4209,4922,0,0,0,0,.00nan,0,0
29279,4661,73,77,35,3,32,.914,3600000,0
29279,27142,4922,86,32,2,30,.938,3600000,0
29279,30429,73,0,0,0,0,.00nan,0,0
29281,34604,4920,78,23,1,22,.957,3600000,0
29281,35457,4921,0,0,0,0,.00nan,0,0
29281,36342,4920,0,0,0,0,.00nan,0,0
29281,40447,4921,41,22,4,18,.818,3600000,0
29283,15244,78,0,0,0,0,.00nan,0,0
29283,29275,80,61,20,2,18,.900,3900000,0
29283,40094,78,75,26,2,24,.923,3900000,0
29283,52870,80,0,0,0,0,.00nan,0,0
29285,34595,157,86,23,1,22,.957,3600000,0
29285,37072,1096,47,26,4,22,.846,3600000,0
29285,38650,1096,0,0,0,0,.00nan,0,0
29285,40386,157,0,0,0,0,.00nan,0,0
29287,9230,67,44,4,1,3,.750,312000,0
29287,16896,67,38,32,6,26,.813,3288000,0
29287,17060,85,0,0,0,0,.00nan,0,0
29287,40227,85,85,31,2,29,.935,3600000,0
29289,14342,75,0,0,0,0,.00nan,0,0
29289,32574,74,38,40,6,34,.850,3600000,0
29289,34196,74,0,0,0,0,.00nan,0,0
29289,35048,75,60,20,2,18,.900,3600000,0
29291,16928,4620,0,0,0,0,.00nan,0,0
29291,17034,158,83,27,1,26,.963,3600000,0
29291,34684,4620,60,33,4,29,.879,3600000,0
29291,50194,158,0,0,0,0,.00nan,0,0
29293,5073,76,72,35,3,32,.914,3570000,0
29293,35573,2564,86,29,1,28,.966,3600000,0
29293,39158,76,0,0,0,0,.00nan,0,0
29293,50383,2564,0,0,0,0,.00nan,0,0
29295,3779,82,74,34,3,31,.912,3600000,0
29295,24385,82,0,0,0,0,.00nan,0,0
29295,36893,77,23,13,4,9,.692,942000,0
29295,38659,77,77,23,1,22,.957,2616000,0
29297,3553,71,0,0,0,0,.00nan,0,0
29297,15244,78,64,46,6,40,.870,3600000,0
29297,40094,78,0,0,0,0,.00nan,0,0
29297,76924,71,60,25,3,22,.880,3600000,0
29299,22743,149,0,0,0,0,.00nan,0,0
29299,23965,149,77,23,1,22,.957,3600000,0
29299,32574,74,0,0,0,0,.00nan,0,0
29299,34196,74,73,46,5,41,.891,3600000,0
29301,4209,4922,91,36,1,35,.972,3900000,0
29301,14342,75,90,28,1,27,.964,3900000,0
29301,27142,4922,0,0,0,0,.00nan,0,0
29301,35048,75,0,0,0,0,.00nan,0,0
29303,3779,82,0,0,0,0,.00nan,0,0
29303,9230,67,62,25,3,22,.880,3600000,0
29303,16896,67,0,0,0,0,.00nan,0,0
29303,24385,82,85,25,1,24,.960,3600000,0
29305,32580,4245,0,0,0,0,.00nan,0,0
29305,34595,157,0,0,0,0,.00nan,0,0
29305,34911,4245,53,34,4,30,.882,3559000,0
29305,40386,157,64,31,3,28,.903,3600000,0
29307,24381,151,0,0,0,0,.00nan,0,0
29307,31424,151,81,34,2,32,.941,3600000,0
29307,37072,1096,0,0,0,0,.00nan,0,0
29307,38650,1096,64,29,3,26,.897,3544000,0
29309,4661,73,0,0,0,0,.00nan,0,0
29309,30429,73,58,17,1,16,.941,3600000,0
29309,35573,2564,0,0,0,0,.00nan,0,0
29309,50383,2564,47,37,6,31,.838,3600000,0
29311,3654,81,0,0,0,0,.00nan,0,0
29311,17034,158,0,0,0,0,.00nan,0,0
29311,32605,81,72,33,3,30,.909,3600000,0
29311,50194,158,44,22,4,18,.818,3572000,0
29313,8191,69,84,25,1,24,.960,3600000,0
29313,14114,1097,70,25,2,23,.920,3594000,0
29313,26532,1097,0,0,0,0,.00nan,0,0
29313,40477,69,0,0,0,0,.00nan,0,0
29315,5073,76,0,0,0,0,.00nan,0,0
29315,29275,80,0,0,0,0,.00nan,0,0
29315,39158,76,99,42,1,41,.976,3600000,0
29315,52870,80,63,26,2,24,.923,3543000,0
29317,34604,4920,64,16,1,15,.938,1780000,0
29317,35457,4921,76,23,1,22,.957,3600000,0
29317,36342,4920,25,23,6,17,.739,1820000,0
29317,40447,4921,0,0,0,0,.00nan,0,0
29319,16928,4620,100,28,0,28,1000,3600000,0
29319,30246,152,0,0,0,0,.00nan,0,0
29319,32611,152,81,38,2,36,.947,3574000,0
29319,34684,4620,0,0,0,0,.00nan,0,0
29321,5078,72,58,19,2,17,.895,3600000,0
29321,8066,1095,0,0,0,0,.00nan,0,0
29321,36017,72,0,0,0,0,.00nan,0,0
29321,38665,1095,66,31,3,28,.903,3544000,0
29323,17060,85,86,32,2,30,.938,3557000,0
29323,36893,77,100,35,1,34,.971,3600000,0
29323,38659,77,0,0,0,0,.00nan,0,0
29323,40227,85,0,0,0,0,.00nan,0,0
29325,30246,152,69,29,4,25,.862,3600000,0
29325,32611,152,0,0,0,0,.00nan,0,0
29325,36893,77,0,0,0,0,.00nan,0,0
29325,38659,77,68,45,5,40,.889,3545000,0
29327,3779,82,35,29,5,24,.828,3600000,0
29327,24385,82,0,0,0,0,.00nan,0,0
29327,34595,157,50,17,2,15,.882,3600000,0
29327,40386,157,0,0,0,0,.00nan,0,0
29329,5073,76,0,0,0,0,.00nan,0,0
29329,16928,4620,68,29,3,26,.897,3900000,0
29329,34684,4620,0,0,0,0,.00nan,0,0
29329,39158,76,88,39,3,36,.923,3900000,0
29331,3654,81,70,36,3,33,.917,3600000,0
29331,14342,75,0,0,0,0,.00nan,0,0
29331,32605,81,0,0,0,0,.00nan,0,0
29331,35048,75,45,29,5,24,.828,3531000,0
29333,5078,72,0,0,0,0,.00nan,0,0
29333,32580,4245,0,0,0,0,.00nan,0,0
29333,34911,4245,57,38,4,34,.895,3900000,0
29333,36017,72,82,38,4,34,.895,3900000,0
29335,34604,4920,0,0,0,0,.00nan,0,0
29335,35573,2564,52,31,4,27,.871,3552000,0
29335,36342,4920,73,33,3,30,.909,3600000,0
29335,50383,2564,0,0,0,0,.00nan,0,0
29337,3553,71,73,29,3,26,.897,3900000,0
29337,9230,67,90,44,3,41,.932,3900000,0
29337,16896,67,0,0,0,0,.00nan,0,0
29337,76924,71,0,0,0,0,.00nan,0,0
29339,35457,4921,69,25,2,23,.920,3574000,0
29339,37072,1096,0,0,0,0,.00nan,0,0
29339,38650,1096,86,28,1,27,.964,3600000,0
29339,40447,4921,0,0,0,0,.00nan,0,0
29341,24381,151,55,18,3,15,.833,3600000,0
29341,31424,151,0,0,0,0,.00nan,0,0
29341,32574,74,0,0,0,0,.00nan,0,0
29341,34196,74,44,36,5,31,.861,3571000,0
29343,4209,4922,0,0,0,0,.00nan,0,0
29343,17034,158,49,26,4,22,.846,3600000,0
29343,27142,4922,100,35,0,35,1000,3600000,0
29343,50194,158,0,0,0,0,.00nan,0,0
29345,8066,1095,95,35,1,34,.971,3900000,0
29345,14114,1097,67,18,1,17,.944,3900000,0
29345,26532,1097,0,0,0,0,.00nan,0,0
29345,38665,1095,0,0,0,0,.00nan,0,0
29347,8191,69,0,0,0,0,.00nan,0,0
29347,17060,85,0,0,0,0,.00nan,0,0
29347,40227,85,63,29,3,26,.897,3573000,0
29347,40477,69,71,18,1,17,.944,3600000,0
29349,4661,73,82,18,0,18,1000,3600000,0
29349,15244,78,76,46,5,41,.891,3600000,0
29349,30429,73,0,0,0,0,.00nan,0,0
29349,40094,78,0,0,0,0,.00nan,0,0
29351,22743,149,0,0,0,0,.00nan,0,0
29351,23965,149,65,29,3,26,.897,3900000,0
29351,29275,80,77,35,3,32,.914,3900000,0
29351,52870,80,0,0,0,0,.00nan,0,0
29353,3553,71,0,0,0,0,.00nan,0,0
29353,14114,1097,0,0,0,0,.00nan,0,0
29353,26532,1097,100,26,0,26,1000,3600000,0
29353,76924,71,51,48,7,41,.854,3600000,0
29355,4661,73,80,41,3,38,.927,3886000,0
29355,14342,75,51,31,4,27,.871,3886000,0
29355,30429,73,0,0,0,0,.00nan,0,0
29355,35048,75,0,0,0,0,.00nan,0,0
29357,9230,67,0,0,0,0,.00nan,0,0
29357,16896,67,63,30,3,27,.900,3552000,0
29357,34604,4920,54,15,2,13,.867,3600000,0
29357,36342,4920,0,0,0,0,.00nan,0,0
29359,34595,157,0,0,0,0,.00nan,0,0
29359,35457,4921,0,0,0,0,.00nan,0,0
29359,40386,157,99,38,1,37,.974,3600000,0
29359,40447,4921,54,16,2,14,.875,3557000,0
29361,32574,74,71,34,3,31,.912,3900000,0
29361,34196,74,0,0,0,0,.00nan,0,0
29361,35573,2564,0,0,0,0,.00nan,0,0
29361,50383,2564,69,33,3,30,.909,3900000,0
29363,5078,72,0,0,0,0,.00nan,0,0
29363,8066,1095,67,15,1,14,.933,1366000,0
29363,36017,72,85,34,2,32,.941,3600000,0
29363,38665,1095,42,28,5,23,.821,2234000,0
29365,17060,85,36,25,5,20,.800,3600000,0
29365,32580,4245,95,28,1,27,.964,3600000,0
29365,34911,4245,0,0,0,0,.00nan,0,0
29365,40227,85,0,0,0,0,.00nan,0,0
29367,8191,69,71,31,3,28,.903,3900000,0
29367,16928,4620,0,0,0,0,.00nan,0,0
29367,34684,4620,95,46,3,43,.935,3900000,0
29367,40477,69,0,0,0,0,.00nan,0,0
29369,22743,149,78,31,3,28,.903,3900000,0
29369,23965,149,0,0,0,0,.00nan,0,0
29369,29275,80,0,0,0,0,.00nan,0,0
29369,52870,80,83,36,3,33,.917,3900000,0
29371,4209,4922,0,0,0,0,.00nan,0,0
29371,24381,151,0,0,0,0,.00nan,0,0
29371,27142,4922,99,56,2,54,.964,3600000,0
29371,31424,151,50,20,3,17,.850,3548000,0
29373,3654,81,59,9,0,9,1000,1433000,0
29373,32605,81,32,29,5,24,.828,2167000,0
29373,36893,77,86,31,2,29,.935,3600000,0
29373,38659,77,0,0,0,0,.00nan,0,0
29375,5073,76,64,36,4,32,.889,3600000,0
29375,15244,78,0,0,0,0,.00nan,0,0
29375,39158,76,0,0,0,0,.00nan,0,0
29375,40094,78,45,45,6,39,.867,3595000,0
29377,30246,152,0,0,0,0,.00nan,0,0
29377,32611,152,67,33,3,30,.909,3600000,0
29377,37072,1096,74,43,5,38,.884,3513000,0
29377,38650,1096,0,0,0,0,.00nan,0,0
29379,3779,82,0,0,0,0,.00nan,0,0
29379,17034,158,0,0,0,0,.00nan,0,0
29379,24385,82,89,35,2,33,.943,3600000,0
29379,50194,158,52,30,5,25,.833,3600000,0
29380,55660,109,88,33,2,31,.939,3600000,0
29380,58115,117,30,24,5,19,.792,3600000,0
29380,58153,109,0,0,0,0,.00nan,0,0
29380,77968,117,0,0,0,0,.00nan,0,0
29381,55913,116,0,0,0,0,.00nan,0,0
29381,56366,114,0,0,0,0,.00nan,0,0
29381,58555,116,83,36,2,34,.944,3600000,0
29381,63716,114,67,31,3,28,.903,3570000,0
29382,56479,112,0,0,0,0,.00nan,0,0
29382,62116,121,46,20,3,17,.850,3600000,0
29382,78025,112,37,29,5,24,.828,3587000,0
29382,79931,121,0,0,0,0,.00nan,0,0
29383,8450,120,36,12,3,9,.750,401000,0
29383,41903,111,0,0,0,0,.00nan,0,0
29383,56333,111,54,17,3,14,.824,3600000,0
29383,56368,120,47,17,2,15,.882,3168000,0
29384,4231,110,64,29,3,26,.897,3600000,0
29384,62116,121,0,0,0,0,.00nan,0,0
29384,63636,110,0,0,0,0,.00nan,0,0
29384,79931,121,58,34,5,29,.853,3527000,0
29385,52560,119,42,37,5,32,.865,3600000,0
29385,55905,124,0,0,0,0,.00nan,0,0
29385,56361,124,80,27,1,26,.963,3600000,0
29385,63656,119,0,0,0,0,.00nan,0,0
29386,56340,118,89,38,2,36,.947,3600000,0
29386,56474,118,0,0,0,0,.00nan,0,0
29386,63714,122,0,0,0,0,.00nan,0,0
29386,77796,122,58,29,3,26,.897,3524000,0
29387,55660,109,0,0,0,0,.00nan,0,0
29387,58090,108,0,0,0,0,.00nan,0,0
29387,58153,109,82,38,3,35,.921,3900000,0
29387,63688,108,44,19,3,16,.842,3900000,0
29388,55696,126,77,34,3,31,.912,3600000,0
29388,56191,126,0,0,0,0,.00nan,0,0
29388,70545,115,49,38,5,33,.868,3530000,0
29388,77782,115,0,0,0,0,.00nan,0,0
29389,1605,113,100,39,2,37,.949,3893000,0
29389,56284,113,0,0,0,0,.00nan,0,0
29389,58115,117,0,0,0,0,.00nan,0,0
29389,77968,117,68,30,2,28,.933,3900000,0
29390,55913,116,0,0,0,0,.00nan,0,0
29390,56841,127,0,0,0,0,.00nan,0,0
29390,58137,127,68,25,2,23,.920,3544000,0
29390,58555,116,98,40,1,39,.975,3600000,0
29391,52560,119,0,0,0,0,.00nan,0,0
29391,63656,119,57,25,3,22,.880,3600000,0
29391,63714,122,36,19,4,15,.789,2262000,0
29391,77796,122,40,8,2,6,.750,1338000,0
29392,41903,111,48,27,4,23,.852,3583000,0
29392,56333,111,0,0,0,0,.00nan,0,0
29392,56479,112,0,0,0,0,.00nan,0,0
29392,78025,112,76,27,2,25,.926,3600000,0
29393,8450,120,65,43,5,38,.884,3578000,0
29393,55636,125,46,20,3,17,.850,3600000,0
29393,56368,120,0,0,0,0,.00nan,0,0
29393,63650,125,0,0,0,0,.00nan,0,0
29394,55696,126,0,0,0,0,.00nan,0,0
29394,56191,126,100,35,0,35,1000,3600000,0
29394,70545,115,0,0,0,0,.00nan,0,0
29394,77782,115,42,32,5,27,.844,3600000,0
29395,55905,124,80,27,2,25,.926,3600000,0
29395,56361,124,0,0,0,0,.00nan,0,0
29395,56600,123,57,7,0,7,1000,459000,0
29395,58064,123,39,35,6,29,.829,3141000,0
29396,1605,113,38,24,4,20,.833,3600000,0
29396,56284,113,0,0,0,0,.00nan,0,0
29396,56366,114,54,23,3,20,.870,3600000,0
29396,63716,114,0,0,0,0,.00nan,0,0
29397,4231,110,55,23,2,21,.913,3900000,0
29397,55660,109,86,34,2,32,.941,3900000,0
29397,58153,109,0,0,0,0,.00nan,0,0
29397,63636,110,0,0,0,0,.00nan,0,0
29398,58090,108,0,0,0,0,.00nan,0,0
29398,62116,121,73,30,2,28,.933,3600000,0
29398,63688,108,60,37,5,32,.865,3600000,0
29398,79931,121,0,0,0,0,.00nan,0,0
29399,55636,125,0,0,0,0,.00nan,0,0
29399,55913,116,98,45,2,43,.956,3600000,0
29399,58555,116,0,0,0,0,.00nan,0,0
29399,63650,125,68,44,5,39,.886,3600000,0
29400,55696,126,0,0,0,0,.00nan,0,0
29400,56191,126,52,31,5,26,.839,3522000,0
29400,56841,127,0,0,0,0,.00nan,0,0
29400,61228,127,62,35,4,31,.886,3600000,0
29401,55913,116,0,0,0,0,.00nan,0,0
29401,58115,117,92,36,2,34,.944,3600000,0
29401,58555,116,62,42,5,37,.881,3600000,0
29401,77968,117,0,0,0,0,.00nan,0,0
29402,52618,115,0,0,0,0,.00nan,0,0
29402,56479,112,0,0,0,0,.00nan,0,0
29402,70545,115,94,52,4,48,.923,3600000,0
29402,78025,112,89,15,0,15,1000,3600000,0
29403,1605,113,52,19,3,16,.842,3545000,0
29403,56284,113,0,0,0,0,.00nan,0,0
29403,56600,123,0,0,0,0,.00nan,0,0
29403,58064,123,75,29,2,27,.931,3600000,0
29404,8450,120,81,44,4,40,.909,3541000,0
29404,56368,120,0,0,0,0,.00nan,0,0
29404,56841,127,0,0,0,0,.00nan,0,0
29404,61228,127,70,25,2,23,.920,3600000,0
29405,4231,110,68,29,3,26,.897,3900000,0
29405,52618,115,93,52,3,49,.942,3900000,0
29405,63636,110,0,0,0,0,.00nan,0,0
29405,70545,115,0,0,0,0,.00nan,0,0
29406,55696,126,39,32,5,27,.844,3528000,0
29406,56191,126,0,0,0,0,.00nan,0,0
29406,56340,118,72,35,3,32,.914,3600000,0
29406,56474,118,0,0,0,0,.00nan,0,0
29407,45278,114,86,35,2,33,.943,3600000,0
29407,56286,121,0,0,0,0,.00nan,0,0
29407,56366,114,0,0,0,0,.00nan,0,0
29407,62116,121,41,26,4,22,.846,3517000,0
29408,55660,109,47,28,5,23,.821,3550000,0
29408,55913,116,87,47,3,44,.936,3600000,0
29408,58153,109,0,0,0,0,.00nan,0,0
29408,58555,116,0,0,0,0,.00nan,0,0
29409,52560,119,31,24,5,19,.792,3549000,0
29409,58090,108,0,0,0,0,.00nan,0,0
29409,63656,119,0,0,0,0,.00nan,0,0
29409,63688,108,79,38,3,35,.921,3600000,0
29410,41903,111,0,0,0,0,.00nan,0,0
29410,56333,111,81,36,4,32,.889,3900000,0
29410,56341,122,57,34,4,30,.882,3900000,0
29410,77796,122,0,0,0,0,.00nan,0,0
29411,55636,125,71,28,2,26,.929,3553000,0
29411,55905,124,0,0,0,0,.00nan,0,0
29411,56361,124,98,30,1,29,.967,3600000,0
29411,63650,125,0,0,0,0,.00nan,0,0
29412,56479,112,0,0,0,0,.00nan,0,0
29412,58115,117,45,31,5,26,.839,3551000,0
29412,77968,117,0,0,0,0,.00nan,0,0
29412,78025,112,70,35,4,31,.886,3600000,0
29413,56286,121,69,22,2,20,.909,3600000,0
29413,56340,118,0,0,0,0,.00nan,0,0
29413,56474,118,97,48,3,45,.938,3547000,0
29413,62116,121,0,0,0,0,.00nan,0,0
29414,1605,113,75,38,3,35,.921,3579000,0
29414,56284,113,0,0,0,0,.00nan,0,0
29414,56841,127,74,27,2,25,.926,3600000,0
29414,61228,127,0,0,0,0,.00nan,0,0
29415,41903,111,57,27,3,24,.889,3835000,0
29415,55660,109,0,0,0,0,.00nan,0,0
29415,56333,111,0,0,0,0,.00nan,0,0
29415,58153,109,51,30,4,26,.867,3835000,0
29416,8450,120,0,0,0,0,.00nan,0,0
29416,55913,116,0,0,0,0,.00nan,0,0
29416,56368,120,61,39,4,35,.897,3900000,0
29416,58555,116,46,29,4,25,.862,3900000,0
29417,52618,115,0,0,0,0,.00nan,0,0
29417,58090,108,33,13,4,9,.692,1141000,0
29417,63688,108,57,26,3,23,.885,2459000,0
29417,70545,115,57,30,4,26,.867,3600000,0
29418,45278,114,50,39,5,34,.872,3600000,0
29418,56341,122,0,0,0,0,.00nan,0,0
29418,56366,114,0,0,0,0,.00nan,0,0
29418,77796,122,61,21,2,19,.905,3600000,0
29419,55636,125,0,0,0,0,.00nan,0,0
29419,56600,123,62,37,5,32,.865,3600000,0
29419,58064,123,0,0,0,0,.00nan,0,0
29419,63650,125,83,27,1,26,.963,3600000,0
29420,4231,110,71,26,2,24,.923,3900000,0
29420,52560,119,74,35,2,33,.943,3900000,0
29420,63636,110,0,0,0,0,.00nan,0,0
29420,63656,119,0,0,0,0,.00nan,0,0
29421,1605,113,17,37,8,29,.784,3600000,0
29421,55636,125,51,25,3,22,.880,3600000,0
29421,56284,113,0,0,0,0,.00nan,0,0
29421,63650,125,0,0,0,0,.00nan,0,0
29422,55696,126,11,39,9,30,.769,3600000,0
29422,55905,124,70,16,1,15,.938,3600000,0
29422,56361,124,0,0,0,0,.00nan,0,0
29422,77899,126,0,0,0,0,.00nan,0,0
29423,55696,126,62,31,3,28,.903,3600000,0
29423,56600,123,0,0,0,0,.00nan,0,0
29423,58064,123,30,29,6,23,.793,3600000,0
29423,77899,126,0,0,0,0,.00nan,0,0
29424,55905,124,0,0,0,0,.00nan,0,0
29424,56341,122,90,47,3,44,.936,3898000,0
29424,56361,124,71,39,4,35,.897,3898000,0
29424,77796,122,0,0,0,0,.00nan,0,0
29425,52618,115,0,0,0,0,.00nan,0,0
29425,56479,112,0,0,0,0,.00nan,0,0
29425,70545,115,74,27,2,25,.926,3600000,0
29425,78025,112,72,36,3,33,.917,3600000,0
29426,56286,121,0,0,0,0,.00nan,0,0
29426,58137,127,13,32,8,24,.750,3190000,0
29426,61228,127,50,3,0,3,1000,410000,0
29426,62116,121,81,28,1,27,.964,3600000,0
29427,8450,120,58,15,1,14,.933,3546000,0
29427,55636,125,100,27,0,27,1000,3600000,0
29427,56368,120,0,0,0,0,.00nan,0,0
29427,63650,125,0,0,0,0,.00nan,0,0
29428,4231,110,59,22,2,20,.909,3600000,0
29428,41903,111,56,27,4,23,.852,3534000,0
29428,56333,111,0,0,0,0,.00nan,0,0
29428,63636,110,0,0,0,0,.00nan,0,0
29429,52560,119,33,33,6,27,.818,2748000,0
29429,56341,122,81,34,2,32,.941,3600000,0
29429,63656,119,34,5,2,3,.600,852000,0
29429,77796,122,0,0,0,0,.00nan,0,0
29430,45278,114,35,37,7,30,.811,2855000,0
29430,56340,118,78,25,1,24,.960,3600000,0
29430,56366,114,43,4,1,3,.750,745000,0
29430,56474,118,0,0,0,0,.00nan,0,0
29431,55660,109,54,23,4,19,.826,3600000,0
29431,58090,108,0,0,0,0,.00nan,0,0
29431,58153,109,0,0,0,0,.00nan,0,0
29431,63688,108,64,45,5,40,.889,3558000,0
29432,55905,124,72,26,2,24,.923,3600000,0
29432,56361,124,0,0,0,0,.00nan,0,0
29432,56600,123,0,0,0,0,.00nan,0,0
29432,58064,123,67,36,3,33,.917,3566000,0
29433,55696,126,47,17,3,14,.824,3550000,0
29433,56479,112,100,41,2,39,.951,3600000,0
29433,77899,126,0,0,0,0,.00nan,0,0
29433,78025,112,0,0,0,0,.00nan,0,0
29434,1605,113,37,39,6,33,.846,3570000,0
29434,56284,113,0,0,0,0,.00nan,0,0
29434,58115,117,60,38,5,33,.868,3600000,0
29434,77968,117,0,0,0,0,.00nan,0,0
29435,55636,125,62,20,2,18,.900,3592000,0
29435,56286,121,0,0,0,0,.00nan,0,0
29435,62116,121,94,36,1,35,.972,3600000,0
29435,63650,125,0,0,0,0,.00nan,0,0
29436,4231,110,0,0,0,0,.00nan,0,0
29436,8450,120,0,0,0,0,.00nan,0,0
29436,56368,120,74,44,3,41,.932,3900000,0
29436,63636,110,61,26,3,23,.885,3900000,0
29437,45278,114,72,24,2,22,.917,3600000,0
29437,55660,109,0,0,0,0,.00nan,0,0
29437,56366,114,0,0,0,0,.00nan,0,0
29437,58153,109,79,36,3,33,.917,3600000,0
29438,55913,116,50,24,4,20,.833,3600000,0
29438,58137,127,0,0,0,0,.00nan,0,0
29438,58555,116,0,0,0,0,.00nan,0,0
29438,61228,127,100,32,0,32,1000,3600000,0
29439,56341,122,0,0,0,0,.00nan,0,0
29439,56600,123,28,8,3,5,.625,442000,0
29439,58064,123,62,35,4,31,.886,3158000,0
29439,77796,122,63,26,3,23,.885,3600000,0
29440,55696,126,0,0,0,0,.00nan,0,0
29440,58115,117,0,0,0,0,.00nan,0,0
29440,77899,126,68,46,4,42,.913,3542000,0
29440,77968,117,85,35,2,33,.943,3600000,0
29441,41903,111,0,0,0,0,.00nan,0,0
29441,56333,111,28,34,7,27,.794,3600000,0
29441,56340,118,32,49,9,40,.816,3567000,0
29441,56474,118,0,0,0,0,.00nan,0,0
29442,52560,119,33,28,5,23,.821,3600000,0
29442,58137,127,0,0,0,0,.00nan,0,0
29442,61228,127,91,30,2,28,.933,3600000,0
29442,63656,119,0,0,0,0,.00nan,0,0
29443,45278,114,0,0,0,0,.00nan,0,0
29443,55905,124,0,0,0,0,.00nan,0,0
29443,56361,124,67,19,2,17,.895,3600000,0
29443,56366,114,26,34,7,27,.794,3600000,0
29444,8450,120,34,20,4,16,.800,3569000,0
29444,56368,120,0,0,0,0,.00nan,0,0
29444,58090,108,0,0,0,0,.00nan,0,0
29444,63688,108,69,24,2,22,.917,3600000,0
29445,1605,113,59,30,3,27,.900,3900000,0
29445,56284,113,0,0,0,0,.00nan,0,0
29445,56479,112,73,34,3,31,.912,3900000,0
29445,78025,112,0,0,0,0,.00nan,0,0
29446,55905,124,72,34,3,31,.912,3600000,0
29446,56361,124,0,0,0,0,.00nan,0,0
29446,58137,127,49,31,5,26,.839,3545000,0
29446,61228,127,0,0,0,0,.00nan,0,0
29447,56340,118,18,23,6,17,.739,2714000,0
29447,56341,122,60,29,3,26,.897,3600000,0
29447,56474,118,64,6,0,6,1000,886000,0
29447,77796,122,0,0,0,0,.00nan,0,0
29448,55913,116,75,29,2,27,.931,3600000,0
29448,56286,121,40,32,5,27,.844,3600000,0
29448,58555,116,0,0,0,0,.00nan,0,0
29448,62116,121,0,0,0,0,.00nan,0,0
29449,52618,115,19,7,4,3,.429,634000,0
29449,58090,108,0,0,0,0,.00nan,0,0
29449,63688,108,21,36,7,29,.806,3558000,0
29449,70545,115,95,29,1,28,.966,2966000,0
29450,4231,110,43,26,4,22,.846,3549000,0
29450,56479,112,0,0,0,0,.00nan,0,0
29450,63636,110,0,0,0,0,.00nan,0,0
29450,78025,112,57,26,3,23,.885,3600000,0
29451,55636,125,35,10,3,7,.700,425000,0
29451,56600,123,0,0,0,0,.00nan,0,0
29451,58064,123,79,31,2,29,.935,3600000,0
29451,63650,125,83,19,0,19,1000,3170000,0
29452,56286,121,0,0,0,0,.00nan,0,0
29452,56341,122,80,28,1,27,.964,3600000,0
29452,62116,121,57,28,3,25,.893,3592000,0
29452,77796,122,0,0,0,0,.00nan,0,0
29453,8450,120,80,26,1,25,.962,3600000,0
29453,55660,109,67,27,2,25,.926,3600000,0
29453,56368,120,0,0,0,0,.00nan,0,0
29453,58153,109,0,0,0,0,.00nan,0,0
29454,4231,110,60,6,0,6,1000,1178000,0
29454,56479,112,55,30,4,26,.867,3600000,0
29454,63636,110,24,23,6,17,.739,2373000,0
29454,78025,112,0,0,0,0,.00nan,0,0
29455,1605,113,73,37,4,33,.892,3833000,0
29455,52560,119,42,34,5,29,.853,3833000,0
29455,56284,113,0,0,0,0,.00nan,0,0
29455,63656,119,0,0,0,0,.00nan,0,0
29456,55636,125,40,28,5,23,.821,3600000,0
29456,56340,118,20,16,5,11,.688,2329000,0
29456,56474,118,54,18,2,16,.889,1271000,0
29456,63650,125,0,0,0,0,.00nan,0,0
29457,41903,111,50,1,0,1,1000,659000,0
29457,45278,114,93,32,1,31,.969,3600000,0
29457,56333,111,43,35,6,29,.829,2941000,0
29457,56366,114,0,0,0,0,.00nan,0,0
29458,55905,124,67,27,2,25,.926,3900000,0
29458,56361,124,0,0,0,0,.00nan,0,0
29458,58137,127,80,28,2,26,.929,3900000,0
29458,61228,127,0,0,0,0,.00nan,0,0
29459,55696,126,44,25,4,21,.840,3900000,0
29459,58090,108,66,41,4,37,.902,3900000,0
29459,63688,108,0,0,0,0,.00nan,0,0
29459,77899,126,0,0,0,0,.00nan,0,0
29460,45278,114,34,37,7,30,.811,3600000,0
29460,56366,114,0,0,0,0,.00nan,0,0
29460,58115,117,70,24,2,22,.917,3600000,0
29460,77968,117,0,0,0,0,.00nan,0,0
29461,56286,121,0,0,0,0,.00nan,0,0
29461,56341,122,0,0,0,0,.00nan,0,0
29461,62116,121,52,24,3,21,.875,3588000,0
29461,77796,122,77,22,1,21,.955,3600000,0
29462,56600,123,27,5,3,2,.400,376000,0
29462,58064,123,81,31,1,30,.968,3224000,0
29462,58137,127,0,0,0,0,.00nan,0,0
29462,61228,127,13,27,7,20,.741,3600000,0
29463,8450,120,0,0,0,0,.00nan,0,0
29463,52560,119,0,0,0,0,.00nan,0,0
29463,56368,120,66,34,3,31,.912,3563000,0
29463,63656,119,78,31,2,29,.935,3600000,0
29464,41903,111,96,30,1,29,.967,3600000,0
29464,56333,111,0,0,0,0,.00nan,0,0
29464,56479,112,0,0,0,0,.00nan,0,0
29464,78025,112,55,25,3,22,.880,3517000,0
29465,55636,125,0,0,0,0,.00nan,0,0
29465,56340,118,72,33,3,30,.909,3522000,0
29465,56474,118,0,0,0,0,.00nan,0,0
29465,63650,125,72,24,1,23,.958,3600000,0
29466,55905,124,0,0,0,0,.00nan,0,0
29466,55913,116,0,0,0,0,.00nan,0,0
29466,56361,124,57,33,4,29,.879,3600000,0
29466,58555,116,84,32,2,30,.938,3600000,0
29467,52618,115,94,23,0,23,1000,3600000,0
29467,58115,117,55,47,6,41,.872,3600000,0
29467,70545,115,0,0,0,0,.00nan,0,0
29467,77968,117,0,0,0,0,.00nan,0,0
29468,4231,110,68,41,5,36,.878,3566000,0
29468,55660,109,53,28,4,24,.857,3600000,0
29468,58153,109,0,0,0,0,.00nan,0,0
29468,63636,110,0,0,0,0,.00nan,0,0
29469,1605,113,44,32,4,28,.875,3575000,0
29469,56284,113,0,0,0,0,.00nan,0,0
29469,58090,108,0,0,0,0,.00nan,0,0
29469,63688,108,79,34,2,32,.941,3600000,0
29470,55913,116,90,39,3,36,.923,3600000,0
29470,56600,123,12,34,8,26,.765,2631000,0
29470,58064,123,58,10,1,9,.900,969000,0
29470,58555,116,0,0,0,0,.00nan,0,0
30061,8450,120,50,22,3,19,.864,3600000,0
30061,56368,120,0,0,0,0,.00nan,0,0
30061,58090,108,0,0,0,0,.00nan,0,0
30061,63688,108,60,36,4,32,.889,3553000,0
30063,55636,125,68,19,1,18,.947,3550000,0
30063,55696,126,98,20,0,20,1000,3600000,0
30063,56191,126,0,0,0,0,.00nan,0,0
30063,63650,125,0,0,0,0,.00nan,0,0
30065,55660,109,0,0,0,0,.00nan,0,0
30065,58137,127,74,34,2,32,.941,3600000,0
30065,58153,109,21,33,7,26,.788,3600000,0
30065,61228,127,0,0,0,0,.00nan,0,0
30067,1605,113,52,33,5,28,.848,3600000,0
30067,56284,113,0,0,0,0,.00nan,0,0
30067,56341,122,97,35,1,34,.971,3600000,0
30067,77796,122,0,0,0,0,.00nan,0,0
30069,56340,118,72,38,4,34,.895,3600000,0
30069,56474,118,0,0,0,0,.00nan,0,0
30069,58115,117,100,23,0,23,1000,3600000,0
30069,77968,117,0,0,0,0,.00nan,0,0
30071,52560,119,72,33,3,30,.909,3600000,0
30071,62116,121,70,43,4,39,.907,3600000,0
30071,63656,119,0,0,0,0,.00nan,0,0
30071,79931,121,0,0,0,0,.00nan,0,0
30073,4231,110,90,34,2,32,.941,3600000,0
30073,55905,124,0,0,0,0,.00nan,0,0
30073,56361,124,85,28,1,27,.964,3600000,0
30073,63636,110,0,0,0,0,.00nan,0,0
30075,52618,115,63,23,2,21,.913,3575000,0
30075,56479,112,0,0,0,0,.00nan,0,0
30075,70545,115,0,0,0,0,.00nan,0,0
30075,78025,112,76,24,1,23,.958,3600000,0
30077,45278,114,100,24,0,24,1000,3600000,0
30077,55913,116,0,0,0,0,.00nan,0,0
30077,56366,114,0,0,0,0,.00nan,0,0
30077,58555,116,60,23,3,20,.870,3600000,0
30079,41903,111,0,0,0,0,.00nan,0,0
30079,56333,111,95,38,2,36,.947,3600000,0
30079,56600,123,41,19,4,15,.789,3545000,0
30079,58064,123,0,0,0,0,.00nan,0,0
30081,45278,114,96,33,1,32,.970,3600000,0
30081,56366,114,0,0,0,0,.00nan,0,0
30081,58137,127,83,31,2,29,.935,3599000,0
30081,61228,127,0,0,0,0,.00nan,0,0
30083,55913,116,0,0,0,0,.00nan,0,0
30083,56600,123,0,0,0,0,.00nan,0,0
30083,58064,123,48,33,5,28,.848,3600000,0
30083,58555,116,88,38,2,36,.947,3600000,0
30085,1605,113,38,28,5,23,.821,3517000,0
30085,56284,113,0,0,0,0,.00nan,0,0
30085,56340,118,72,39,3,36,.923,3600000,0
30085,56474,118,0,0,0,0,.00nan,0,0
30087,4231,110,47,36,6,30,.833,3600000,0
30087,58090,108,0,0,0,0,.00nan,0,0
30087,63636,110,0,0,0,0,.00nan,0,0
30087,63688,108,50,13,2,11,.846,3600000,0
30089,56341,122,72,22,2,20,.909,3600000,0
30089,58115,117,50,36,5,31,.861,3600000,0
30089,77796,122,0,0,0,0,.00nan,0,0
30089,77968,117,0,0,0,0,.00nan,0,0
30091,55905,124,65,39,4,35,.897,3571000,0
30091,56361,124,0,0,0,0,.00nan,0,0
30091,62116,121,75,35,3,32,.914,3600000,0
30091,79931,121,0,0,0,0,.00nan,0,0
30093,8450,120,61,31,3,28,.903,3119000,0
30093,52560,119,49,28,4,24,.857,3600000,0
30093,56368,120,17,7,4,3,.429,481000,0
30093,63656,119,0,0,0,0,.00nan,0,0
30095,41903,111,67,32,4,28,.875,3600000,0
30095,56333,111,0,0,0,0,.00nan,0,0
30095,56479,112,44,14,3,11,.786,3600000,0
30095,78025,112,0,0,0,0,.00nan,0,0
30097,55636,125,46,24,4,20,.833,3600000,0
30097,55660,109,48,31,5,26,.839,3600000,0
30097,58153,109,0,0,0,0,.00nan,0,0
30097,63650,125,0,0,0,0,.00nan,0,0
30099,52618,115,0,0,0,0,.00nan,0,0
30099,55696,126,52,22,3,19,.864,3526000,0
30099,56191,126,0,0,0,0,.00nan,0,0
30099,70545,115,100,34,1,33,.971,3600000,0
30101,55905,124,0,0,0,0,.00nan,0,0
30101,56361,124,75,19,1,18,.947,3600000,0
30101,56479,112,0,0,0,0,.00nan,0,0
30101,78025,112,68,27,2,25,.926,3600000,0
30103,45278,114,0,0,0,0,.00nan,0,0
30103,56366,114,61,35,4,31,.886,3547000,0
30103,58090,108,61,25,2,23,.920,3600000,0
30103,63688,108,0,0,0,0,.00nan,0,0
30105,4231,110,49,2,0,2,1000,296000,0
30105,55660,109,0,0,0,0,.00nan,0,0
30105,58153,109,58,21,3,18,.857,3600000,0
30105,63636,110,14,20,6,14,.700,3304000,0
30107,41903,111,0,0,0,0,.00nan,0,0
30107,55636,125,0,0,0,0,.00nan,0,0
30107,56333,111,81,20,1,19,.950,3600000,0
30107,63650,125,77,36,5,31,.861,3600000,0
30109,55913,116,35,20,4,16,.800,1176000,0
30109,58137,127,0,0,0,0,.00nan,0,0
30109,58555,116,57,21,2,19,.905,2424000,0
30109,61228,127,100,26,0,26,1000,3600000,0
30111,8450,120,0,0,0,0,.00nan,0,0
30111,52560,119,0,0,0,0,.00nan,0,0
30111,56368,120,47,34,5,29,.853,3600000,0
30111,63656,119,100,26,0,26,1000,3600000,0
30113,55696,126,0,0,0,0,.00nan,0,0
30113,56191,126,51,22,3,19,.864,3600000,0
30113,56340,118,63,14,1,13,.929,1541000,0
30113,56474,118,31,23,5,18,.783,2059000,0
30115,52618,115,83,38,3,35,.921,3600000,0
30115,56341,122,0,0,0,0,.00nan,0,0
30115,70545,115,0,0,0,0,.00nan,0,0
30115,77796,122,43,32,5,27,.844,3512000,0
30117,1605,113,0,0,0,0,.00nan,0,0
30117,56284,113,77,28,1,27,.964,3600000,0
30117,62116,121,0,0,0,0,.00nan,0,0
30117,79931,121,64,38,4,34,.895,3600000,0
30119,56600,123,55,36,4,32,.889,3704000,0
30119,58064,123,0,0,0,0,.00nan,0,0
30119,58115,117,77,36,3,33,.917,3704000,0
30119,77968,117,0,0,0,0,.00nan,0,0
30121,41903,111,77,27,1,26,.963,3600000,0
30121,56333,111,0,0,0,0,.00nan,0,0
30121,58090,108,0,0,0,0,.00nan,0,0
30121,63688,108,58,33,5,28,.848,3600000,0
30123,1605,113,60,41,5,36,.878,3900000,0
30123,55913,116,23,10,4,6,.600,826000,0
30123,56284,113,0,0,0,0,.00nan,0,0
30123,58555,116,74,21,1,20,.952,3074000,0
30125,52560,119,0,0,0,0,.00nan,0,0
30125,63656,119,37,27,5,22,.815,3600000,0
30125,70545,115,0,0,0,0,.00nan,0,0
30125,77782,115,39,37,7,30,.811,3565000,0
30127,56366,114,0,0,0,0,.00nan,0,0
30127,56479,112,0,0,0,0,.00nan,0,0
30127,63716,114,48,29,4,25,.862,3561000,0
30127,78025,112,74,36,3,33,.917,3600000,0
30129,4231,110,75,27,2,25,.926,3600000,0
30129,56600,123,0,0,0,0,.00nan,0,0
30129,58064,123,50,23,3,20,.870,3584000,0
30129,63636,110,0,0,0,0,.00nan,0,0
30131,55660,109,74,31,3,28,.903,3570000,0
30131,55905,124,70,28,2,26,.929,3600000,0
30131,56361,124,0,0,0,0,.00nan,0,0
30131,58153,109,0,0,0,0,.00nan,0,0
30133,56841,127,0,0,0,0,.00nan,0,0
30133,58137,127,69,19,1,18,.947,3600000,0
30133,63714,122,0,0,0,0,.00nan,0,0
30133,77796,122,80,35,3,32,.914,3600000,0
30135,58115,117,92,31,1,30,.968,3600000,0
30135,62116,121,24,26,6,20,.769,2574000,0
30135,77968,117,0,0,0,0,.00nan,0,0
30135,79931,121,49,14,2,12,.857,1026000,0
30137,8450,120,68,30,2,28,.933,3562000,0
30137,55696,126,71,20,1,19,.950,3600000,0
30137,56191,126,0,0,0,0,.00nan,0,0
30137,56368,120,0,0,0,0,.00nan,0,0
30139,55636,125,20,24,6,18,.750,3590000,0
30139,56340,118,51,43,5,38,.884,3600000,0
30139,56474,118,0,0,0,0,.00nan,0,0
30139,63650,125,0,0,0,0,.00nan,0,0
30141,1605,113,0,0,0,0,.00nan,0,0
30141,56284,113,46,29,5,24,.828,3600000,0
30141,56479,112,65,18,1,17,.944,3600000,0
30141,78025,112,0,0,0,0,.00nan,0,0
30143,55636,125,0,0,0,0,.00nan,0,0
30143,56600,123,63,26,2,24,.923,3900000,0
30143,58064,123,0,0,0,0,.00nan,0,0
30143,63650,125,76,24,2,22,.917,3900000,0
30145,41903,111,0,0,0,0,.00nan,0,0
30145,56333,111,68,32,3,29,.906,3676000,0
30145,70545,115,74,31,4,27,.871,3676000,0
30145,77782,115,0,0,0,0,.00nan,0,0
30147,55905,124,0,0,0,0,.00nan,0,0
30147,56340,118,46,17,3,14,.824,2680000,0
30147,56361,124,33,17,4,13,.765,3600000,0
30147,56474,118,16,6,4,2,.333,920000,0
30149,56366,114,53,24,4,20,.833,3600000,0
30149,62116,121,27,24,6,18,.750,2627000,0
30149,63716,114,0,0,0,0,.00nan,0,0
30149,79931,121,47,5,1,4,.800,973000,0
30151,8450,120,51,2,0,2,1000,1076000,0
30151,56368,120,9,33,8,25,.758,2524000,0
30151,63714,122,52,25,4,21,.840,3600000,0
30151,77796,122,0,0,0,0,.00nan,0,0
30153,4231,110,0,0,0,0,.00nan,0,0
30153,56841,127,90,44,3,41,.932,3856000,0
30153,58137,127,0,0,0,0,.00nan,0,0
30153,63636,110,78,26,2,24,.923,3856000,0
30155,52560,119,29,15,4,11,.733,1112000,0
30155,55913,116,66,32,3,29,.906,3600000,0
30155,58555,116,0,0,0,0,.00nan,0,0
30155,63656,119,63,27,3,24,.889,2488000,0
30157,55660,109,0,0,0,0,.00nan,0,0
30157,58115,117,87,27,1,26,.963,3600000,0
30157,58153,109,77,29,2,27,.931,3544000,0
30157,77968,117,0,0,0,0,.00nan,0,0
30159,55696,126,41,20,4,16,.800,3580000,0
30159,56191,126,0,0,0,0,.00nan,0,0
30159,58090,108,67,36,3,33,.917,3600000,0
30159,63688,108,0,0,0,0,.00nan,0,0
30161,4231,110,56,36,5,31,.861,3600000,0
30161,55636,125,69,22,2,20,.909,3600000,0
30161,63636,110,0,0,0,0,.00nan,0,0
30161,63650,125,0,0,0,0,.00nan,0,0
30163,56841,127,0,0,0,0,.00nan,0,0
30163,58137,127,78,25,2,23,.920,3600000,0
30163,62116,121,41,39,6,33,.846,3600000,0
30163,79931,121,0,0,0,0,.00nan,0,0
30165,8450,120,100,23,0,23,1000,3600000,0
30165,56340,118,59,50,7,43,.860,3600000,0
30165,56368,120,0,0,0,0,.00nan,0,0
30165,56474,118,0,0,0,0,.00nan,0,0
30167,55905,124,88,34,2,32,.941,3600000,0
30167,56361,124,0,0,0,0,.00nan,0,0
30167,56600,123,0,0,0,0,.00nan,0,0
30167,58064,123,54,32,4,28,.875,3600000,0
30169,52560,119,56,24,3,21,.875,3581000,0
30169,56366,114,0,0,0,0,.00nan,0,0
30169,63656,119,0,0,0,0,.00nan,0,0
30169,63716,114,75,32,2,30,.938,3600000,0
30171,55913,116,0,0,0,0,.00nan,0,0
30171,58090,108,0,0,0,0,.00nan,0,0
30171,58555,116,61,16,2,14,.875,3900000,0
30171,63688,108,98,49,2,47,.959,3900000,0
30173,41903,111,14,22,6,16,.727,2679000,0
30173,56333,111,65,16,1,15,.938,1221000,0
30173,56479,112,0,0,0,0,.00nan,0,0
30173,78025,112,20,36,7,29,.806,3900000,0
30175,58115,117,0,0,0,0,.00nan,0,0
30175,63714,122,0,0,0,0,.00nan,0,0
30175,77796,122,42,36,5,31,.861,3600000,0
30175,77968,117,88,38,2,36,.947,3600000,0
30177,55660,109,33,34,6,28,.824,2891000,0
30177,58153,109,15,6,4,2,.333,709000,0
30177,70545,115,39,23,5,18,.783,3600000,0
30177,77782,115,0,0,0,0,.00nan,0,0
30179,1605,113,37,26,4,22,.846,3547000,0
30179,55696,126,58,19,2,17,.895,3600000,0
30179,56191,126,0,0,0,0,.00nan,0,0
30179,56284,113,0,0,0,0,.00nan,0,0
30181,55696,126,0,0,0,0,.00nan,0,0
30181,56191,126,74,37,3,34,.919,3600000,0
30181,62116,121,51,3,0,3,1000,279000,0
30181,79931,121,32,27,6,21,.778,3321000,0
30183,4231,110,0,0,0,0,.00nan,0,0
30183,8450,120,0,0,0,0,.00nan,0,0
30183,56368,120,63,28,3,25,.893,3600000,0
30183,63636,110,38,31,6,25,.806,3600000,0
30185,41903,111,0,0,0,0,.00nan,0,0
30185,56333,111,52,29,4,25,.862,3558000,0
30185,56841,127,86,40,2,38,.950,3600000,0
30185,58137,127,0,0,0,0,.00nan,0,0
30187,56479,112,29,31,7,24,.774,3796000,0
30187,70545,115,0,0,0,0,.00nan,0,0
30187,77782,115,44,31,6,25,.806,3796000,0
30187,78025,112,0,0,0,0,.00nan,0,0
30189,55905,124,67,15,1,14,.933,1525000,0
30189,55913,116,62,28,3,25,.893,3291000,0
30189,56361,124,42,23,4,19,.826,2375000,0
30189,58555,116,31,4,2,2,.500,609000,0
30191,56600,123,76,30,2,28,.933,3900000,0
30191,58064,123,0,0,0,0,.00nan,0,0
30191,58090,108,58,20,2,18,.900,3900000,0
30191,63688,108,0,0,0,0,.00nan,0,0
30193,52560,119,43,30,5,25,.833,3766000,0
30193,56366,114,58,31,4,27,.871,3766000,0
30193,63656,119,0,0,0,0,.00nan,0,0
30193,63716,114,0,0,0,0,.00nan,0,0
30195,56340,118,0,0,0,0,.00nan,0,0
30195,56474,118,53,38,5,33,.868,3615000,0
30195,63714,122,39,22,4,18,.818,3615000,0
30195,77796,122,0,0,0,0,.00nan,0,0
30197,55660,109,0,0,0,0,.00nan,0,0
30197,58115,117,61,28,3,25,.893,3580000,0
30197,58153,109,94,34,1,33,.971,3600000,0
30197,77968,117,0,0,0,0,.00nan,0,0
30199,1605,113,0,0,0,0,.00nan,0,0
30199,55636,125,0,0,0,0,.00nan,0,0
30199,56284,113,58,28,3,25,.893,3600000,0
30199,63650,125,44,24,4,20,.833,3582000,0
30200,41787,97,48,21,3,18,.857,3600000,0
30200,42515,97,0,0,0,0,.00nan,0,0
30200,73712,95,55,38,5,33,.868,3514000,0
30200,77102,95,0,0,0,0,.00nan,0,0
30201,36229,86,0,0,0,0,.00nan,0,0
30201,42528,94,0,0,0,0,.00nan,0,0
30201,42635,94,87,39,2,37,.949,3584000,0
30201,69563,86,84,21,1,20,.952,3600000,0
30202,42456,91,48,27,4,23,.852,3600000,0
30202,42624,96,61,25,3,22,.880,3600000,0
30202,68826,91,0,0,0,0,.00nan,0,0
30202,81547,96,0,0,0,0,.00nan,0,0
30203,8527,88,62,27,3,24,.889,3600000,0
30203,42630,90,86,17,0,17,1000,3600000,0
30203,56980,90,0,0,0,0,.00nan,0,0
30203,75608,88,0,0,0,0,.00nan,0,0
30204,42523,99,92,41,2,39,.951,3600000,0
30204,56036,106,49,33,4,29,.879,3600000,0
30204,62596,106,0,0,0,0,.00nan,0,0
30204,73869,99,0,0,0,0,.00nan,0,0
30205,35824,101,91,45,2,43,.956,3900000,0
30205,35984,101,0,0,0,0,.00nan,0,0
30205,56535,103,53,19,2,17,.895,3900000,0
30205,56591,103,0,0,0,0,.00nan,0,0
30206,6139,102,99,34,1,33,.971,3900000,0
30206,6982,104,79,24,1,23,.958,3900000,0
30206,35987,102,0,0,0,0,.00nan,0,0
30206,42458,104,0,0,0,0,.00nan,0,0
30207,36074,105,73,26,2,24,.923,3600000,0
30207,42565,100,89,16,0,16,1000,3600000,0
30207,68929,105,0,0,0,0,.00nan,0,0
30207,80138,100,0,0,0,0,.00nan,0,0
30208,42439,89,0,0,0,0,.00nan,0,0
30208,42474,89,79,32,2,30,.938,3600000,0
30208,55688,87,73,51,5,46,.902,3600000,0
30208,68872,87,0,0,0,0,.00nan,0,0
30209,42456,91,0,0,0,0,.00nan,0,0
30209,42624,96,0,0,0,0,.00nan,0,0
30209,68826,91,92,30,1,29,.967,3600000,0
30209,81547,96,67,33,3,30,.909,3565000,0
30210,42473,93,96,40,1,39,.975,3600000,0
30210,42486,92,36,21,4,17,.810,3600000,0
30210,56580,93,0,0,0,0,.00nan,0,0
30210,71047,92,0,0,0,0,.00nan,0,0
30211,8527,88,0,0,0,0,.00nan,0,0
30211,42630,90,85,33,2,31,.939,3516000,0
30211,56980,90,0,0,0,0,.00nan,0,0
30211,75608,88,100,33,0,33,1000,3600000,0
30212,36229,86,28,23,6,17,.739,2803000,0
30212,42528,94,60,43,6,37,.860,3600000,0
30212,42635,94,0,0,0,0,.00nan,0,0
30212,69563,86,48,6,1,5,.833,784000,0
30213,41787,97,0,0,0,0,.00nan,0,0
30213,42515,97,80,22,1,21,.955,3600000,0
30213,73712,95,0,0,0,0,.00nan,0,0
30213,77102,95,73,36,3,33,.917,3600000,0
30214,35824,101,0,0,0,0,.00nan,0,0
30214,35984,101,83,46,3,43,.935,3600000,0
30214,56535,103,0,0,0,0,.00nan,0,0
30214,56591,103,98,26,0,26,1000,3600000,0
30215,6139,102,0,0,0,0,.00nan,0,0
30215,6982,104,0,0,0,0,.00nan,0,0
30215,35987,102,59,29,4,25,.862,3579000,0
30215,42458,104,67,33,3,30,.909,3600000,0
30216,30033,107,0,0,0,0,.00nan,0,0
30216,36230,107,50,33,5,28,.848,3600000,0
30216,42565,100,0,0,0,0,.00nan,0,0
30216,80138,100,70,21,2,19,.905,3600000,0
30217,6979,98,43,27,4,23,.852,3600000,0
30217,56036,106,0,0,0,0,.00nan,0,0
30217,62596,106,82,38,3,35,.921,3600000,0
30217,80050,98,0,0,0,0,.00nan,0,0
30218,42439,89,0,0,0,0,.00nan,0,0
30218,42474,89,70,18,1,17,.944,3600000,0
30218,42630,90,97,38,2,36,.947,3555000,0
30218,56980,90,0,0,0,0,.00nan,0,0
30219,42528,94,0,0,0,0,.00nan,0,0
30219,42624,96,72,26,2,24,.923,3600000,0
30219,42635,94,92,32,1,31,.969,3600000,0
30219,81547,96,0,0,0,0,.00nan,0,0
30220,42473,93,57,30,4,26,.867,3762000,0
30220,42486,92,0,0,0,0,.00nan,0,0
30220,56580,93,0,0,0,0,.00nan,0,0
30220,71047,92,57,27,3,24,.889,3762000,0
30221,36229,86,0,0,0,0,.00nan,0,0
30221,42630,90,99,52,2,50,.962,3600000,0
30221,56980,90,0,0,0,0,.00nan,0,0
30221,69563,86,64,26,3,23,.885,3542000,0
30222,41787,97,34,30,6,24,.800,2447000,0
30222,42439,89,0,0,0,0,.00nan,0,0
30222,42474,89,31,27,6,21,.778,3600000,0
30222,42515,97,35,6,2,4,.667,1153000,0
30223,6979,98,85,43,3,40,.930,3900000,0
30223,35824,101,0,0,0,0,.00nan,0,0
30223,35984,101,69,38,3,35,.921,3900000,0
30223,80050,98,0,0,0,0,.00nan,0,0
30224,30033,107,46,32,5,27,.844,3600000,0
30224,36230,107,0,0,0,0,.00nan,0,0
30224,56535,103,0,0,0,0,.00nan,0,0
30224,56591,103,70,26,2,24,.923,3600000,0
30225,6139,102,0,0,0,0,.00nan,0,0
30225,35987,102,66,28,2,26,.929,3552000,0
30225,42565,100,75,24,1,23,.958,3600000,0
30225,80138,100,0,0,0,0,.00nan,0,0
30226,36229,86,97,25,0,25,1000,3600000,0
30226,55688,87,93,46,2,44,.957,3563000,0
30226,68872,87,0,0,0,0,.00nan,0,0
30226,69563,86,0,0,0,0,.00nan,0,0
30227,42624,96,79,37,3,34,.919,3600000,0
30227,42630,90,91,14,0,14,1000,3600000,0
30227,56980,90,0,0,0,0,.00nan,0,0
30227,81547,96,0,0,0,0,.00nan,0,0
30228,6979,98,0,0,0,0,.00nan,0,0
30228,35824,101,54,29,4,25,.862,3600000,0
30228,35984,101,0,0,0,0,.00nan,0,0
30228,80050,98,64,32,3,29,.906,3600000,0
30229,42456,91,100,36,2,34,.944,3900000,0
30229,42528,94,0,0,0,0,.00nan,0,0
30229,42635,94,71,30,2,28,.933,3900000,0
30229,68826,91,0,0,0,0,.00nan,0,0
30230,8527,88,0,0,0,0,.00nan,0,0
30230,41787,97,0,0,0,0,.00nan,0,0
30230,42515,97,52,32,4,28,.875,3600000,0
30230,75608,88,74,21,1,20,.952,3600000,0
30231,56036,106,74,26,1,25,.962,3600000,0
30231,56535,103,44,30,4,26,.867,3600000,0
30231,56591,103,0,0,0,0,.00nan,0,0
30231,62596,106,0,0,0,0,.00nan,0,0
30232,42439,89,63,25,2,23,.920,3600000,0
30232,42473,93,0,0,0,0,.00nan,0,0
30232,42474,89,0,0,0,0,.00nan,0,0
30232,56580,93,45,30,5,25,.833,3600000,0
30233,36074,105,50,26,4,22,.846,3588000,0
30233,42565,100,0,0,0,0,.00nan,0,0
30233,68929,105,0,0,0,0,.00nan,0,0
30233,80138,100,82,29,2,27,.931,3600000,0
30234,6982,104,69,20,1,19,.950,3600000,0
30234,42458,104,0,0,0,0,.00nan,0,0
30234,42523,99,80,33,2,31,.939,3551000,0
30234,73869,99,0,0,0,0,.00nan,0,0
30235,42528,94,57,30,3,27,.900,3600000,0
30235,42635,94,0,0,0,0,.00nan,0,0
30235,73712,95,0,0,0,0,.00nan,0,0
30235,74366,95,59,21,2,19,.905,3600000,0
30236,6139,102,36,20,4,16,.800,3549000,0
30236,30033,107,0,0,0,0,.00nan,0,0
30236,35987,102,0,0,0,0,.00nan,0,0
30236,36230,107,50,21,3,18,.857,3600000,0
30237,8527,88,57,32,4,28,.875,3633000,0
30237,42486,92,0,0,0,0,.00nan,0,0
30237,71047,92,48,32,5,27,.844,3633000,0
30237,75608,88,0,0,0,0,.00nan,0,0
30238,42528,94,34,36,6,30,.833,3102000,0
30238,42635,94,53,5,0,5,1000,498000,0
30238,55688,87,55,20,3,17,.850,3600000,0
30238,68872,87,0,0,0,0,.00nan,0,0
30239,42486,92,68,44,5,39,.886,3600000,0
30239,42630,90,72,17,1,16,.941,3600000,0
30239,56434,90,0,0,0,0,.00nan,0,0
30239,71047,92,0,0,0,0,.00nan,0,0
30240,8527,88,0,0,0,0,.00nan,0,0
30240,36229,86,52,28,4,24,.857,3546000,0
30240,69563,86,0,0,0,0,.00nan,0,0
30240,75608,88,54,26,3,23,.885,3600000,0
30241,6139,102,72,33,4,29,.879,3600000,0
30241,6979,98,35,21,5,16,.762,3550000,0
30241,35987,102,0,0,0,0,.00nan,0,0
30241,80050,98,0,0,0,0,.00nan,0,0
30242,8527,88,76,32,2,30,.938,3600000,0
30242,55688,87,55,27,3,24,.889,3555000,0
30242,68872,87,0,0,0,0,.00nan,0,0
30242,75608,88,0,0,0,0,.00nan,0,0
30243,42456,91,61,16,1,15,.938,3600000,0
30243,42486,92,0,0,0,0,.00nan,0,0
30243,68826,91,0,0,0,0,.00nan,0,0
30243,71047,92,56,31,3,28,.903,3580000,0
30244,41787,97,0,0,0,0,.00nan,0,0
30244,42515,97,33,17,4,13,.765,3608000,0
30244,42630,90,69,28,3,25,.893,3608000,0
30244,56434,90,0,0,0,0,.00nan,0,0
30245,42439,89,0,0,0,0,.00nan,0,0
30245,42474,89,51,30,5,25,.833,3600000,0
30245,42528,94,46,7,1,6,.857,467000,0
30245,42635,94,44,34,6,28,.824,3098000,0
30246,6139,102,33,32,6,26,.813,3186000,0
30246,35987,102,51,2,0,2,1000,414000,0
30246,42523,99,73,22,1,21,.955,3600000,0
30246,73869,99,0,0,0,0,.00nan,0,0
30247,6982,104,85,33,2,31,.939,3574000,0
30247,42458,104,0,0,0,0,.00nan,0,0
30247,42624,96,74,26,1,25,.962,3600000,0
30247,81547,96,0,0,0,0,.00nan,0,0
30248,30033,107,63,27,3,24,.889,3600000,0
30248,36230,107,0,0,0,0,.00nan,0,0
30248,42473,93,25,29,6,23,.793,3114000,0
30248,56580,93,47,6,1,5,.833,486000,0
30249,6979,98,54,30,4,26,.867,3900000,0
30249,36074,105,72,38,4,34,.895,3900000,0
30249,56518,105,0,0,0,0,.00nan,0,0
30249,80050,98,0,0,0,0,.00nan,0,0
30250,35824,101,0,0,0,0,.00nan,0,0
30250,35984,101,44,33,5,28,.848,3600000,0
30250,42565,100,28,21,5,16,.762,2319000,0
30250,80138,100,39,8,2,6,.750,1251000,0
30251,42456,91,86,21,1,20,.952,3900000,0
30251,68826,91,0,0,0,0,.00nan,0,0
30251,73712,95,0,0,0,0,.00nan,0,0
30251,74366,95,98,57,1,56,.982,3900000,0
30252,42473,93,0,0,0,0,.00nan,0,0
30252,56036,106,0,0,0,0,.00nan,0,0
30252,56580,93,75,27,1,26,.963,3600000,0
30252,62596,106,71,31,3,28,.903,3551000,0
30253,42486,92,88,39,2,37,.949,3600000,0
30253,42630,90,100,31,0,31,1000,3600000,0
30253,56434,90,0,0,0,0,.00nan,0,0
30253,71047,92,0,0,0,0,.00nan,0,0
30254,41787,97,44,29,5,24,.828,3600000,0
30254,42515,97,0,0,0,0,.00nan,0,0
30254,42528,94,75,28,1,27,.964,3600000,0
30254,42635,94,0,0,0,0,.00nan,0,0
30255,36229,86,0,0,0,0,.00nan,0,0
30255,42439,89,36,33,6,27,.818,3600000,0
30255,42474,89,0,0,0,0,.00nan,0,0
30255,69563,86,79,27,1,26,.963,3600000,0
30256,42624,96,0,0,0,0,.00nan,0,0
30256,56535,103,58,37,4,33,.892,3600000,0
30256,56591,103,0,0,0,0,.00nan,0,0
30256,81547,96,90,21,0,21,1000,3600000,0
30257,30033,107,0,0,0,0,.00nan,0,0
30257,35824,101,49,34,6,28,.824,3600000,0
30257,35984,101,0,0,0,0,.00nan,0,0
30257,36230,107,69,17,1,16,.941,3600000,0
30258,36074,105,0,0,0,0,.00nan,0,0
30258,42565,100,60,24,3,21,.875,3600000,0
30258,56518,105,38,34,6,28,.824,3600000,0
30258,80138,100,0,0,0,0,.00nan,0,0
30259,6139,102,0,0,0,0,.00nan,0,0
30259,35987,102,64,27,3,24,.889,3645000,0
30259,42523,99,0,0,0,0,.00nan,0,0
30259,73869,99,77,34,2,32,.941,3645000,0
30260,8527,88,61,39,4,35,.897,3600000,0
30260,36229,86,78,25,1,24,.960,3600000,0
30260,69563,86,0,0,0,0,.00nan,0,0
30260,75608,88,0,0,0,0,.00nan,0,0
30261,6982,104,60,27,3,24,.889,3600000,0
30261,42458,104,0,0,0,0,.00nan,0,0
30261,56036,106,59,31,4,27,.871,3553000,0
30261,62596,106,0,0,0,0,.00nan,0,0
30262,55688,87,0,0,0,0,.00nan,0,0
30262,68872,87,73,22,1,21,.955,3600000,0
30262,73712,95,0,0,0,0,.00nan,0,0
30262,74366,95,85,35,2,33,.943,3559000,0
30263,42624,96,0,0,0,0,.00nan,0,0
30263,56036,106,0,0,0,0,.00nan,0,0
30263,62596,106,86,28,1,27,.964,3900000,0
30263,81547,96,92,33,1,32,.970,3900000,0
30264,6139,102,66,39,4,35,.897,3567000,0
30264,6979,98,62,27,3,24,.889,3600000,0
30264,35987,102,0,0,0,0,.00nan,0,0
30264,80050,98,0,0,0,0,.00nan,0,0
30265,36074,105,33,32,6,26,.813,3600000,0
30265,42473,93,90,39,2,37,.949,3600000,0
30265,56518,105,0,0,0,0,.00nan,0,0
30265,56580,93,0,0,0,0,.00nan,0,0
30266,42528,94,0,0,0,0,.00nan,0,0
30266,42630,90,54,22,3,19,.864,3600000,0
30266,42635,94,60,35,4,31,.886,3564000,0
30266,56434,90,0,0,0,0,.00nan,0,0
30267,42439,89,58,17,1,16,.941,3600000,0
30267,42474,89,0,0,0,0,.00nan,0,0
30267,42486,92,0,0,0,0,.00nan,0,0
30267,71047,92,73,32,2,30,.938,3558000,0
30268,35824,101,0,0,0,0,.00nan,0,0
30268,35984,101,100,30,0,30,1000,3600000,0
30268,55688,87,48,23,3,20,.870,3600000,0
30268,68872,87,0,0,0,0,.00nan,0,0
30269,30033,107,51,27,4,23,.852,3600000,0
30269,36230,107,0,0,0,0,.00nan,0,0
30269,42624,96,89,29,1,28,.966,3600000,0
30269,81547,96,0,0,0,0,.00nan,0,0
30270,6139,102,0,0,0,0,.00nan,0,0
30270,6979,98,0,0,0,0,.00nan,0,0
30270,35987,102,38,22,4,18,.818,3600000,0
30270,80050,98,89,15,0,15,1000,3600000,0
30271,42473,93,0,0,0,0,.00nan,0,0
30271,56535,103,0,0,0,0,.00nan,0,0
30271,56580,93,82,27,1,26,.963,3600000,0
30271,56591,103,68,26,2,24,.923,3596000,0
30272,36229,86,0,0,0,0,.00nan,0,0
30272,42456,91,64,36,4,32,.889,3600000,0
30272,68826,91,0,0,0,0,.00nan,0,0
30272,69563,86,96,29,0,29,1000,3600000,0
30273,41787,97,0,0,0,0,.00nan,0,0
30273,42515,97,82,32,2,30,.938,3600000,0
30273,42528,94,62,44,5,39,.886,3600000,0
30273,42635,94,0,0,0,0,.00nan,0,0
30274,36074,105,69,18,1,17,.944,3600000,0
30274,42624,96,0,0,0,0,.00nan,0,0
30274,56518,105,0,0,0,0,.00nan,0,0
30274,81547,96,89,37,3,34,.919,3559000,0
30275,6979,98,0,0,0,0,.00nan,0,0
30275,30033,107,0,0,0,0,.00nan,0,0
30275,36230,107,94,32,1,31,.969,3600000,0
30275,80050,98,45,23,3,20,.870,3516000,0
30276,42523,99,0,0,0,0,.00nan,0,0
30276,56535,103,89,39,2,37,.949,3900000,0
30276,56591,103,0,0,0,0,.00nan,0,0
30276,73869,99,72,25,2,23,.920,3900000,0
30277,6982,104,0,0,0,0,.00nan,0,0
30277,42458,104,67,30,3,27,.900,3848000,0
30277,42473,93,79,34,2,32,.941,3848000,0
30277,56580,93,0,0,0,0,.00nan,0,0
30278,42565,100,100,37,0,37,1000,3600000,0
30278,55688,87,0,0,0,0,.00nan,0,0
30278,68872,87,61,26,3,23,.885,3600000,0
30278,80138,100,0,0,0,0,.00nan,0,0
30279,42630,90,87,36,2,34,.944,3600000,0
30279,56434,90,0,0,0,0,.00nan,0,0
30279,73712,95,60,8,0,8,1000,989000,0
30279,74366,95,43,33,6,27,.818,2611000,0
30280,42523,99,54,15,2,13,.867,3600000,0
30280,56036,106,0,0,0,0,.00nan,0,0
30280,62596,106,100,50,1,49,.980,3600000,0
30280,73869,99,0,0,0,0,.00nan,0,0
30281,36229,86,0,0,0,0,.00nan,0,0
30281,42486,92,53,2,0,2,1000,923000,0
30281,69563,86,86,14,0,14,1000,3600000,0
30281,71047,92,25,35,7,28,.800,2677000,0
30282,41787,97,61,27,3,24,.889,3600000,0
30282,42456,91,0,0,0,0,.00nan,0,0
30282,42515,97,0,0,0,0,.00nan,0,0
30282,68826,91,44,23,4,19,.826,3563000,0
30283,35824,101,0,0,0,0,.00nan,0,0
30283,35984,101,34,42,8,34,.810,3600000,0
30283,42439,89,81,27,2,25,.926,3600000,0
30283,42474,89,0,0,0,0,.00nan,0,0
30284,6139,102,26,31,6,25,.806,3600000,0
30284,35987,102,0,0,0,0,.00nan,0,0
30284,55688,87,78,28,2,26,.929,3600000,0
30284,68872,87,0,0,0,0,.00nan,0,0
30285,30033,107,65,29,2,27,.931,3566000,0
30285,36074,105,80,27,1,26,.963,3600000,0
30285,36230,107,0,0,0,0,.00nan,0,0
30285,56518,105,0,0,0,0,.00nan,0,0
30286,6982,104,67,31,3,28,.903,3514000,0
30286,42458,104,0,0,0,0,.00nan,0,0
30286,56535,103,0,0,0,0,.00nan,0,0
30286,56591,103,99,36,1,35,.972,3600000,0
30287,8527,88,89,29,1,28,.966,3600000,0
30287,73712,95,90,37,2,35,.946,3600000,0
30287,74366,95,0,0,0,0,.00nan,0,0
30287,75608,88,0,0,0,0,.00nan,0,0
30288,42486,92,100,26,0,26,1000,3600000,0
30288,42528,94,0,0,0,0,.00nan,0,0
30288,42635,94,63,36,4,32,.889,3600000,0
30288,71047,92,0,0,0,0,.00nan,0,0
30289,6982,104,0,0,0,0,.00nan,0,0
30289,30033,107,0,0,0,0,.00nan,0,0
30289,36230,107,93,34,1,33,.971,3600000,0
30289,42458,104,76,27,2,25,.926,3563000,0
30290,42523,99,69,31,3,28,.903,3600000,0
30290,55688,87,58,7,0,7,1000,912000,0
30290,68872,87,31,26,6,20,.769,2688000,0
30290,73869,99,0,0,0,0,.00nan,0,0
30291,6139,102,70,29,2,27,.931,3525000,0
30291,35987,102,0,0,0,0,.00nan,0,0
30291,42439,89,96,27,0,27,1000,3600000,0
30291,42474,89,0,0,0,0,.00nan,0,0
30292,42456,91,64,23,2,21,.913,3600000,0
30292,68826,91,0,0,0,0,.00nan,0,0
30292,73712,95,0,0,0,0,.00nan,0,0
30292,74366,95,61,34,4,30,.882,3579000,0
30293,8527,88,64,27,2,25,.926,3600000,0
30293,42486,92,47,33,5,28,.848,3600000,0
30293,71047,92,0,0,0,0,.00nan,0,0
30293,75608,88,0,0,0,0,.00nan,0,0
30294,42439,89,57,21,2,19,.905,3600000,0
30294,42474,89,0,0,0,0,.00nan,0,0
30294,42565,100,100,41,1,40,.976,3600000,0
30294,80138,100,0,0,0,0,.00nan,0,0
30295,6979,98,54,23,3,20,.870,3600000,0
30295,55688,87,68,18,1,17,.944,1554000,0
30295,68872,87,36,32,6,26,.813,2046000,0
30295,80050,98,0,0,0,0,.00nan,0,0
30296,36229,86,0,0,0,0,.00nan,0,0
30296,42528,94,59,46,5,41,.891,3600000,0
30296,42635,94,0,0,0,0,.00nan,0,0
30296,69563,86,88,15,0,15,1000,3600000,0
30297,42486,92,0,0,0,0,.00nan,0,0
30297,55688,87,54,35,5,30,.857,3600000,0
30297,68872,87,0,0,0,0,.00nan,0,0
30297,71047,92,48,15,2,13,.867,3600000,0
30298,42624,96,61,28,3,25,.893,3575000,0
30298,42630,90,74,24,2,22,.917,3600000,0
30298,56434,90,0,0,0,0,.00nan,0,0
30298,81547,96,0,0,0,0,.00nan,0,0
30299,42456,91,75,24,1,23,.958,3600000,0
30299,42473,93,98,41,2,39,.951,3600000,0
30299,56580,93,0,0,0,0,.00nan,0,0
30299,68826,91,0,0,0,0,.00nan,0,0
30300,8527,88,20,8,4,4,.500,984000,0
30300,73712,95,0,0,0,0,.00nan,0,0
30300,74366,95,100,35,1,34,.971,3600000,0
30300,75608,88,65,8,0,8,1000,2616000,0
30301,42439,89,0,0,0,0,.00nan,0,0
30301,42474,89,89,30,1,29,.967,3600000,0
30301,42523,99,39,40,6,34,.850,2841000,0
30301,73869,99,39,1,1,0,.000,759000,0
30302,30033,107,0,0,0,0,.00nan,0,0
30302,36230,107,26,41,9,32,.780,3600000,0
30302,56535,103,0,0,0,0,.00nan,0,0
30302,56591,103,84,29,1,28,.966,3600000,0
30303,35824,101,0,0,0,0,.00nan,0,0
30303,35984,101,66,38,4,34,.895,3565000,0
30303,42565,100,58,18,2,16,.889,3600000,0
30303,80138,100,0,0,0,0,.00nan,0,0
30304,42473,93,0,0,0,0,.00nan,0,0
30304,55688,87,8,14,6,8,.571,2290000,0
30304,56580,93,59,23,2,21,.913,3600000,0
30304,68872,87,60,16,1,15,.938,1310000,0
30305,41787,97,92,33,1,32,.970,3600000,0
30305,42486,92,62,30,3,27,.900,3517000,0
30305,42515,97,0,0,0,0,.00nan,0,0
30305,71047,92,0,0,0,0,.00nan,0,0
30306,42456,91,89,16,0,16,1000,3600000,0
30306,42630,90,63,51,6,45,.882,3600000,0
30306,56434,90,0,0,0,0,.00nan,0,0
30306,68826,91,0,0,0,0,.00nan,0,0
30307,56036,106,0,0,0,0,.00nan,0,0
30307,56535,103,78,33,2,31,.939,3600000,0
30307,56591,103,0,0,0,0,.00nan,0,0
30307,62596,106,63,42,5,37,.881,3566000,0
30308,6982,104,66,31,3,28,.903,3600000,0
30308,36074,105,72,19,1,18,.947,3600000,0
30308,42458,104,0,0,0,0,.00nan,0,0
30308,56518,105,0,0,0,0,.00nan,0,0
30309,6139,102,49,42,6,36,.857,3353000,0
30309,35987,102,50,1,0,1,1000,186000,0
30309,42565,100,50,24,4,20,.833,3600000,0
30309,80138,100,0,0,0,0,.00nan,0,0
30310,35824,101,0,0,0,0,.00nan,0,0
30310,35984,101,63,32,3,29,.906,3548000,0
30310,42523,99,0,0,0,0,.00nan,0,0
30310,73869,99,100,35,1,34,.971,3600000,0
30311,6979,98,65,38,4,34,.895,3600000,0
30311,42439,89,58,26,3,23,.885,3600000,0
30311,42474,89,0,0,0,0,.00nan,0,0
30311,80050,98,0,0,0,0,.00nan,0,0
30312,36229,86,0,0,0,0,.00nan,0,0
30312,42528,94,0,0,0,0,.00nan,0,0
30312,42635,94,88,37,1,36,.973,3571000,0
30312,69563,86,100,28,0,28,1000,3600000,0
30313,42630,90,40,22,4,18,.818,3582000,0
30313,56434,90,0,0,0,0,.00nan,0,0
30313,73712,95,0,0,0,0,.00nan,0,0
30313,74366,95,68,26,3,23,.885,3600000,0
30314,8527,88,61,30,3,27,.900,3573000,0
30314,42624,96,0,0,0,0,.00nan,0,0
30314,75608,88,0,0,0,0,.00nan,0,0
30314,81547,96,85,32,1,31,.969,3600000,0
30315,42523,99,80,33,3,30,.909,3600000,0
30315,42565,100,41,21,4,17,.810,3557000,0
30315,73869,99,0,0,0,0,.00nan,0,0
30315,80138,100,0,0,0,0,.00nan,0,0
30949,6979,98,64,23,3,20,.870,3900000,0
30949,73712,95,0,0,0,0,.00nan,0,0
30949,74366,95,59,24,3,21,.875,3900000,0
30949,80050,98,0,0,0,0,.00nan,0,0
30951,6139,102,43,34,6,28,.824,2318000,0
30951,35987,102,53,16,2,14,.875,1282000,0
30951,55688,87,0,0,0,0,.00nan,0,0
30951,68872,87,69,24,2,22,.917,3600000,0
30953,36074,105,50,33,5,28,.848,3600000,0
30953,42630,90,67,20,2,18,.900,3600000,0
30953,56434,90,0,0,0,0,.00nan,0,0
30953,56518,105,0,0,0,0,.00nan,0,0
30955,41787,97,100,28,0,28,1000,3600000,0
30955,42515,97,0,0,0,0,.00nan,0,0
30955,42528,94,90,39,2,37,.949,3554000,0
30955,42635,94,0,0,0,0,.00nan,0,0
30957,35767,100,81,26,1,25,.962,3600000,0
30957,42523,99,0,0,0,0,.00nan,0,0
30957,42565,100,0,0,0,0,.00nan,0,0
30957,62597,99,37,34,7,27,.794,3600000,0
30959,8527,88,44,22,4,18,.818,3657000,0
30959,42624,96,0,0,0,0,.00nan,0,0
30959,75608,88,0,0,0,0,.00nan,0,0
30959,81547,96,73,36,3,33,.917,3657000,0
30961,6982,104,49,34,5,29,.853,3563000,0
30961,30033,107,65,35,4,31,.886,3600000,0
30961,36230,107,0,0,0,0,.00nan,0,0
30961,42458,104,0,0,0,0,.00nan,0,0
30963,42439,89,0,0,0,0,.00nan,0,0
30963,42456,91,70,26,2,24,.923,3600000,0
30963,42474,89,77,44,4,40,.909,3514000,0
30963,68826,91,0,0,0,0,.00nan,0,0
30965,35824,101,0,0,0,0,.00nan,0,0
30965,35984,101,86,33,2,31,.939,3900000,0
30965,56535,103,0,0,0,0,.00nan,0,0
30965,56591,103,87,30,2,28,.933,3900000,0
30967,36229,86,0,0,0,0,.00nan,0,0
30967,42473,93,50,29,4,25,.862,3600000,0
30967,56580,93,0,0,0,0,.00nan,0,0
30967,69563,86,65,17,1,16,.941,3600000,0
30969,36124,106,53,36,5,31,.861,3600000,0
30969,42486,92,0,0,0,0,.00nan,0,0
30969,62596,106,0,0,0,0,.00nan,0,0
30969,71047,92,91,36,2,34,.944,3600000,0
30971,8527,88,0,0,0,0,.00nan,0,0
30971,36074,105,0,0,0,0,.00nan,0,0
30971,56518,105,62,40,5,35,.875,3600000,0
30971,75608,88,60,23,2,21,.913,3600000,0
30973,6982,104,0,0,0,0,.00nan,0,0
30973,35767,100,0,0,0,0,.00nan,0,0
30973,42458,104,100,29,0,29,1000,3600000,0
30973,42565,100,64,25,2,23,.920,3512000,0
30975,36229,86,73,23,1,22,.957,3600000,0
30975,42456,91,0,0,0,0,.00nan,0,0
30975,68826,91,94,46,3,43,.935,3561000,0
30975,69563,86,0,0,0,0,.00nan,0,0
30977,42439,89,53,24,3,21,.875,3600000,0
30977,42474,89,0,0,0,0,.00nan,0,0
30977,42523,99,65,46,4,42,.913,3573000,0
30977,62597,99,0,0,0,0,.00nan,0,0
30979,6979,98,0,0,0,0,.00nan,0,0
30979,30033,107,0,0,0,0,.00nan,0,0
30979,36230,107,80,31,2,29,.935,3600000,0
30979,80050,98,75,38,4,34,.895,3600000,0
30981,42624,96,35,27,5,22,.815,3562000,0
30981,73712,95,44,24,4,20,.833,3600000,0
30981,74366,95,0,0,0,0,.00nan,0,0
30981,81547,96,0,0,0,0,.00nan,0,0
30983,36124,106,0,0,0,0,.00nan,0,0
30983,56535,103,59,21,2,19,.905,3900000,0
30983,56591,103,0,0,0,0,.00nan,0,0
30983,62596,106,78,31,2,29,.935,3900000,0
30985,6139,102,0,0,0,0,.00nan,0,0
30985,35987,102,98,38,1,37,.974,3600000,0
30985,42473,93,0,0,0,0,.00nan,0,0
30985,56580,93,65,25,3,22,.880,3600000,0
30987,35824,101,94,50,2,48,.960,3847000,0
30987,35984,101,0,0,0,0,.00nan,0,0
30987,42630,90,0,0,0,0,.00nan,0,0
30987,56434,90,77,24,1,23,.958,3847000,0
30989,41787,97,86,33,2,31,.939,3547000,0
30989,42515,97,0,0,0,0,.00nan,0,0
30989,42528,94,0,0,0,0,.00nan,0,0
30989,42635,94,83,27,1,26,.963,3600000,0
30991,42486,92,83,42,3,39,.929,3600000,0
30991,55688,87,56,25,4,21,.840,3543000,0
30991,68872,87,0,0,0,0,.00nan,0,0
30991,71047,92,0,0,0,0,.00nan,0,0
30993,36229,86,0,0,0,0,.00nan,0,0
30993,42630,90,87,31,1,30,.968,3600000,0
30993,56434,90,0,0,0,0,.00nan,0,0
30993,69563,86,48,16,2,14,.875,3552000,0
30995,30033,107,78,29,2,27,.931,3600000,0
30995,35767,100,66,39,4,35,.897,3600000,0
30995,36230,107,0,0,0,0,.00nan,0,0
30995,42565,100,0,0,0,0,.00nan,0,0
30997,42486,92,55,32,4,28,.875,3600000,0
30997,42528,94,82,28,1,27,.964,3600000,0
30997,42635,94,0,0,0,0,.00nan,0,0
30997,71047,92,0,0,0,0,.00nan,0,0
30999,6982,104,0,0,0,0,.00nan,0,0
30999,35824,101,0,0,0,0,.00nan,0,0
30999,35984,101,86,21,1,20,.952,3600000,0
30999,42458,104,63,35,4,31,.886,3600000,0
31001,42473,93,72,42,5,37,.881,3600000,0
31001,42624,96,0,0,0,0,.00nan,0,0
31001,56580,93,0,0,0,0,.00nan,0,0
31001,81547,96,57,26,3,23,.885,3600000,0
31003,6979,98,88,39,2,37,.949,3600000,0
31003,42523,99,51,32,5,27,.844,3562000,0
31003,62597,99,0,0,0,0,.00nan,0,0
31003,80050,98,0,0,0,0,.00nan,0,0
31005,36124,106,99,48,3,45,.938,3600000,0
31005,41787,97,0,0,0,0,.00nan,0,0
31005,42515,97,52,28,4,24,.857,3544000,0
31005,62596,106,0,0,0,0,.00nan,0,0
31007,42456,91,60,25,3,22,.880,3600000,0
31007,68826,91,0,0,0,0,.00nan,0,0
31007,73712,95,0,0,0,0,.00nan,0,0
31007,74366,95,63,42,4,38,.905,3600000,0
31009,6139,102,65,26,2,24,.923,3553000,0
31009,35987,102,0,0,0,0,.00nan,0,0
31009,36074,105,78,30,1,29,.967,3600000,0
31009,56518,105,0,0,0,0,.00nan,0,0
31011,42439,89,84,44,2,42,.955,3900000,0
31011,42474,89,0,0,0,0,.00nan,0,0
31011,55688,87,69,25,2,23,.920,3900000,0
31011,68872,87,0,0,0,0,.00nan,0,0
31013,8527,88,70,25,1,24,.960,3545000,0
31013,56535,103,0,0,0,0,.00nan,0,0
31013,56591,103,100,31,0,31,1000,3600000,0
31013,75608,88,0,0,0,0,.00nan,0,0
31015,41787,97,0,0,0,0,.00nan,0,0
31015,42515,97,59,39,6,33,.846,3600000,0
31015,42630,90,75,29,3,26,.897,3600000,0
31015,56434,90,0,0,0,0,.00nan,0,0
31017,35824,101,73,27,2,25,.926,3600000,0
31017,35984,101,0,0,0,0,.00nan,0,0
31017,42624,96,56,28,4,24,.857,3573000,0
31017,81547,96,0,0,0,0,.00nan,0,0
31019,36124,106,88,32,1,31,.969,3600000,0
31019,42528,94,0,0,0,0,.00nan,0,0
31019,42635,94,64,34,3,31,.912,3575000,0
31019,62596,106,0,0,0,0,.00nan,0,0
31021,6139,102,0,0,0,0,.00nan,0,0
31021,35987,102,92,21,0,21,1000,3600000,0
31021,73712,95,0,0,0,0,.00nan,0,0
31021,74366,95,94,43,2,41,.953,3520000,0
31023,8527,88,42,35,6,29,.829,3600000,0
31023,36074,105,100,36,0,36,1000,3600000,0
31023,56518,105,0,0,0,0,.00nan,0,0
31023,75608,88,0,0,0,0,.00nan,0,0
31025,30033,107,75,23,1,22,.957,3600000,0
31025,36230,107,0,0,0,0,.00nan,0,0
31025,42473,93,66,30,3,27,.900,3527000,0
31025,56580,93,0,0,0,0,.00nan,0,0
31027,6979,98,55,30,4,26,.867,3800000,0
31027,55688,87,66,27,3,24,.889,3800000,0
31027,68872,87,0,0,0,0,.00nan,0,0
31027,80050,98,0,0,0,0,.00nan,0,0
31029,42486,92,0,0,0,0,.00nan,0,0
31029,42523,99,47,34,5,29,.853,3591000,0
31029,62597,99,0,0,0,0,.00nan,0,0
31029,71047,92,65,35,4,31,.886,3600000,0
31031,36229,86,0,0,0,0,.00nan,0,0
31031,42456,91,58,44,6,38,.864,3363000,0
31031,68826,91,56,5,0,5,1000,237000,0
31031,69563,86,70,23,1,22,.957,3600000,0
31033,42439,89,0,0,0,0,.00nan,0,0
31033,42474,89,77,23,1,22,.957,3600000,0
31033,56535,103,0,0,0,0,.00nan,0,0
31033,56591,103,37,32,6,26,.813,3600000,0
31035,6982,104,0,0,0,0,.00nan,0,0
31035,35767,100,100,33,0,33,1000,3600000,0
31035,42458,104,68,21,1,20,.952,3545000,0
31035,42565,100,0,0,0,0,.00nan,0,0
31037,6982,104,57,22,3,19,.864,3571000,0
31037,36124,106,0,0,0,0,.00nan,0,0
31037,42458,104,0,0,0,0,.00nan,0,0
31037,62596,106,81,32,2,30,.938,3600000,0
31039,42456,91,0,0,0,0,.00nan,0,0
31039,56535,103,63,35,4,31,.886,3576000,0
31039,56591,103,0,0,0,0,.00nan,0,0
31039,68826,91,59,25,3,22,.880,3600000,0
31041,8527,88,0,0,0,0,.00nan,0,0
31041,42523,99,0,0,0,0,.00nan,0,0
31041,62597,99,65,27,2,25,.926,3600000,0
31041,75608,88,62,24,3,21,.875,3577000,0
31043,41787,97,93,24,1,23,.958,3600000,0
31043,42486,92,67,32,3,29,.906,3592000,0
31043,42515,97,0,0,0,0,.00nan,0,0
31043,71047,92,0,0,0,0,.00nan,0,0
31045,42439,89,76,39,3,36,.923,3554000,0
31045,42474,89,0,0,0,0,.00nan,0,0
31045,42630,90,0,0,0,0,.00nan,0,0
31045,56434,90,75,31,2,29,.935,3600000,0
31047,6139,102,0,0,0,0,.00nan,0,0
31047,35987,102,54,25,4,21,.840,3600000,0
31047,42473,93,0,0,0,0,.00nan,0,0
31047,56580,93,66,39,5,34,.872,3545000,0
31049,35824,101,0,0,0,0,.00nan,0,0
31049,35984,101,59,36,4,32,.889,3600000,0
31049,73712,95,51,20,3,17,.850,3600000,0
31049,74366,95,0,0,0,0,.00nan,0,0
31051,6979,98,43,12,2,10,.833,1143000,0
31051,36229,86,0,0,0,0,.00nan,0,0
31051,69563,86,92,28,1,27,.964,3600000,0
31051,80050,98,27,28,6,22,.786,2457000,0
31053,36074,105,84,37,3,34,.919,3900000,0
31053,55688,87,0,0,0,0,.00nan,0,0
31053,56518,105,0,0,0,0,.00nan,0,0
31053,68872,87,58,23,3,20,.870,3900000,0
31055,30033,107,0,0,0,0,.00nan,0,0
31055,36230,107,75,35,3,32,.914,3900000,0
31055,42624,96,0,0,0,0,.00nan,0,0
31055,81547,96,60,20,3,17,.850,3900000,0
31057,35767,100,61,19,2,17,.895,3600000,0
31057,42528,94,57,40,4,36,.900,3540000,0
31057,42565,100,0,0,0,0,.00nan,0,0
31057,42635,94,0,0,0,0,.00nan,0,0
31059,41787,97,0,0,0,0,.00nan,0,0
31059,42439,89,70,29,3,26,.897,3599000,0
31059,42474,89,0,0,0,0,.00nan,0,0
31059,42515,97,74,28,2,26,.929,3600000,0
31061,30033,107,73,26,1,25,.962,3566000,0
31061,36229,86,0,0,0,0,.00nan,0,0
31061,36230,107,0,0,0,0,.00nan,0,0
31061,69563,86,86,20,0,20,1000,3600000,0
31063,35767,100,0,0,0,0,.00nan,0,0
31063,36074,105,99,29,0,29,1000,3600000,0
31063,42565,100,65,17,1,16,.941,3596000,0
31063,56518,105,0,0,0,0,.00nan,0,0
31065,36124,106,71,48,5,43,.896,3600000,0
31065,42486,92,0,0,0,0,.00nan,0,0
31065,62596,106,0,0,0,0,.00nan,0,0
31065,71047,92,39,13,3,10,.769,3600000,0
31067,8527,88,44,25,4,21,.840,3600000,0
31067,35824,101,57,38,5,33,.868,3600000,0
31067,35984,101,0,0,0,0,.00nan,0,0
31067,75608,88,0,0,0,0,.00nan,0,0
31069,42456,91,74,37,4,33,.892,3600000,0
31069,68826,91,0,0,0,0,.00nan,0,0
31069,73712,95,0,0,0,0,.00nan,0,0
31069,74366,95,46,39,6,33,.846,3594000,0
31071,42523,99,70,35,3,32,.914,3544000,0
31071,42630,90,86,33,2,31,.939,3600000,0
31071,56434,90,0,0,0,0,.00nan,0,0
31071,62597,99,0,0,0,0,.00nan,0,0
31073,6979,98,75,41,4,37,.902,3581000,0
31073,42528,94,0,0,0,0,.00nan,0,0
31073,42635,94,56,27,3,24,.889,3600000,0
31073,80050,98,0,0,0,0,.00nan,0,0
31075,6982,104,0,0,0,0,.00nan,0,0
31075,42458,104,73,36,3,33,.917,3900000,0
31075,42473,93,71,33,3,30,.909,3900000,0
31075,56580,93,0,0,0,0,.00nan,0,0
31077,55688,87,100,28,0,28,1000,3673000,0
31077,56535,103,0,0,0,0,.00nan,0,0
31077,56591,103,92,31,1,30,.968,3673000,0
31077,68872,87,0,0,0,0,.00nan,0,0
31079,6139,102,0,0,0,0,.00nan,0,0
31079,35987,102,45,31,5,26,.839,3600000,0
31079,42624,96,63,27,3,24,.889,3600000,0
31079,81547,96,0,0,0,0,.00nan,0,0
31081,6979,98,68,28,3,25,.893,3600000,0
31081,42473,93,0,0,0,0,.00nan,0,0
31081,56580,93,44,32,5,27,.844,3564000,0
31081,80050,98,0,0,0,0,.00nan,0,0
31083,55688,87,75,33,2,31,.939,3600000,0
31083,68872,87,0,0,0,0,.00nan,0,0
31083,73712,95,80,38,3,35,.921,3566000,0
31083,74366,95,0,0,0,0,.00nan,0,0
31085,36124,106,0,0,0,0,.00nan,0,0
31085,42630,90,0,0,0,0,.00nan,0,0
31085,56434,90,64,29,3,26,.897,3600000,0
31085,62596,106,59,41,5,36,.878,3579000,0
31087,8527,88,0,0,0,0,.00nan,0,0
31087,36074,105,35,30,6,24,.800,3600000,0
31087,56518,105,0,0,0,0,.00nan,0,0
31087,75608,88,55,25,3,22,.880,3600000,0
31089,42456,91,0,0,0,0,.00nan,0,0
31089,42523,99,0,0,0,0,.00nan,0,0
31089,62597,99,55,35,4,31,.886,3600000,0
31089,68826,91,55,21,3,18,.857,3600000,0
31091,41787,97,65,22,1,21,.955,3900000,0
31091,42515,97,0,0,0,0,.00nan,0,0
31091,56535,103,95,45,1,44,.978,3900000,0
31091,56591,103,0,0,0,0,.00nan,0,0
31093,6982,104,70,31,2,29,.935,3600000,0
31093,30033,107,33,12,3,9,.750,1847000,0
31093,36230,107,28,20,5,15,.750,1753000,0
31093,42458,104,0,0,0,0,.00nan,0,0
31095,42486,92,53,33,4,29,.879,3600000,0
31095,42624,96,0,0,0,0,.00nan,0,0
31095,71047,92,0,0,0,0,.00nan,0,0
31095,81547,96,66,21,1,20,.952,3600000,0
31097,6139,102,43,23,4,19,.826,3600000,0
31097,35824,101,0,0,0,0,.00nan,0,0
31097,35984,101,71,47,5,42,.894,3600000,0
31097,35987,102,0,0,0,0,.00nan,0,0
31099,35767,100,12,19,6,13,.684,2152000,0
31099,36229,86,0,0,0,0,.00nan,0,0
31099,42565,100,50,15,2,13,.867,1448000,0
31099,69563,86,51,14,2,12,.857,3600000,0
31101,42439,89,0,0,0,0,.00nan,0,0
31101,42474,89,76,31,2,29,.935,3900000,0
31101,42528,94,68,18,2,16,.889,3900000,0
31101,42635,94,0,0,0,0,.00nan,0,0
31102,40171,137,0,0,0,0,.00nan,0,0
31102,54514,138,89,37,2,35,.946,3600000,0
31102,55627,137,37,28,6,22,.786,3600000,0
31102,63513,138,0,0,0,0,.00nan,0,0
31103,55608,142,78,31,2,29,.935,3600000,0
31103,68954,139,50,29,4,25,.862,3561000,0
31103,79812,139,0,0,0,0,.00nan,0,0
31103,79819,142,0,0,0,0,.00nan,0,0
31104,5675,140,0,0,0,0,.00nan,0,0
31104,42270,141,98,43,2,41,.953,3600000,0
31104,55871,140,31,35,6,29,.829,3600000,0
31104,55945,141,0,0,0,0,.00nan,0,0
31105,4635,143,80,45,3,42,.933,3600000,0
31105,55745,144,0,0,0,0,.00nan,0,0
31105,57299,144,61,36,4,32,.889,3544000,0
31105,57310,143,0,0,0,0,.00nan,0,0
31106,20182,134,0,0,0,0,.00nan,0,0
31106,42349,133,43,34,6,28,.824,2652000,0
31106,55736,134,55,16,2,14,.875,3600000,0
31106,57354,133,60,12,2,10,.833,948000,0
31107,42196,132,66,36,4,32,.889,3600000,0
31107,55894,132,0,0,0,0,.00nan,0,0
31107,79197,128,0,0,0,0,.00nan,0,0
31107,83112,128,100,30,0,30,1000,3600000,0
31108,55819,129,71,21,1,20,.952,3600000,0
31108,56443,130,22,23,6,17,.739,2135000,0
31108,57763,130,31,16,4,12,.750,1465000,0
31108,79056,129,0,0,0,0,.00nan,0,0
31109,55527,135,92,32,1,31,.969,3600000,0
31109,56593,136,53,3,0,3,1000,275000,0
31109,78015,136,42,33,6,27,.818,3325000,0
31109,139220,135,0,0,0,0,.00nan,0,0
31110,42208,131,81,29,2,27,.931,3600000,0
31110,55569,131,0,0,0,0,.00nan,0,0
31110,55850,1340,70,36,4,32,.889,3600000,0
31110,57454,1340,0,0,0,0,.00nan,0,0
31111,40171,137,21,20,5,15,.750,2980000,0
31111,54514,138,64,34,4,30,.882,3600000,0
31111,55627,137,35,5,2,3,.600,601000,0
31111,63513,138,0,0,0,0,.00nan,0,0
31112,55819,129,0,0,0,0,.00nan,0,0
31112,79056,129,52,16,2,14,.875,3600000,0
31112,79197,128,0,0,0,0,.00nan,0,0
31112,83112,128,57,32,5,27,.844,3600000,0
31113,55608,142,0,0,0,0,.00nan,0,0
31113,68954,139,0,0,0,0,.00nan,0,0
31113,79812,139,64,27,2,25,.926,3900000,0
31113,79819,142,84,30,2,28,.933,3900000,0
31114,5675,140,77,27,1,26,.963,3600000,0
31114,42270,141,55,3,0,3,1000,1015000,0
31114,55871,140,0,0,0,0,.00nan,0,0
31114,55945,141,38,33,6,27,.818,2585000,0
31115,4635,143,62,29,3,26,.897,3600000,0
31115,55745,144,0,0,0,0,.00nan,0,0
31115,57299,144,65,35,4,31,.886,3585000,0
31115,57310,143,0,0,0,0,.00nan,0,0
31116,42196,132,0,0,0,0,.00nan,0,0
31116,55894,132,43,30,5,25,.833,3600000,0
31116,56443,130,100,22,0,22,1000,3600000,0
31116,57763,130,0,0,0,0,.00nan,0,0
31117,42208,131,0,0,0,0,.00nan,0,0
31117,55569,131,38,22,4,18,.818,3545000,0
31117,55850,1340,0,0,0,0,.00nan,0,0
31117,57454,1340,70,34,3,31,.912,3600000,0
31118,20182,134,54,21,3,18,.857,3600000,0
31118,42349,133,51,30,4,26,.867,2522000,0
31118,55736,134,0,0,0,0,.00nan,0,0
31118,57354,133,21,22,6,16,.727,1078000,0
31119,55527,135,64,21,2,19,.905,3600000,0
31119,56593,136,0,0,0,0,.00nan,0,0
31119,78015,136,81,45,4,41,.911,3600000,0
31119,139220,135,0,0,0,0,.00nan,0,0
31120,42196,132,56,30,4,26,.867,3600000,0
31120,42208,131,82,27,1,26,.963,3600000,0
31120,55569,131,0,0,0,0,.00nan,0,0
31120,55894,132,0,0,0,0,.00nan,0,0
31121,42270,141,50,39,5,34,.872,3600000,0
31121,55945,141,0,0,0,0,.00nan,0,0
31121,68954,139,70,22,2,20,.909,3600000,0
31121,79812,139,0,0,0,0,.00nan,0,0
31122,4635,143,43,24,4,20,.833,3600000,0
31122,55608,142,88,37,1,36,.973,3600000,0
31122,57310,143,0,0,0,0,.00nan,0,0
31122,79819,142,0,0,0,0,.00nan,0,0
31123,5675,140,40,27,5,22,.815,3600000,0
31123,55745,144,0,0,0,0,.00nan,0,0
31123,55871,140,0,0,0,0,.00nan,0,0
31123,57299,144,69,28,2,26,.929,3600000,0
31124,20182,134,62,26,3,23,.885,3600000,0
31124,56017,134,0,0,0,0,.00nan,0,0
31124,56593,136,0,0,0,0,.00nan,0,0
31124,78015,136,58,38,5,33,.868,3600000,0
31125,42349,133,50,38,5,33,.868,2523000,0
31125,55527,135,30,7,3,4,.571,387000,0
31125,57354,133,24,13,4,9,.692,1077000,0
31125,139220,135,50,23,3,20,.870,3213000,0
31126,42208,131,0,0,0,0,.00nan,0,0
31126,55569,131,61,32,3,29,.906,3600000,0
31126,55819,129,69,20,1,19,.950,3600000,0
31126,79056,129,0,0,0,0,.00nan,0,0
31127,54514,138,73,37,3,34,.919,3571000,0
31127,56443,130,54,17,2,15,.882,3600000,0
31127,57763,130,0,0,0,0,.00nan,0,0
31127,63513,138,0,0,0,0,.00nan,0,0
31128,20182,134,0,0,0,0,.00nan,0,0
31128,55527,135,58,29,4,25,.862,3600000,0
31128,56017,134,78,27,1,26,.963,3600000,0
31128,139220,135,0,0,0,0,.00nan,0,0
31129,55819,129,53,4,0,4,1000,689000,0
31129,55850,1340,83,54,4,50,.926,3600000,0
31129,57454,1340,0,0,0,0,.00nan,0,0
31129,79056,129,31,29,6,23,.793,2876000,0
31130,40171,137,0,0,0,0,.00nan,0,0
31130,42196,132,0,0,0,0,.00nan,0,0
31130,55627,137,74,35,3,32,.914,3900000,0
31130,55894,132,68,32,3,29,.906,3900000,0
31131,56593,136,43,29,5,24,.828,3600000,0
31131,78015,136,0,0,0,0,.00nan,0,0
31131,79197,128,0,0,0,0,.00nan,0,0
31131,83112,128,78,26,1,25,.962,3600000,0
31132,5675,140,0,0,0,0,.00nan,0,0
31132,55745,144,0,0,0,0,.00nan,0,0
31132,55871,140,56,23,3,20,.870,3600000,0
31132,57299,144,69,40,4,36,.900,3570000,0
31133,4635,143,56,36,5,31,.861,3589000,0
31133,55608,142,0,0,0,0,.00nan,0,0
31133,57310,143,0,0,0,0,.00nan,0,0
31133,79819,142,44,25,4,21,.840,3600000,0
31134,42270,141,33,11,3,8,.727,3600000,0
31134,55945,141,0,0,0,0,.00nan,0,0
31134,68954,139,39,39,6,33,.846,3600000,0
31134,79812,139,0,0,0,0,.00nan,0,0
31135,42349,133,0,0,0,0,.00nan,0,0
31135,54514,138,98,22,0,22,1000,3600000,0
31135,57354,133,49,27,4,23,.852,3600000,0
31135,63513,138,0,0,0,0,.00nan,0,0
31136,42196,132,44,30,4,26,.867,3590000,0
31136,55850,1340,60,24,3,21,.875,3600000,0
31136,55894,132,0,0,0,0,.00nan,0,0
31136,57454,1340,0,0,0,0,.00nan,0,0
31137,42208,131,87,32,2,30,.938,3600000,0
31137,55569,131,0,0,0,0,.00nan,0,0
31137,56443,130,0,0,0,0,.00nan,0,0
31137,57763,130,38,14,3,11,.786,3565000,0
31138,40171,137,85,39,2,37,.949,3600000,0
31138,55627,137,0,0,0,0,.00nan,0,0
31138,79197,128,96,26,0,26,1000,3600000,0
31138,83112,128,0,0,0,0,.00nan,0,0
31139,42270,141,0,0,0,0,.00nan,0,0
31139,55608,142,74,22,2,20,.909,3900000,0
31139,55945,141,82,32,2,30,.938,3900000,0
31139,79819,142,0,0,0,0,.00nan,0,0
31140,4635,143,54,28,4,24,.857,3600000,0
31140,55745,144,99,34,1,33,.971,3600000,0
31140,57299,144,0,0,0,0,.00nan,0,0
31140,57310,143,0,0,0,0,.00nan,0,0
31141,40171,137,0,0,0,0,.00nan,0,0
31141,42270,141,27,23,5,18,.783,3570000,0
31141,55627,137,71,43,4,39,.907,3600000,0
31141,55945,141,0,0,0,0,.00nan,0,0
31142,42208,131,66,19,1,18,.947,3600000,0
31142,54514,138,97,55,4,51,.927,3600000,0
31142,55569,131,0,0,0,0,.00nan,0,0
31142,63513,138,0,0,0,0,.00nan,0,0
31143,42349,133,74,50,5,45,.900,3600000,0
31143,57354,133,0,0,0,0,.00nan,0,0
31143,79197,128,52,17,2,15,.882,3600000,0
31143,83112,128,0,0,0,0,.00nan,0,0
31144,5675,140,70,26,2,24,.923,3600000,0
31144,40171,137,76,44,3,41,.932,3014000,0
31144,55627,137,36,14,3,11,.786,586000,0
31144,55871,140,0,0,0,0,.00nan,0,0
31145,4635,143,70,26,2,24,.923,3747000,0
31145,42270,141,0,0,0,0,.00nan,0,0
31145,55945,141,100,39,1,38,.974,3747000,0
31145,57310,143,0,0,0,0,.00nan,0,0
31146,56593,136,0,0,0,0,.00nan,0,0
31146,78015,136,83,34,2,32,.941,3600000,0
31146,79197,128,0,0,0,0,.00nan,0,0
31146,83112,128,61,36,4,32,.889,3564000,0
31147,20182,134,52,26,4,22,.846,3900000,0
31147,42196,132,49,23,4,19,.826,3900000,0
31147,55894,132,0,0,0,0,.00nan,0,0
31147,56017,134,0,0,0,0,.00nan,0,0
31148,42208,131,74,22,1,21,.955,3600000,0
31148,55569,131,0,0,0,0,.00nan,0,0
31148,55819,129,95,46,2,44,.957,3600000,0
31148,79056,129,0,0,0,0,.00nan,0,0
31149,54514,138,88,38,2,36,.947,3545000,0
31149,56443,130,0,0,0,0,.00nan,0,0
31149,57763,130,73,23,1,22,.957,3600000,0
31149,63513,138,0,0,0,0,.00nan,0,0
31150,55527,135,60,19,2,17,.895,3600000,0
31150,55850,1340,71,49,5,44,.898,3600000,0
31150,57454,1340,0,0,0,0,.00nan,0,0
31150,139220,135,0,0,0,0,.00nan,0,0
31151,55608,142,71,20,1,19,.950,3600000,0
31151,68954,139,0,0,0,0,.00nan,0,0
31151,79812,139,68,34,3,31,.912,3535000,0
31151,79819,142,0,0,0,0,.00nan,0,0
31152,55527,135,0,0,0,0,.00nan,0,0
31152,79197,128,87,38,2,36,.947,3600000,0
31152,83112,128,0,0,0,0,.00nan,0,0
31152,139220,135,36,29,6,23,.793,3600000,0
31153,42349,133,71,35,4,31,.886,3526000,0
31153,54514,138,0,0,0,0,.00nan,0,0
31153,57354,133,0,0,0,0,.00nan,0,0
31153,63513,138,82,30,2,28,.933,3600000,0
31154,40171,137,0,0,0,0,.00nan,0,0
31154,55627,137,74,28,2,26,.929,3600000,0
31154,55745,144,0,0,0,0,.00nan,0,0
31154,57299,144,81,35,3,32,.914,3569000,0
31155,4635,143,0,0,0,0,.00nan,0,0
31155,42270,141,69,28,3,25,.893,3820000,0
31155,55945,141,0,0,0,0,.00nan,0,0
31155,57310,143,75,39,4,35,.897,3820000,0
31156,20182,134,0,0,0,0,.00nan,0,0
31156,42196,132,0,0,0,0,.00nan,0,0
31156,55894,132,70,30,3,27,.900,3600000,0
31156,56017,134,66,17,1,16,.941,3600000,0
31157,55608,142,0,0,0,0,.00nan,0,0
31157,55745,144,0,0,0,0,.00nan,0,0
31157,57299,144,62,33,4,29,.879,3522000,0
31157,79819,142,64,23,2,21,.913,3600000,0
31158,20182,134,73,44,4,40,.909,3900000,0
31158,55819,129,77,37,3,34,.919,3900000,0
31158,56017,134,0,0,0,0,.00nan,0,0
31158,79056,129,0,0,0,0,.00nan,0,0
31159,42208,131,0,0,0,0,.00nan,0,0
31159,42349,133,90,34,2,32,.941,3600000,0
31159,55569,131,70,36,3,33,.917,3600000,0
31159,57354,133,0,0,0,0,.00nan,0,0
31160,55850,1340,64,27,3,24,.889,3900000,0
31160,56443,130,62,29,3,26,.897,3900000,0
31160,57454,1340,0,0,0,0,.00nan,0,0
31160,57763,130,0,0,0,0,.00nan,0,0
31161,5675,140,87,47,4,43,.915,3900000,0
31161,55871,140,0,0,0,0,.00nan,0,0
31161,68954,139,59,27,4,23,.852,3900000,0
31161,79812,139,0,0,0,0,.00nan,0,0
31162,55527,135,35,29,7,22,.759,3031000,0
31162,56593,136,0,0,0,0,.00nan,0,0
31162,78015,136,76,25,1,24,.960,3600000,0
31162,139220,135,38,6,2,4,.667,569000,0
31163,42270,141,0,0,0,0,.00nan,0,0
31163,55745,144,0,0,0,0,.00nan,0,0
31163,55945,141,76,35,5,30,.857,3587000,0
31163,57299,144,65,40,4,36,.900,3600000,0
31164,55608,142,100,40,2,38,.950,3900000,0
31164,57310,143,78,29,2,27,.931,3900000,0
31164,63512,143,0,0,0,0,.00nan,0,0
31164,79819,142,0,0,0,0,.00nan,0,0
31165,40171,137,0,0,0,0,.00nan,0,0
31165,54514,138,77,39,4,35,.897,3693000,0
31165,55627,137,70,46,5,41,.891,3693000,0
31165,63513,138,0,0,0,0,.00nan,0,0
31166,56443,130,65,19,1,18,.947,3600000,0
31166,56593,136,62,8,0,8,1000,1351000,0
31166,57763,130,0,0,0,0,.00nan,0,0
31166,78015,136,40,28,5,23,.821,2249000,0
31167,42208,131,88,33,1,32,.970,3600000,0
31167,55527,135,51,29,4,25,.862,3600000,0
31167,55569,131,0,0,0,0,.00nan,0,0
31167,139220,135,0,0,0,0,.00nan,0,0
31168,42196,132,68,26,2,24,.923,3691000,0
31168,55608,142,84,36,3,33,.917,3691000,0
31168,55894,132,0,0,0,0,.00nan,0,0
31168,79819,142,0,0,0,0,.00nan,0,0
31169,42270,141,0,0,0,0,.00nan,0,0
31169,55819,129,60,22,2,20,.909,3600000,0
31169,55945,141,79,40,3,37,.925,3558000,0
31169,79056,129,0,0,0,0,.00nan,0,0
31170,20182,134,0,0,0,0,.00nan,0,0
31170,42208,131,0,0,0,0,.00nan,0,0
31170,55569,131,54,26,3,23,.885,3600000,0
31170,55736,134,100,27,0,27,1000,3600000,0
31171,54514,138,85,47,4,43,.915,3585000,0
31171,55850,1340,55,22,3,19,.864,3600000,0
31171,57454,1340,0,0,0,0,.00nan,0,0
31171,63513,138,0,0,0,0,.00nan,0,0
31172,40171,137,0,0,0,0,.00nan,0,0
31172,55627,137,37,37,7,30,.811,3560000,0
31172,56593,136,0,0,0,0,.00nan,0,0
31172,78015,136,13,19,6,13,.684,3600000,0
31173,56443,130,0,0,0,0,.00nan,0,0
31173,57763,130,71,21,1,20,.952,3900000,0
31173,79197,128,0,0,0,0,.00nan,0,0
31173,83112,128,87,30,1,29,.967,3900000,0
31174,42349,133,0,0,0,0,.00nan,0,0
31174,55527,135,73,23,1,22,.957,3600000,0
31174,57354,133,77,35,2,33,.943,3566000,0
31174,139220,135,0,0,0,0,.00nan,0,0
31175,5675,140,64,20,2,18,.900,3577000,0
31175,55819,129,87,31,1,30,.968,3600000,0
31175,55871,140,0,0,0,0,.00nan,0,0
31175,79056,129,0,0,0,0,.00nan,0,0
31176,42196,132,0,0,0,0,.00nan,0,0
31176,55745,144,60,28,2,26,.929,3900000,0
31176,55894,132,80,24,2,22,.917,3900000,0
31176,57299,144,0,0,0,0,.00nan,0,0
31177,57310,143,0,0,0,0,.00nan,0,0
31177,63512,143,88,38,2,36,.947,3600000,0
31177,68954,139,0,0,0,0,.00nan,0,0
31177,79812,139,48,25,3,22,.880,3594000,0
31178,55608,142,78,47,4,43,.915,3600000,0
31178,57310,143,56,17,2,15,.882,3600000,0
31178,63512,143,0,0,0,0,.00nan,0,0
31178,79819,142,0,0,0,0,.00nan,0,0
31179,5675,140,0,0,0,0,.00nan,0,0
31179,42270,141,50,22,3,19,.864,3600000,0
31179,55871,140,56,31,4,27,.871,3583000,0
31179,55945,141,0,0,0,0,.00nan,0,0
31180,55745,144,0,0,0,0,.00nan,0,0
31180,55819,129,73,22,1,21,.955,3600000,0
31180,57299,144,59,35,4,31,.886,3600000,0
31180,79056,129,0,0,0,0,.00nan,0,0
31181,20182,134,0,0,0,0,.00nan,0,0
31181,55527,135,0,0,0,0,.00nan,0,0
31181,55736,134,81,46,3,43,.935,3900000,0
31181,139220,135,57,29,3,26,.897,3900000,0
31182,42208,131,28,30,7,23,.767,3584000,0
31182,42349,133,66,39,5,34,.872,3600000,0
31182,55569,131,0,0,0,0,.00nan,0,0
31182,57354,133,0,0,0,0,.00nan,0,0
31183,40171,137,0,0,0,0,.00nan,0,0
31183,55627,137,85,30,2,28,.933,3600000,0
31183,56443,130,57,21,3,18,.857,3567000,0
31183,57763,130,0,0,0,0,.00nan,0,0
31184,55850,1340,40,40,6,34,.850,3566000,0
31184,57454,1340,0,0,0,0,.00nan,0,0
31184,79197,128,33,24,5,19,.792,3600000,0
31184,83112,128,0,0,0,0,.00nan,0,0
31185,42196,132,96,43,2,41,.953,3600000,0
31185,55894,132,0,0,0,0,.00nan,0,0
31185,68954,139,89,33,1,32,.970,3600000,0
31185,79812,139,0,0,0,0,.00nan,0,0
31186,54514,138,42,16,3,13,.813,3600000,0
31186,56593,136,46,7,1,6,.857,686000,0
31186,63513,138,0,0,0,0,.00nan,0,0
31186,78015,136,51,36,6,30,.833,2914000,0
31715,20182,134,0,0,0,0,.00nan,0,0
31715,55736,134,73,31,2,29,.935,3600000,0
31715,55819,129,38,32,6,26,.813,3600000,0
31715,79056,129,0,0,0,0,.00nan,0,0
31717,42270,141,0,0,0,0,.00nan,0,0
31717,55945,141,75,39,4,35,.897,3600000,0
31717,79197,128,64,45,6,39,.867,3563000,0
31717,83112,128,0,0,0,0,.00nan,0,0
31719,40171,137,88,35,2,33,.943,3600000,0
31719,55627,137,0,0,0,0,.00nan,0,0
31719,56443,130,58,37,5,32,.865,3600000,0
31719,57763,130,0,0,0,0,.00nan,0,0
31721,55608,142,75,38,3,35,.921,3600000,0
31721,55745,144,0,0,0,0,.00nan,0,0
31721,57299,144,65,35,4,31,.886,3591000,0
31721,79819,142,0,0,0,0,.00nan,0,0
31723,4635,143,71,23,2,21,.913,3600000,0
31723,55850,1340,67,33,3,30,.909,3560000,0
31723,57310,143,0,0,0,0,.00nan,0,0
31723,57454,1340,0,0,0,0,.00nan,0,0
31725,5675,140,44,39,6,33,.846,3600000,0
31725,55871,140,0,0,0,0,.00nan,0,0
31725,56593,136,54,22,3,19,.864,3600000,0
31725,78015,136,0,0,0,0,.00nan,0,0
31727,42349,133,0,0,0,0,.00nan,0,0
31727,54514,138,95,33,2,31,.939,3600000,0
31727,57354,133,62,40,5,35,.875,3600000,0
31727,63513,138,0,0,0,0,.00nan,0,0
31729,42196,132,59,49,7,42,.857,3600000,0
31729,55527,135,54,22,4,18,.818,3600000,0
31729,55894,132,0,0,0,0,.00nan,0,0
31729,139220,135,0,0,0,0,.00nan,0,0
31731,42208,131,65,27,3,24,.889,3600000,0
31731,55569,131,0,0,0,0,.00nan,0,0
31731,68954,139,0,0,0,0,.00nan,0,0
31731,79812,139,57,45,5,40,.889,3537000,0
31733,55819,129,0,0,0,0,.00nan,0,0
31733,56443,130,0,0,0,0,.00nan,0,0
31733,57763,130,63,26,2,24,.923,3600000,0
31733,79056,129,82,40,3,37,.925,3592000,0
31735,5675,140,0,0,0,0,.00nan,0,0
31735,42196,132,0,0,0,0,.00nan,0,0
31735,55871,140,52,35,5,30,.857,3867000,0
31735,55894,132,61,38,5,33,.868,3900000,0
31737,40171,137,0,0,0,0,.00nan,0,0
31737,42208,131,0,0,0,0,.00nan,0,0
31737,55569,131,86,31,2,29,.935,3600000,0
31737,55627,137,77,36,3,33,.917,3564000,0
31739,55850,1340,54,17,2,15,.882,1321000,0
31739,57454,1340,38,29,6,23,.793,2279000,0
31739,68954,139,68,32,3,29,.906,3600000,0
31739,79812,139,0,0,0,0,.00nan,0,0
31741,4635,143,0,0,0,0,.00nan,0,0
31741,20182,134,61,41,4,37,.902,3900000,0
31741,55736,134,0,0,0,0,.00nan,0,0
31741,57310,143,52,30,4,26,.867,3900000,0
31743,42270,141,90,34,2,32,.941,3600000,0
31743,42349,133,70,42,4,38,.905,3574000,0
31743,55945,141,0,0,0,0,.00nan,0,0
31743,57354,133,0,0,0,0,.00nan,0,0
31745,55527,135,76,21,1,20,.952,3600000,0
31745,79197,128,0,0,0,0,.00nan,0,0
31745,83112,128,78,32,2,30,.938,3540000,0
31745,139220,135,0,0,0,0,.00nan,0,0
31747,55745,144,25,23,6,17,.739,2427000,0
31747,56593,136,0,0,0,0,.00nan,0,0
31747,57299,144,73,20,1,19,.950,1173000,0
31747,78015,136,43,22,4,18,.818,3600000,0
31749,54514,138,0,0,0,0,.00nan,0,0
31749,55608,142,0,0,0,0,.00nan,0,0
31749,63513,138,86,39,2,37,.949,3600000,0
31749,79819,142,37,34,6,28,.824,3600000,0
31751,20182,134,0,0,0,0,.00nan,0,0
31751,55736,134,56,24,3,21,.875,3600000,0
31751,55850,1340,17,19,6,13,.684,2262000,0
31751,57454,1340,68,21,1,20,.952,1338000,0
31753,56443,130,77,25,2,23,.920,3600000,0
31753,57763,130,0,0,0,0,.00nan,0,0
31753,68954,139,0,0,0,0,.00nan,0,0
31753,79812,139,54,42,5,37,.881,3600000,0
31755,42208,131,50,20,3,17,.850,3514000,0
31755,55569,131,0,0,0,0,.00nan,0,0
31755,55819,129,99,36,1,35,.972,3600000,0
31755,79056,129,0,0,0,0,.00nan,0,0
31757,5675,140,0,0,0,0,.00nan,0,0
31757,42196,132,24,11,4,7,.636,739000,0
31757,55871,140,45,31,5,26,.839,3600000,0
31757,55894,132,40,28,5,23,.821,2861000,0
31759,4635,143,48,38,6,32,.842,2340000,0
31759,42270,141,78,39,3,36,.923,3600000,0
31759,55945,141,0,0,0,0,.00nan,0,0
31759,57310,143,59,22,2,20,.909,1260000,0
31761,55527,135,55,34,5,29,.853,3600000,0
31761,55608,142,86,39,2,37,.949,3600000,0
31761,79819,142,0,0,0,0,.00nan,0,0
31761,139220,135,0,0,0,0,.00nan,0,0
31763,55745,144,0,0,0,0,.00nan,0,0
31763,56593,136,0,0,0,0,.00nan,0,0
31763,57299,144,70,46,5,41,.891,3651000,0
31763,78015,136,58,34,4,30,.882,3651000,0
31765,40171,137,0,0,0,0,.00nan,0,0
31765,42349,133,77,42,4,38,.905,3600000,0
31765,55627,137,83,28,1,27,.964,3600000,0
31765,57354,133,0,0,0,0,.00nan,0,0
31767,54514,138,82,24,1,23,.958,3900000,0
31767,63513,138,0,0,0,0,.00nan,0,0
31767,79197,128,0,0,0,0,.00nan,0,0
31767,83112,128,82,33,1,32,.970,3900000,0
31769,54514,138,60,20,2,18,.900,3600000,0
31769,63513,138,0,0,0,0,.00nan,0,0
31769,79197,128,48,8,1,7,.875,621000,0
31769,83112,128,31,37,6,31,.838,2979000,0
31771,5675,140,0,0,0,0,.00nan,0,0
31771,55745,144,0,0,0,0,.00nan,0,0
31771,55871,140,77,23,1,22,.957,3600000,0
31771,57299,144,76,34,3,31,.912,3591000,0
31773,56443,130,42,27,5,22,.815,3600000,0
31773,56593,136,19,10,4,6,.600,682000,0
31773,57763,130,0,0,0,0,.00nan,0,0
31773,78015,136,64,31,3,28,.903,2831000,0
31775,4635,143,26,26,6,20,.769,2332000,0
31775,42349,133,46,45,7,38,.844,3789000,0
31775,57310,143,57,5,0,5,1000,1404000,0
31775,57354,133,0,0,0,0,.00nan,0,0
31777,42208,131,37,33,6,27,.818,3600000,0
31777,55569,131,0,0,0,0,.00nan,0,0
31777,55819,129,33,11,3,8,.727,420000,0
31777,79056,129,42,33,6,27,.818,3180000,0
31779,42270,141,39,27,5,22,.815,2253000,0
31779,55527,135,61,32,4,28,.875,3600000,0
31779,55945,141,42,13,2,11,.846,1347000,0
31779,139220,135,0,0,0,0,.00nan,0,0
31781,42196,132,0,0,0,0,.00nan,0,0
31781,55850,1340,92,32,1,31,.969,3600000,0
31781,55894,132,54,24,4,20,.833,3600000,0
31781,57454,1340,0,0,0,0,.00nan,0,0
31783,40171,137,0,0,0,0,.00nan,0,0
31783,55627,137,69,28,3,25,.893,3600000,0
31783,68954,139,28,22,5,17,.773,3518000,0
31783,79812,139,0,0,0,0,.00nan,0,0
31785,20182,134,0,0,0,0,.00nan,0,0
31785,55608,142,85,36,2,34,.944,3641000,0
31785,55736,134,71,32,3,29,.906,3641000,0
31785,79819,142,0,0,0,0,.00nan,0,0
31787,42349,133,0,0,0,0,.00nan,0,0
31787,55819,129,75,31,3,28,.903,3600000,0
31787,57354,133,58,35,4,31,.886,3600000,0
31787,79056,129,0,0,0,0,.00nan,0,0
31789,42196,132,52,42,6,36,.857,3581000,0
31789,55894,132,0,0,0,0,.00nan,0,0
31789,68954,139,0,0,0,0,.00nan,0,0
31789,79812,139,40,27,5,22,.815,3600000,0
31791,42208,131,0,0,0,0,.00nan,0,0
31791,55569,131,77,32,3,29,.906,3900000,0
31791,55850,1340,0,0,0,0,.00nan,0,0
31791,57454,1340,69,36,3,33,.917,3900000,0
31793,4635,143,0,0,0,0,.00nan,0,0
31793,57310,143,78,26,1,25,.962,3600000,0
31793,79197,128,63,28,3,25,.893,3547000,0
31793,83112,128,0,0,0,0,.00nan,0,0
31795,40171,137,88,40,2,38,.950,3600000,0
31795,55627,137,0,0,0,0,.00nan,0,0
31795,56443,130,0,0,0,0,.00nan,0,0
31795,57763,130,88,34,1,33,.971,3600000,0
31797,20182,134,18,30,7,23,.767,3072000,0
31797,55608,142,0,0,0,0,.00nan,0,0
31797,55736,134,56,7,0,7,1000,528000,0
31797,79819,142,80,31,3,28,.903,3600000,0
31799,54514,138,0,0,0,0,.00nan,0,0
31799,56593,136,51,43,6,37,.860,3220000,0
31799,63513,138,67,26,3,23,.885,3600000,0
31799,78015,136,50,1,0,1,1000,380000,0
31801,42270,141,54,32,4,28,.875,3600000,0
31801,55527,135,0,0,0,0,.00nan,0,0
31801,55945,141,0,0,0,0,.00nan,0,0
31801,139220,135,63,44,5,39,.886,3600000,0
31803,5675,140,55,26,3,23,.885,3600000,0
31803,55745,144,25,21,5,16,.762,2353000,0
31803,55871,140,0,0,0,0,.00nan,0,0
31803,57299,144,54,10,1,9,.900,1247000,0
31805,42196,132,78,22,1,21,.955,3900000,0
31805,55608,142,83,24,1,23,.958,3900000,0
31805,55894,132,0,0,0,0,.00nan,0,0
31805,79819,142,0,0,0,0,.00nan,0,0
31807,4635,143,78,30,2,28,.933,3600000,0
31807,56593,136,0,0,0,0,.00nan,0,0
31807,57310,143,0,0,0,0,.00nan,0,0
31807,78015,136,64,31,3,28,.903,3600000,0
31809,42270,141,72,31,2,29,.935,3600000,0
31809,55819,129,59,42,5,37,.881,3600000,0
31809,55945,141,0,0,0,0,.00nan,0,0
31809,79056,129,0,0,0,0,.00nan,0,0
31811,40171,137,0,0,0,0,.00nan,0,0
31811,55627,137,64,29,3,26,.897,3600000,0
31811,55745,144,0,0,0,0,.00nan,0,0
31811,57299,144,45,31,5,26,.839,3599000,0
31813,5675,140,0,0,0,0,.00nan,0,0
31813,42208,131,63,21,2,19,.905,3600000,0
31813,55569,131,0,0,0,0,.00nan,0,0
31813,55871,140,68,37,4,33,.892,3528000,0
31815,55527,135,47,18,3,15,.833,3600000,0
31815,68954,139,55,38,5,33,.868,3586000,0
31815,79812,139,0,0,0,0,.00nan,0,0
31815,139220,135,0,0,0,0,.00nan,0,0
31817,55850,1340,19,20,6,14,.700,2134000,0
31817,56443,130,88,15,0,15,1000,3600000,0
31817,57454,1340,97,30,0,30,1000,1466000,0
31817,57763,130,0,0,0,0,.00nan,0,0
31819,42349,133,0,0,0,0,.00nan,0,0
31819,57354,133,96,30,1,29,.967,3600000,0
31819,79197,128,0,0,0,0,.00nan,0,0
31819,83112,128,69,35,3,32,.914,3578000,0
31821,20182,134,0,0,0,0,.00nan,0,0
31821,54514,138,84,35,2,33,.943,3546000,0
31821,55736,134,95,23,0,23,1000,3600000,0
31821,63513,138,0,0,0,0,.00nan,0,0
31823,5675,140,56,39,5,34,.872,3900000,0
31823,55527,135,0,0,0,0,.00nan,0,0
31823,55871,140,0,0,0,0,.00nan,0,0
31823,139220,135,46,30,5,25,.833,3900000,0
31825,42208,131,0,0,0,0,.00nan,0,0
31825,55569,131,79,23,1,22,.957,3600000,0
31825,68954,139,0,0,0,0,.00nan,0,0
31825,79812,139,89,38,2,36,.947,3548000,0
31827,40171,137,44,31,4,27,.871,3600000,0
31827,55627,137,0,0,0,0,.00nan,0,0
31827,55850,1340,85,33,1,32,.970,3600000,0
31827,57454,1340,0,0,0,0,.00nan,0,0
31829,54514,138,0,0,0,0,.00nan,0,0
31829,55745,144,79,36,2,34,.944,3600000,0
31829,57299,144,0,0,0,0,.00nan,0,0
31829,63513,138,71,34,4,30,.882,3514000,0
31831,20182,134,0,0,0,0,.00nan,0,0
31831,55736,134,91,32,2,30,.938,3900000,0
31831,55819,129,0,0,0,0,.00nan,0,0
31831,79056,129,74,35,2,33,.943,3900000,0
31833,4635,143,0,0,0,0,.00nan,0,0
31833,42196,132,0,0,0,0,.00nan,0,0
31833,55894,132,75,31,2,29,.935,3544000,0
31833,57310,143,79,23,1,22,.957,3600000,0
31835,56443,130,82,26,1,25,.962,3600000,0
31835,56593,136,92,54,3,51,.944,3534000,0
31835,57763,130,0,0,0,0,.00nan,0,0
31835,78015,136,0,0,0,0,.00nan,0,0
31837,55608,142,0,0,0,0,.00nan,0,0
31837,79197,128,61,40,4,36,.900,3547000,0
31837,79819,142,67,28,2,26,.929,3600000,0
31837,83112,128,0,0,0,0,.00nan,0,0
31839,42270,141,0,0,0,0,.00nan,0,0
31839,42349,133,88,47,3,44,.936,3600000,0
31839,55945,141,76,20,1,19,.950,3600000,0
31839,57354,133,0,0,0,0,.00nan,0,0
31840,41884,2620,65,29,3,26,.897,3900000,0
31840,45054,231,88,37,3,34,.919,3900000,0
31840,50372,231,0,0,0,0,.00nan,0,0
31840,58682,2620,0,0,0,0,.00nan,0,0
31841,43589,176,0,0,0,0,.00nan,0,0
31841,45665,180,0,0,0,0,.00nan,0,0
31841,58410,176,82,37,3,34,.919,3900000,0
31841,60584,180,83,38,3,35,.921,3900000,0
31842,8448,204,32,30,6,24,.800,3600000,0
31842,33008,204,0,0,0,0,.00nan,0,0
31842,37691,229,75,33,3,30,.909,3600000,0
31842,54127,229,0,0,0,0,.00nan,0,0
31843,29935,213,0,0,0,0,.00nan,0,0
31843,34574,178,64,20,2,18,.900,3781000,0
31843,66667,213,93,48,3,45,.938,3781000,0
31843,78525,178,0,0,0,0,.00nan,0,0
31844,37974,212,0,0,0,0,.00nan,0,0
31844,42595,212,54,23,3,20,.870,3600000,0
31844,59231,232,100,45,1,44,.978,3600000,0
31844,77251,232,0,0,0,0,.00nan,0,0
31845,33418,226,57,34,4,30,.882,3630000,0
31845,34756,226,0,0,0,0,.00nan,0,0
31845,36100,206,55,24,3,21,.875,3630000,0
31845,63862,206,0,0,0,0,.00nan,0,0
31846,40174,183,0,0,0,0,.00nan,0,0
31846,48932,183,91,41,4,37,.902,3600000,0
31846,64580,215,69,7,0,7,1000,3600000,0
31846,65223,215,0,0,0,0,.00nan,0,0
31847,44929,214,69,19,1,18,.947,3600000,0
31847,52598,4959,0,0,0,0,.00nan,0,0
31847,55624,214,0,0,0,0,.00nan,0,0
31847,56185,4959,95,42,2,40,.952,3563000,0
31848,7213,208,0,0,0,0,.00nan,0,0
31848,47063,208,64,28,3,25,.893,3900000,0
31848,53385,209,68,34,3,31,.912,3900000,0
31848,63752,209,0,0,0,0,.00nan,0,0
31849,34128,186,0,0,0,0,.00nan,0,0
31849,38669,210,72,27,2,25,.926,3600000,0
31849,60471,210,0,0,0,0,.00nan,0,0
31849,67868,186,49,31,5,26,.839,3600000,0
31850,44452,220,0,0,0,0,.00nan,0,0
31850,50247,227,0,0,0,0,.00nan,0,0
31850,52415,227,68,43,5,38,.884,3600000,0
31850,65261,220,48,18,2,16,.889,3600000,0
31851,2043,222,79,26,1,25,.962,3600000,0
31851,35510,193,0,0,0,0,.00nan,0,0
31851,45629,222,0,0,0,0,.00nan,0,0
31851,63590,193,77,32,2,30,.938,3600000,0
31852,36909,179,65,35,4,31,.886,3600000,0
31852,37964,179,0,0,0,0,.00nan,0,0
31852,38684,218,0,0,0,0,.00nan,0,0
31852,44933,218,50,24,3,21,.875,3600000,0
31853,5034,199,48,40,6,34,.850,3354000,0
31853,42503,199,44,6,1,5,.833,246000,0
31853,44927,190,0,0,0,0,.00nan,0,0
31853,56010,190,80,32,2,30,.938,3600000,0
31854,934,4864,69,37,4,33,.892,3550000,0
31854,18631,217,83,41,3,38,.927,3600000,0
31854,45789,4864,0,0,0,0,.00nan,0,0
31854,54504,217,0,0,0,0,.00nan,0,0
31855,41884,2620,0,0,0,0,.00nan,0,0
31855,45054,231,0,0,0,0,.00nan,0,0
31855,50372,231,77,43,4,39,.907,3566000,0
31855,58682,2620,44,16,3,13,.813,3600000,0
31856,43589,176,0,0,0,0,.00nan,0,0
31856,45665,180,59,17,2,15,.882,3600000,0
31856,58410,176,63,37,4,33,.892,3570000,0
31856,60584,180,0,0,0,0,.00nan,0,0
31857,29935,213,65,38,4,34,.895,3593000,0
31857,34574,178,0,0,0,0,.00nan,0,0
31857,66667,213,0,0,0,0,.00nan,0,0
31857,78525,178,65,33,3,30,.909,3600000,0
31858,33418,226,0,0,0,0,.00nan,0,0
31858,34756,226,100,49,2,47,.959,3900000,0
31858,36100,206,0,0,0,0,.00nan,0,0
31858,63862,206,88,39,2,37,.949,3900000,0
31859,40174,183,49,41,6,35,.854,3600000,0
31859,48932,183,0,0,0,0,.00nan,0,0
31859,64580,215,63,15,1,14,.933,3600000,0
31859,65223,215,0,0,0,0,.00nan,0,0
31860,44929,214,0,0,0,0,.00nan,0,0
31860,52598,4959,26,30,6,24,.800,1895000,0
31860,55624,214,61,26,3,23,.885,3600000,0
31860,56185,4959,73,24,1,23,.958,1705000,0
31861,44452,220,72,22,2,20,.909,3600000,0
31861,50247,227,53,36,6,30,.833,2280000,0
31861,52415,227,65,16,1,15,.938,1320000,0
31861,65261,220,0,0,0,0,.00nan,0,0
31862,36909,179,0,0,0,0,.00nan,0,0
31862,37964,179,77,47,4,43,.915,3600000,0
31862,38684,218,81,25,1,24,.960,3600000,0
31862,44933,218,0,0,0,0,.00nan,0,0
31863,35510,193,78,25,1,24,.960,3600000,0
31863,54105,225,38,32,5,27,.844,3600000,0
31863,56376,225,0,0,0,0,.00nan,0,0
31863,63590,193,0,0,0,0,.00nan,0,0
31864,934,4864,94,33,2,31,.939,3900000,0
31864,18631,217,0,0,0,0,.00nan,0,0
31864,45789,4864,0,0,0,0,.00nan,0,0
31864,54504,217,78,30,2,28,.933,3900000,0
31865,56045,205,0,0,0,0,.00nan,0,0
31865,59231,232,86,29,1,28,.966,3600000,0
31865,77251,232,0,0,0,0,.00nan,0,0
31865,77982,205,76,35,3,32,.914,3600000,0
31866,36909,179,92,53,1,52,.981,3719000,0
31866,37964,179,0,0,0,0,.00nan,0,0
31866,41884,2620,93,23,0,23,1000,3719000,0
31866,58682,2620,0,0,0,0,.00nan,0,0
31867,934,4864,69,39,4,35,.897,3600000,0
31867,37974,212,0,0,0,0,.00nan,0,0
31867,42595,212,30,21,5,16,.762,3561000,0
31867,45789,4864,0,0,0,0,.00nan,0,0
31868,35301,216,65,18,2,16,.889,3600000,0
31868,36994,216,0,0,0,0,.00nan,0,0
31868,43589,176,0,0,0,0,.00nan,0,0
31868,58410,176,59,29,3,26,.897,3588000,0
31869,2043,222,66,38,4,34,.895,3900000,0
31869,45629,222,0,0,0,0,.00nan,0,0
31869,54105,225,70,48,4,44,.917,3900000,0
31869,56376,225,0,0,0,0,.00nan,0,0
31870,9246,181,83,26,1,25,.962,3600000,0
31870,29935,213,0,0,0,0,.00nan,0,0
31870,45733,181,0,0,0,0,.00nan,0,0
31870,66667,213,96,44,3,41,.932,3566000,0
31871,34222,184,0,0,0,0,.00nan,0,0
31871,45725,223,87,39,2,37,.949,3621000,0
31871,55581,184,63,15,1,14,.933,3621000,0
31871,56138,223,0,0,0,0,.00nan,0,0
31872,34144,228,73,34,4,30,.882,3535000,0
31872,35118,219,0,0,0,0,.00nan,0,0
31872,42095,219,70,28,2,26,.929,3600000,0
31872,68192,228,0,0,0,0,.00nan,0,0
31873,42036,182,51,30,5,25,.833,3600000,0
31873,52598,4959,0,0,0,0,.00nan,0,0
31873,56185,4959,84,17,0,17,1000,3600000,0
31873,70585,182,0,0,0,0,.00nan,0,0
31874,45439,191,0,0,0,0,.00nan,0,0
31874,50247,227,51,10,1,9,.900,1600000,0
31874,52415,227,11,18,6,12,.667,2000000,0
31874,59538,191,72,25,2,23,.920,3600000,0
31875,44927,190,0,0,0,0,.00nan,0,0
31875,45701,200,0,0,0,0,.00nan,0,0
31875,56010,190,68,34,4,30,.882,3515000,0
31875,63702,200,82,32,2,30,.938,3600000,0
31876,5034,199,63,35,4,31,.886,3694000,0
31876,42503,199,0,0,0,0,.00nan,0,0
31876,64580,215,81,32,3,29,.906,3694000,0
31876,65223,215,0,0,0,0,.00nan,0,0
31877,38669,210,0,0,0,0,.00nan,0,0
31877,44929,214,78,29,2,27,.931,3600000,0
31877,55624,214,0,0,0,0,.00nan,0,0
31877,60471,210,50,24,4,20,.833,3517000,0
31878,7437,201,0,0,0,0,.00nan,0,0
31878,36908,194,0,0,0,0,.00nan,0,0
31878,41795,201,68,39,5,34,.872,3584000,0
31878,44342,194,49,23,4,19,.826,3600000,0
31879,34128,186,0,0,0,0,.00nan,0,0
31879,34152,224,37,39,6,33,.846,3600000,0
31879,45415,224,0,0,0,0,.00nan,0,0
31879,67868,186,80,13,0,13,1000,3600000,0
31880,6262,198,0,0,0,0,.00nan,0,0
31880,34574,178,83,15,0,15,1000,3600000,0
31880,35266,198,69,46,4,42,.913,3600000,0
31880,78525,178,0,0,0,0,.00nan,0,0
31881,39182,1371,0,0,0,0,.00nan,0,0
31881,52460,211,77,32,3,29,.906,3563000,0
31881,55710,211,0,0,0,0,.00nan,0,0
31881,79637,1371,61,17,2,15,.882,3600000,0
31882,34564,188,60,23,2,21,.913,3600000,0
31882,42148,203,68,44,5,39,.886,3600000,0
31882,45449,203,0,0,0,0,.00nan,0,0
31882,55616,188,0,0,0,0,.00nan,0,0
31883,33418,226,68,34,4,30,.882,3600000,0
31883,34756,226,0,0,0,0,.00nan,0,0
31883,35510,193,0,0,0,0,.00nan,0,0
31883,63590,193,38,26,5,21,.808,3593000,0
31884,7213,208,0,0,0,0,.00nan,0,0
31884,36100,206,46,24,4,20,.833,2159000,0
31884,47063,208,72,24,2,22,.917,3600000,0
31884,63862,206,48,16,3,13,.813,1441000,0
31885,35170,185,0,0,0,0,.00nan,0,0
31885,44452,220,0,0,0,0,.00nan,0,0
31885,55500,185,40,30,5,25,.833,3600000,0
31885,65261,220,100,28,0,28,1000,3600000,0
31886,39182,1371,45,34,5,29,.853,3544000,0
31886,59231,232,71,30,3,27,.900,3600000,0
31886,77251,232,0,0,0,0,.00nan,0,0
31886,79637,1371,0,0,0,0,.00nan,0,0
31887,36909,179,52,41,6,35,.854,2913000,0
31887,37964,179,57,6,0,6,1000,687000,0
31887,41884,2620,12,4,4,0,.000,687000,0
31887,58682,2620,53,26,3,23,.885,2870000,0
31888,934,4864,67,50,6,44,.880,3600000,0
31888,37974,212,79,37,3,34,.919,3600000,0
31888,42595,212,0,0,0,0,.00nan,0,0
31888,45789,4864,0,0,0,0,.00nan,0,0
31889,35301,216,0,0,0,0,.00nan,0,0
31889,36994,216,71,23,2,21,.913,3733000,0
31889,43589,176,0,0,0,0,.00nan,0,0
31889,58410,176,74,35,3,32,.914,3740000,0
31890,2043,222,0,0,0,0,.00nan,0,0
31890,45629,222,100,27,0,27,1000,3600000,0
31890,54105,225,0,0,0,0,.00nan,0,0
31890,56376,225,85,27,1,26,.963,3600000,0
31891,34222,184,0,0,0,0,.00nan,0,0
31891,45725,223,0,0,0,0,.00nan,0,0
31891,55581,184,100,26,0,26,1000,3600000,0
31891,56138,223,81,34,2,32,.941,3600000,0
31892,34144,228,0,0,0,0,.00nan,0,0
31892,35118,219,75,19,1,18,.947,3600000,0
31892,42095,219,0,0,0,0,.00nan,0,0
31892,68192,228,51,37,5,32,.865,3600000,0
31893,42036,182,0,0,0,0,.00nan,0,0
31893,52598,4959,0,0,0,0,.00nan,0,0
31893,56185,4959,57,20,2,18,.900,3600000,0
31893,70585,182,99,63,1,62,.984,3600000,0
31894,52460,211,88,36,1,35,.972,3600000,0
31894,55710,211,0,0,0,0,.00nan,0,0
31894,56045,205,61,30,3,27,.900,3529000,0
31894,77982,205,0,0,0,0,.00nan,0,0
31895,45054,231,0,0,0,0,.00nan,0,0
31895,50372,231,87,42,3,39,.929,3557000,0
31895,55582,207,76,25,2,23,.920,3600000,0
31895,55702,207,0,0,0,0,.00nan,0,0
31896,45439,191,75,31,3,28,.903,3600000,0
31896,50247,227,0,0,0,0,.00nan,0,0
31896,52415,227,54,29,4,25,.862,3545000,0
31896,59538,191,0,0,0,0,.00nan,0,0
31897,5034,199,0,0,0,0,.00nan,0,0
31897,42503,199,65,35,4,31,.886,3600000,0
31897,64580,215,54,36,5,31,.861,3553000,0
31897,65223,215,0,0,0,0,.00nan,0,0
31898,9246,181,0,0,0,0,.00nan,0,0
31898,29935,213,68,44,4,40,.909,3600000,0
31898,45733,181,84,13,0,13,1000,3600000,0
31898,66667,213,0,0,0,0,.00nan,0,0
31899,38669,210,93,41,2,39,.951,3593000,0
31899,44929,214,0,0,0,0,.00nan,0,0
31899,55624,214,100,38,1,37,.974,3600000,0
31899,60471,210,0,0,0,0,.00nan,0,0
31900,7437,201,66,34,3,31,.912,3900000,0
31900,41795,201,0,0,0,0,.00nan,0,0
31900,44927,190,62,28,3,25,.893,3900000,0
31900,56010,190,0,0,0,0,.00nan,0,0
31901,34128,186,0,0,0,0,.00nan,0,0
31901,34152,224,0,0,0,0,.00nan,0,0
31901,45415,224,73,31,3,28,.903,3600000,0
31901,67868,186,34,26,5,21,.808,3511000,0
31902,6262,198,83,41,4,37,.902,3600000,0
31902,34574,178,63,17,1,16,.941,3600000,0
31902,35266,198,0,0,0,0,.00nan,0,0
31902,78525,178,0,0,0,0,.00nan,0,0
31903,34134,202,78,41,4,37,.902,3566000,0
31903,39190,221,79,28,2,26,.929,3600000,0
31903,39398,202,0,0,0,0,.00nan,0,0
31903,44366,221,0,0,0,0,.00nan,0,0
31904,36908,194,0,0,0,0,.00nan,0,0
31904,44342,194,47,38,5,33,.868,3600000,0
31904,44927,190,0,0,0,0,.00nan,0,0
31904,56010,190,73,29,2,27,.931,3600000,0
31905,33418,226,0,0,0,0,.00nan,0,0
31905,34756,226,81,33,2,31,.939,3600000,0
31905,35510,193,68,32,3,29,.906,3587000,0
31905,63590,193,0,0,0,0,.00nan,0,0
31906,7213,208,86,34,2,32,.941,3600000,0
31906,36100,206,69,32,3,29,.906,3570000,0
31906,47063,208,0,0,0,0,.00nan,0,0
31906,63862,206,0,0,0,0,.00nan,0,0
31907,35170,185,10,17,6,11,.647,1807000,0
31907,44452,220,0,0,0,0,.00nan,0,0
31907,55500,185,73,21,1,20,.952,1793000,0
31907,65261,220,86,14,0,14,1000,3600000,0
31908,34564,188,0,0,0,0,.00nan,0,0
31908,53385,209,39,26,4,22,.846,3578000,0
31908,55616,188,73,30,2,28,.933,3600000,0
31908,63752,209,0,0,0,0,.00nan,0,0
31909,35510,193,49,19,3,16,.842,3600000,0
31909,37691,229,59,36,4,32,.889,3558000,0
31909,54127,229,0,0,0,0,.00nan,0,0
31909,63590,193,0,0,0,0,.00nan,0,0
31910,18631,217,60,21,2,19,.905,3600000,0
31910,29935,213,0,0,0,0,.00nan,0,0
31910,54504,217,0,0,0,0,.00nan,0,0
31910,66667,213,78,61,7,54,.885,3600000,0
31911,34134,202,85,37,2,35,.946,3900000,0
31911,36908,194,0,0,0,0,.00nan,0,0
31911,39398,202,0,0,0,0,.00nan,0,0
31911,44342,194,74,29,2,27,.931,3900000,0
31912,5034,199,0,0,0,0,.00nan,0,0
31912,9246,181,0,0,0,0,.00nan,0,0
31912,42503,199,80,37,5,32,.865,3659000,0
31912,45733,181,55,28,4,24,.857,3659000,0
31913,34222,184,0,0,0,0,.00nan,0,0
31913,50247,227,0,0,0,0,.00nan,0,0
31913,52415,227,69,29,3,26,.897,3600000,0
31913,55581,184,77,40,4,36,.900,3600000,0
31914,39117,177,72,39,4,35,.897,3600000,0
31914,41884,2620,78,22,1,21,.955,3600000,0
31914,58682,2620,0,0,0,0,.00nan,0,0
31914,76131,177,0,0,0,0,.00nan,0,0
31915,34144,228,29,28,7,21,.750,3600000,0
31915,39190,221,82,24,1,23,.958,3600000,0
31915,44366,221,0,0,0,0,.00nan,0,0
31915,68192,228,0,0,0,0,.00nan,0,0
31916,52598,4959,100,28,0,28,1000,3600000,0
31916,56185,4959,0,0,0,0,.00nan,0,0
31916,59231,232,81,27,1,26,.963,3560000,0
31916,77251,232,0,0,0,0,.00nan,0,0
31917,34152,224,79,29,2,27,.931,3600000,0
31917,45054,231,0,0,0,0,.00nan,0,0
31917,45415,224,0,0,0,0,.00nan,0,0
31917,50372,231,61,35,4,31,.886,3582000,0
31918,8448,204,51,27,3,24,.889,3890000,0
31918,33008,204,0,0,0,0,.00nan,0,0
31918,42036,182,98,53,3,50,.943,3900000,0
31918,70585,182,0,0,0,0,.00nan,0,0
31919,40174,183,35,14,3,11,.786,1581000,0
31919,45725,223,0,0,0,0,.00nan,0,0
31919,48932,183,41,22,5,17,.773,2019000,0
31919,56138,223,58,33,4,29,.879,3600000,0
31920,6262,198,0,0,0,0,.00nan,0,0
31920,35266,198,87,31,1,30,.968,3600000,0
31920,43589,176,0,0,0,0,.00nan,0,0
31920,58410,176,98,23,0,23,1000,3600000,0
31921,37974,212,0,0,0,0,.00nan,0,0
31921,42595,212,55,32,4,28,.875,3521000,0
31921,44927,190,0,0,0,0,.00nan,0,0
31921,56010,190,68,26,2,24,.923,3600000,0
31922,52460,211,23,29,7,22,.759,3079000,0
31922,55582,207,48,26,4,22,.846,3600000,0
31922,55702,207,0,0,0,0,.00nan,0,0
31922,55710,211,37,8,2,6,.750,521000,0
31923,45439,191,65,31,4,27,.871,3561000,0
31923,53385,209,68,38,3,35,.921,3600000,0
31923,59538,191,0,0,0,0,.00nan,0,0
31923,63752,209,0,0,0,0,.00nan,0,0
31924,5034,199,75,27,2,25,.926,3600000,0
31924,9246,181,55,29,3,26,.897,3600000,0
31924,42503,199,0,0,0,0,.00nan,0,0
31924,45733,181,0,0,0,0,.00nan,0,0
31925,39117,177,71,36,2,34,.944,3560000,0
31925,41884,2620,0,0,0,0,.00nan,0,0
31925,58682,2620,96,35,1,34,.971,3600000,0
31925,76131,177,0,0,0,0,.00nan,0,0
31926,38669,210,99,45,2,43,.956,3600000,0
31926,45665,180,0,0,0,0,.00nan,0,0
31926,60471,210,0,0,0,0,.00nan,0,0
31926,60584,180,27,23,5,18,.783,3600000,0
31927,34574,178,93,39,1,38,.974,3600000,0
31927,39182,1371,64,28,3,25,.893,3546000,0
31927,78525,178,0,0,0,0,.00nan,0,0
31927,79637,1371,0,0,0,0,.00nan,0,0
31928,33418,226,47,38,6,32,.842,2643000,0
31928,34756,226,21,11,4,7,.636,957000,0
31928,44452,220,0,0,0,0,.00nan,0,0
31928,65261,220,46,23,4,19,.826,3600000,0
31929,34128,186,0,0,0,0,.00nan,0,0
31929,60371,4949,39,21,4,17,.810,1061000,0
31929,64187,4949,72,30,2,28,.933,2539000,0
31929,67868,186,56,15,2,13,.867,3600000,0
31930,34222,184,66,26,2,24,.923,3600000,0
31930,50247,227,69,34,3,31,.912,3600000,0
31930,52415,227,0,0,0,0,.00nan,0,0
31930,55581,184,0,0,0,0,.00nan,0,0
31931,34564,188,67,18,1,17,.944,3600000,0
31931,35118,219,77,44,3,41,.932,3600000,0
31931,42095,219,0,0,0,0,.00nan,0,0
31931,55616,188,0,0,0,0,.00nan,0,0
31932,34144,228,63,26,2,24,.923,3554000,0
31932,39190,221,0,0,0,0,.00nan,0,0
31932,44366,221,82,23,1,22,.957,3600000,0
31932,68192,228,0,0,0,0,.00nan,0,0
31933,35170,185,19,12,4,8,.667,1091000,0
31933,38684,218,0,0,0,0,.00nan,0,0
31933,44933,218,66,30,3,27,.900,3600000,0
31933,55500,185,53,16,2,14,.875,2509000,0
31934,18631,217,0,0,0,0,.00nan,0,0
31934,29935,213,77,39,3,36,.923,3600000,0
31934,54504,217,56,21,2,19,.905,3600000,0
31934,66667,213,0,0,0,0,.00nan,0,0
31935,52598,4959,0,0,0,0,.00nan,0,0
31935,56185,4959,74,36,2,34,.944,3823000,0
31935,59231,232,0,0,0,0,.00nan,0,0
31935,77251,232,72,34,3,31,.912,3823000,0
31936,34152,224,62,34,4,30,.882,3578000,0
31936,45054,231,69,30,3,27,.900,3600000,0
31936,45415,224,0,0,0,0,.00nan,0,0
31936,50372,231,0,0,0,0,.00nan,0,0
31937,45439,191,59,9,0,9,1000,1673000,0
31937,54105,225,69,36,3,33,.917,3600000,0
31937,56376,225,0,0,0,0,.00nan,0,0
31937,59538,191,18,9,4,5,.556,1868000,0
31938,7437,201,0,0,0,0,.00nan,0,0
31938,41795,201,74,35,3,32,.914,3600000,0
31938,42148,203,89,18,0,18,1000,3600000,0
31938,45449,203,0,0,0,0,.00nan,0,0
31939,40174,183,0,0,0,0,.00nan,0,0
31939,45725,223,87,30,1,29,.967,3600000,0
31939,48932,183,75,31,2,29,.935,3543000,0
31939,56138,223,0,0,0,0,.00nan,0,0
31940,6262,198,51,24,3,21,.875,3566000,0
31940,35266,198,0,0,0,0,.00nan,0,0
31940,43589,176,0,0,0,0,.00nan,0,0
31940,58410,176,89,31,1,30,.968,3600000,0
31941,37974,212,49,30,4,26,.867,3600000,0
31941,42595,212,0,0,0,0,.00nan,0,0
31941,44927,190,69,45,5,40,.889,3547000,0
31941,56010,190,0,0,0,0,.00nan,0,0
31942,52460,211,100,41,0,41,1000,3600000,0
31942,55582,207,0,0,0,0,.00nan,0,0
31942,55702,207,34,27,5,22,.815,3600000,0
31942,55710,211,0,0,0,0,.00nan,0,0
31943,37691,229,57,21,2,19,.905,3600000,0
31943,54127,229,0,0,0,0,.00nan,0,0
31943,56045,205,73,34,3,31,.912,3581000,0
31943,77982,205,0,0,0,0,.00nan,0,0
31944,38669,210,0,0,0,0,.00nan,0,0
31944,45665,180,43,28,4,24,.857,3600000,0
31944,60471,210,42,30,5,25,.833,3600000,0
31944,60584,180,0,0,0,0,.00nan,0,0
31945,33418,226,0,0,0,0,.00nan,0,0
31945,34756,226,64,28,3,25,.893,3569000,0
31945,44452,220,80,38,2,36,.947,3600000,0
31945,65261,220,0,0,0,0,.00nan,0,0
31946,34128,186,92,16,0,16,1000,3600000,0
31946,60371,4949,80,40,3,37,.925,3600000,0
31946,64187,4949,0,0,0,0,.00nan,0,0
31946,67868,186,0,0,0,0,.00nan,0,0
31947,7213,208,0,0,0,0,.00nan,0,0
31947,34134,202,91,32,2,30,.938,3600000,0
31947,39398,202,0,0,0,0,.00nan,0,0
31947,47063,208,67,33,4,29,.879,3555000,0
31948,34564,188,0,0,0,0,.00nan,0,0
31948,35118,219,0,0,0,0,.00nan,0,0
31948,42095,219,45,31,5,26,.839,3600000,0
31948,55616,188,70,24,1,23,.958,3600000,0
31949,35170,185,66,38,3,35,.921,3900000,0
31949,38684,218,75,35,3,32,.914,3900000,0
31949,44933,218,0,0,0,0,.00nan,0,0
31949,55500,185,0,0,0,0,.00nan,0,0
31950,2043,222,0,0,0,0,.00nan,0,0
31950,35510,193,0,0,0,0,.00nan,0,0
31950,45629,222,73,39,4,35,.897,3572000,0
31950,63590,193,86,39,2,37,.949,3600000,0
31951,8448,204,0,0,0,0,.00nan,0,0
31951,33008,204,68,16,2,14,.875,3900000,0
31951,42036,182,100,46,2,44,.957,3900000,0
31951,70585,182,0,0,0,0,.00nan,0,0
31952,34574,178,47,33,6,27,.818,2743000,0
31952,39182,1371,72,27,2,25,.926,3600000,0
31952,78525,178,59,6,0,6,1000,857000,0
31952,79637,1371,0,0,0,0,.00nan,0,0
31953,7213,208,0,0,0,0,.00nan,0,0
31953,42148,203,59,31,4,27,.871,3600000,0
31953,45449,203,0,0,0,0,.00nan,0,0
31953,47063,208,77,22,1,21,.955,3600000,0
31954,34144,228,48,22,3,19,.864,3600000,0
31954,45054,231,40,18,3,15,.833,2439000,0
31954,50372,231,26,13,4,9,.692,1161000,0
31954,68192,228,0,0,0,0,.00nan,0,0
31955,7437,201,0,0,0,0,.00nan,0,0
31955,41795,201,83,42,4,38,.905,3600000,0
31955,45701,200,0,0,0,0,.00nan,0,0
31955,63702,200,91,20,0,20,1000,3600000,0
31956,45439,191,46,27,4,23,.852,3582000,0
31956,45725,223,39,18,3,15,.833,3600000,0
31956,56138,223,0,0,0,0,.00nan,0,0
31956,59538,191,0,0,0,0,.00nan,0,0
31957,37691,229,94,36,1,35,.972,3554000,0
31957,44452,220,0,0,0,0,.00nan,0,0
31957,54127,229,0,0,0,0,.00nan,0,0
31957,65261,220,89,18,0,18,1000,3600000,0
31958,2043,222,85,37,2,35,.946,3900000,0
31958,45629,222,0,0,0,0,.00nan,0,0
31958,59231,232,80,35,2,33,.943,3900000,0
31958,77251,232,0,0,0,0,.00nan,0,0
31959,34128,186,0,0,0,0,.00nan,0,0
31959,41884,2620,59,42,5,37,.881,3600000,0
31959,58682,2620,0,0,0,0,.00nan,0,0
31959,67868,186,62,22,2,20,.909,3600000,0
31960,934,4864,88,39,3,36,.923,3600000,0
31960,34574,178,50,32,4,28,.875,3600000,0
31960,45789,4864,0,0,0,0,.00nan,0,0
31960,78525,178,0,0,0,0,.00nan,0,0
31961,7437,201,0,0,0,0,.00nan,0,0
31961,41795,201,88,37,3,34,.919,3600000,0
31961,54105,225,23,4,3,1,.250,554000,0
31961,56376,225,84,31,1,30,.968,3006000,0
31962,35301,216,96,37,1,36,.973,3627000,0
31962,36994,216,0,0,0,0,.00nan,0,0
31962,39117,177,70,29,2,27,.931,3627000,0
31962,76131,177,0,0,0,0,.00nan,0,0
31963,37691,229,0,0,0,0,.00nan,0,0
31963,44452,220,0,0,0,0,.00nan,0,0
31963,54127,229,82,34,3,31,.912,3600000,0
31963,65261,220,32,40,7,33,.825,3600000,0
31964,6262,198,0,0,0,0,.00nan,0,0
31964,35266,198,68,40,4,36,.900,3600000,0
31964,45701,200,0,0,0,0,.00nan,0,0
31964,63702,200,75,17,1,16,.941,3600000,0
31965,37974,212,0,0,0,0,.00nan,0,0
31965,42595,212,72,26,2,24,.923,3600000,0
31965,43589,176,0,0,0,0,.00nan,0,0
31965,58410,176,72,37,3,34,.919,3600000,0
31966,8448,204,59,42,4,38,.905,3816000,0
31966,33008,204,0,0,0,0,.00nan,0,0
31966,33418,226,54,32,5,27,.844,3816000,0
31966,34756,226,0,0,0,0,.00nan,0,0
31967,9246,181,90,22,0,22,1000,3600000,0
31967,45733,181,0,0,0,0,.00nan,0,0
31967,53385,209,97,42,2,40,.952,3600000,0
31967,63752,209,0,0,0,0,.00nan,0,0
31968,36908,194,0,0,0,0,.00nan,0,0
31968,44342,194,94,22,0,22,1000,3600000,0
31968,50247,227,0,0,0,0,.00nan,0,0
31968,52415,227,69,27,3,24,.889,3600000,0
31969,45725,223,0,0,0,0,.00nan,0,0
31969,56138,223,67,37,4,33,.892,3600000,0
31969,64580,215,78,27,1,26,.963,3600000,0
31969,65223,215,0,0,0,0,.00nan,0,0
31970,42036,182,71,33,3,30,.909,3600000,0
31970,60371,4949,88,18,0,18,1000,3600000,0
31970,64187,4949,0,0,0,0,.00nan,0,0
31970,70585,182,0,0,0,0,.00nan,0,0
31971,38669,210,69,33,3,30,.909,3548000,0
31971,38684,218,0,0,0,0,.00nan,0,0
31971,44933,218,83,26,1,25,.962,3600000,0
31971,60471,210,0,0,0,0,.00nan,0,0
31972,35118,219,49,33,5,28,.848,2293000,0
31972,42095,219,60,14,1,13,.929,1307000,0
31972,44929,214,41,26,5,21,.808,3600000,0
31972,55624,214,0,0,0,0,.00nan,0,0
31973,34134,202,73,18,1,17,.944,3600000,0
31973,39398,202,0,0,0,0,.00nan,0,0
31973,52460,211,71,40,4,36,.900,3600000,0
31973,55710,211,0,0,0,0,.00nan,0,0
31974,2043,222,0,0,0,0,.00nan,0,0
31974,45629,222,45,42,6,36,.857,3514000,0
31974,59231,232,48,32,4,28,.875,3600000,0
31974,77251,232,0,0,0,0,.00nan,0,0
31975,34152,224,17,34,8,26,.765,2980000,0
31975,39190,221,79,22,1,21,.955,3600000,0
31975,44366,221,0,0,0,0,.00nan,0,0
31975,45415,224,56,10,1,9,.900,620000,0
31976,34222,184,0,0,0,0,.00nan,0,0
31976,36909,179,71,24,2,22,.917,3900000,0
31976,37964,179,0,0,0,0,.00nan,0,0
31976,55581,184,93,35,2,33,.943,3900000,0
31977,35510,193,42,34,6,28,.824,2514000,0
31977,55582,207,89,18,0,18,1000,3600000,0
31977,55702,207,0,0,0,0,.00nan,0,0
31977,63590,193,59,9,0,9,1000,1086000,0
31978,18631,217,95,40,1,39,.975,3830000,0
31978,39182,1371,74,30,2,28,.933,3830000,0
31978,54504,217,0,0,0,0,.00nan,0,0
31978,79637,1371,0,0,0,0,.00nan,0,0
31979,35170,185,0,0,0,0,.00nan,0,0
31979,45665,180,0,0,0,0,.00nan,0,0
31979,55500,185,95,34,2,32,.941,3600000,0
31979,60584,180,47,32,4,28,.875,3575000,0
31980,934,4864,34,15,4,11,.733,776000,0
31980,34574,178,37,26,5,21,.808,3600000,0
31980,45789,4864,53,21,2,19,.905,2796000,0
31980,78525,178,0,0,0,0,.00nan,0,0
31981,35301,216,0,0,0,0,.00nan,0,0
31981,36994,216,100,35,0,35,1000,3600000,0
31981,39117,177,61,21,2,19,.905,3563000,0
31981,76131,177,0,0,0,0,.00nan,0,0
31982,6262,198,85,24,1,23,.958,3600000,0
31982,35266,198,0,0,0,0,.00nan,0,0
31982,45701,200,0,0,0,0,.00nan,0,0
31982,63702,200,95,38,2,36,.947,3600000,0
31983,37974,212,71,20,1,19,.950,3600000,0
31983,42595,212,0,0,0,0,.00nan,0,0
31983,43589,176,0,0,0,0,.00nan,0,0
31983,58410,176,73,32,2,30,.938,3581000,0
31984,8448,204,66,41,4,37,.902,3809000,0
31984,33008,204,0,0,0,0,.00nan,0,0
31984,33418,226,0,0,0,0,.00nan,0,0
31984,34756,226,50,20,3,17,.850,3809000,0
31985,34144,228,55,43,6,37,.860,2895000,0
31985,36100,206,67,33,3,30,.909,3600000,0
31985,63862,206,0,0,0,0,.00nan,0,0
31985,68192,228,42,10,2,8,.800,705000,0
31986,45054,231,0,0,0,0,.00nan,0,0
31986,50372,231,24,21,5,16,.762,3584000,0
31986,52598,4959,77,36,4,32,.889,3600000,0
31986,56185,4959,0,0,0,0,.00nan,0,0
31987,9246,181,47,22,3,19,.864,3544000,0
31987,45733,181,0,0,0,0,.00nan,0,0
31987,53385,209,0,0,0,0,.00nan,0,0
31987,63752,209,79,33,2,31,.939,3600000,0
31988,5034,199,0,0,0,0,.00nan,0,0
31988,7213,208,0,0,0,0,.00nan,0,0
31988,42503,199,84,15,0,15,1000,3600000,0
31988,47063,208,53,26,4,22,.846,3600000,0
31989,36908,194,0,0,0,0,.00nan,0,0
31989,44342,194,81,16,0,16,1000,3600000,0
31989,50247,227,98,55,3,52,.945,3600000,0
31989,52415,227,0,0,0,0,.00nan,0,0
31990,45725,223,93,54,1,53,.981,3600000,0
31990,56138,223,0,0,0,0,.00nan,0,0
31990,64580,215,54,17,2,15,.882,3556000,0
31990,65223,215,0,0,0,0,.00nan,0,0
31991,42036,182,0,0,0,0,.00nan,0,0
31991,60371,4949,0,0,0,0,.00nan,0,0
31991,64187,4949,65,30,2,28,.933,3600000,0
31991,70585,182,36,27,5,22,.815,3600000,0
31992,38669,210,0,0,0,0,.00nan,0,0
31992,38684,218,70,33,3,30,.909,3600000,0
31992,44933,218,0,0,0,0,.00nan,0,0
31992,60471,210,56,35,4,31,.886,3600000,0
31993,35118,219,46,36,6,30,.833,3541000,0
31993,42095,219,0,0,0,0,.00nan,0,0
31993,44929,214,0,0,0,0,.00nan,0,0
31993,55624,214,40,24,4,20,.833,3600000,0
31994,18631,217,0,0,0,0,.00nan,0,0
31994,39182,1371,0,0,0,0,.00nan,0,0
31994,54504,217,65,33,3,30,.909,3600000,0
31994,79637,1371,50,27,4,23,.852,3541000,0
31995,34134,202,0,0,0,0,.00nan,0,0
31995,39398,202,100,46,3,43,.935,3900000,0
31995,52460,211,42,13,3,10,.769,3900000,0
31995,55710,211,0,0,0,0,.00nan,0,0
31996,34564,188,84,25,1,24,.960,3900000,0
31996,55616,188,0,0,0,0,.00nan,0,0
31996,56045,205,97,42,1,41,.976,3900000,0
31996,77982,205,0,0,0,0,.00nan,0,0
31997,34152,224,81,45,4,41,.911,3600000,0
31997,39190,221,0,0,0,0,.00nan,0,0
31997,44366,221,96,19,0,19,1000,3600000,0
31997,45415,224,0,0,0,0,.00nan,0,0
31998,34222,184,0,0,0,0,.00nan,0,0
31998,36909,179,0,0,0,0,.00nan,0,0
31998,37964,179,92,38,2,36,.947,3552000,0
31998,55581,184,100,29,0,29,1000,3600000,0
31999,35510,193,0,0,0,0,.00nan,0,0
31999,55582,207,67,37,4,33,.892,3578000,0
31999,55702,207,0,0,0,0,.00nan,0,0
31999,63590,193,76,32,2,30,.938,3600000,0
32000,35170,185,0,0,0,0,.00nan,0,0
32000,45665,180,33,28,5,23,.821,3825000,0
32000,55500,185,46,27,4,23,.852,3825000,0
32000,60584,180,0,0,0,0,.00nan,0,0
32001,34128,186,0,0,0,0,.00nan,0,0
32001,41884,2620,65,35,4,31,.886,3600000,0
32001,58682,2620,0,0,0,0,.00nan,0,0
32001,67868,186,83,27,1,26,.963,3600000,0
32002,45054,231,58,38,5,33,.868,3567000,0
32002,50372,231,0,0,0,0,.00nan,0,0
32002,52598,4959,0,0,0,0,.00nan,0,0
32002,56185,4959,61,26,3,23,.885,3600000,0
32003,34564,188,0,0,0,0,.00nan,0,0
32003,55616,188,68,20,1,19,.950,3600000,0
32003,56045,205,0,0,0,0,.00nan,0,0
32003,77982,205,77,37,2,35,.946,3572000,0
32860,33418,226,0,0,0,0,.00nan,0,0
32860,34756,226,83,52,4,48,.923,3900000,0
32860,40174,183,0,0,0,0,.00nan,0,0
32860,48932,183,52,35,4,31,.886,3900000,0
32862,34496,192,97,22,0,22,1000,3600000,0
32862,34574,178,53,33,4,29,.879,3600000,0
32862,45670,192,0,0,0,0,.00nan,0,0
32862,78525,178,0,0,0,0,.00nan,0,0
32864,34497,189,76,21,1,20,.952,3600000,0
32864,34564,188,67,28,3,25,.893,3523000,0
32864,37959,189,0,0,0,0,.00nan,0,0
32864,55616,188,0,0,0,0,.00nan,0,0
32866,34152,224,42,34,5,29,.853,3530000,0
32866,45415,224,0,0,0,0,.00nan,0,0
32866,52460,211,60,20,3,17,.850,3600000,0
32866,55710,211,0,0,0,0,.00nan,0,0
32868,43444,196,0,0,0,0,.00nan,0,0
32868,45439,191,0,0,0,0,.00nan,0,0
32868,59538,191,94,42,2,40,.952,3588000,0
32868,67737,196,100,19,0,19,1000,3600000,0
32870,2043,222,92,18,0,18,1000,3600000,0
32870,45629,222,0,0,0,0,.00nan,0,0
32870,60371,4949,27,11,4,7,.636,987000,0
32870,64187,4949,74,29,2,27,.931,2613000,0
32872,45665,180,79,13,0,13,1000,3600000,0
32872,50247,227,55,5,0,5,1000,645000,0
32872,52415,227,55,43,6,37,.860,2955000,0
32872,60584,180,0,0,0,0,.00nan,0,0
32874,35510,193,0,0,0,0,.00nan,0,0
32874,42036,182,90,42,2,40,.952,3559000,0
32874,63590,193,57,10,1,9,.900,3600000,0
32874,70585,182,0,0,0,0,.00nan,0,0
32876,38684,218,0,0,0,0,.00nan,0,0
32876,44933,218,89,21,0,21,1000,3600000,0
32876,54105,225,47,25,4,21,.840,3600000,0
32876,56376,225,0,0,0,0,.00nan,0,0
32878,34144,228,76,30,2,28,.933,3600000,0
32878,45608,197,50,15,3,12,.800,3600000,0
32878,59361,197,0,0,0,0,.00nan,0,0
32878,68192,228,0,0,0,0,.00nan,0,0
32880,9246,181,63,11,1,10,.909,3600000,0
32880,36909,179,94,59,2,57,.966,3600000,0
32880,37964,179,0,0,0,0,.00nan,0,0
32880,45733,181,0,0,0,0,.00nan,0,0
32882,34134,202,0,0,0,0,.00nan,0,0
32882,39398,202,88,31,1,30,.968,3600000,0
32882,44929,214,46,16,3,13,.813,3523000,0
32882,55624,214,0,0,0,0,.00nan,0,0
32884,5034,199,0,0,0,0,.00nan,0,0
32884,7213,208,0,0,0,0,.00nan,0,0
32884,42503,199,57,18,2,16,.889,3600000,0
32884,47063,208,70,37,4,33,.892,3578000,0
32886,45701,200,0,0,0,0,.00nan,0,0
32886,55582,207,56,32,4,28,.875,3600000,0
32886,55702,207,0,0,0,0,.00nan,0,0
32886,63702,200,13,22,6,16,.727,3553000,0
32888,37691,229,85,45,3,42,.933,3900000,0
32888,42148,203,47,19,3,16,.842,3900000,0
32888,45449,203,0,0,0,0,.00nan,0,0
32888,54127,229,0,0,0,0,.00nan,0,0
32890,35118,219,0,0,0,0,.00nan,0,0
32890,35293,187,54,30,4,26,.867,3900000,0
32890,42095,219,60,35,4,31,.886,3900000,0
32890,45482,187,0,0,0,0,.00nan,0,0
32892,7437,201,0,0,0,0,.00nan,0,0
32892,41795,201,62,25,3,22,.880,3600000,0
32892,45054,231,87,46,4,42,.913,3600000,0
32892,50372,231,0,0,0,0,.00nan,0,0
32894,35170,185,0,0,0,0,.00nan,0,0
32894,55500,185,38,21,5,16,.762,3600000,0
32894,56045,205,93,24,0,24,1000,3600000,0
32894,77982,205,0,0,0,0,.00nan,0,0
32896,37974,212,0,0,0,0,.00nan,0,0
32896,42595,212,67,33,3,30,.909,3600000,0
32896,59231,232,42,23,4,19,.826,3600000,0
32896,77251,232,0,0,0,0,.00nan,0,0
32898,29935,213,0,0,0,0,.00nan,0,0
32898,34222,184,0,0,0,0,.00nan,0,0
32898,55581,184,87,16,0,16,1000,3600000,0
32898,66667,213,50,31,4,27,.871,3600000,0
32900,36908,194,0,0,0,0,.00nan,0,0
32900,44342,194,48,26,4,22,.846,3600000,0
32900,53385,209,100,33,0,33,1000,3600000,0
32900,63752,209,0,0,0,0,.00nan,0,0
32902,36100,206,78,17,0,17,1000,3600000,0
32902,43589,176,0,0,0,0,.00nan,0,0
32902,58410,176,94,43,2,41,.953,3525000,0
32902,63862,206,0,0,0,0,.00nan,0,0
32904,39190,221,84,42,2,40,.952,3521000,0
32904,44366,221,0,0,0,0,.00nan,0,0
32904,64580,215,87,15,0,15,1000,3600000,0
32904,65223,215,0,0,0,0,.00nan,0,0
32906,34128,186,0,0,0,0,.00nan,0,0
32906,44927,190,0,0,0,0,.00nan,0,0
32906,56010,190,45,31,5,26,.839,3553000,0
32906,67868,186,59,23,3,20,.870,3600000,0
32908,39182,1371,57,17,2,15,.882,3600000,0
32908,56006,195,45,21,4,17,.810,1180000,0
32908,63601,195,57,40,4,36,.900,2420000,0
32908,79637,1371,0,0,0,0,.00nan,0,0
32910,934,4864,53,17,2,15,.882,3600000,0
32910,45725,223,57,43,6,37,.860,3600000,0
32910,45789,4864,0,0,0,0,.00nan,0,0
32910,56138,223,0,0,0,0,.00nan,0,0
32912,6262,198,0,0,0,0,.00nan,0,0
32912,8448,204,76,26,1,25,.962,3900000,0
32912,33008,204,0,0,0,0,.00nan,0,0
32912,35266,198,100,38,1,37,.974,3900000,0
32914,35301,216,0,0,0,0,.00nan,0,0
32914,36994,216,64,40,4,36,.900,3563000,0
32914,44452,220,0,0,0,0,.00nan,0,0
32914,65261,220,60,30,3,27,.900,3600000,0
32916,41884,2620,100,30,0,30,1000,3600000,0
32916,52598,4959,59,41,5,36,.878,3600000,0
32916,56185,4959,0,0,0,0,.00nan,0,0
32916,58682,2620,0,0,0,0,.00nan,0,0
32918,18631,217,44,32,6,26,.813,3017000,0
32918,39117,177,78,29,2,27,.931,3600000,0
32918,54504,217,67,9,0,9,1000,583000,0
32918,76131,177,0,0,0,0,.00nan,0,0
32920,5034,199,71,29,3,26,.897,3600000,0
32920,42503,199,0,0,0,0,.00nan,0,0
32920,52460,211,0,0,0,0,.00nan,0,0
32920,55710,211,66,47,5,42,.894,3550000,0
32922,36909,179,0,0,0,0,.00nan,0,0
32922,37964,179,94,63,5,58,.921,3600000,0
32922,44929,214,0,0,0,0,.00nan,0,0
32922,55624,214,82,13,0,13,1000,3600000,0
32924,39182,1371,74,21,1,20,.952,3600000,0
32924,52598,4959,0,0,0,0,.00nan,0,0
32924,56185,4959,93,45,2,43,.956,3569000,0
32924,79637,1371,0,0,0,0,.00nan,0,0
32926,45725,223,0,0,0,0,.00nan,0,0
32926,56138,223,28,29,6,23,.793,3600000,0
32926,60371,4949,87,36,1,35,.972,3600000,0
32926,64187,4949,0,0,0,0,.00nan,0,0
32928,18631,217,0,0,0,0,.00nan,0,0
32928,50247,227,49,32,5,27,.844,3569000,0
32928,52415,227,0,0,0,0,.00nan,0,0
32928,54504,217,38,24,4,20,.833,3600000,0
32930,934,4864,0,0,0,0,.00nan,0,0
32930,43444,196,0,0,0,0,.00nan,0,0
32930,45789,4864,51,34,4,30,.882,3585000,0
32930,67737,196,64,27,2,25,.926,3600000,0
32932,7213,208,71,32,3,29,.906,3512000,0
32932,34564,188,0,0,0,0,.00nan,0,0
32932,47063,208,0,0,0,0,.00nan,0,0
32932,55616,188,80,25,1,24,.960,3600000,0
32934,39190,221,0,0,0,0,.00nan,0,0
32934,44366,221,80,35,2,33,.943,3600000,0
32934,59231,232,0,0,0,0,.00nan,0,0
32934,77251,232,21,29,7,22,.759,3600000,0
32936,7437,201,90,40,2,38,.950,3600000,0
32936,34134,202,39,23,4,19,.826,3562000,0
32936,39398,202,0,0,0,0,.00nan,0,0
32936,41795,201,0,0,0,0,.00nan,0,0
32938,33418,226,72,29,2,27,.931,3600000,0
32938,34756,226,0,0,0,0,.00nan,0,0
32938,40174,183,73,41,4,37,.902,3582000,0
32938,48932,183,0,0,0,0,.00nan,0,0
32940,29935,213,78,47,3,44,.936,3600000,0
32940,38669,210,61,16,1,15,.938,3600000,0
32940,60471,210,0,0,0,0,.00nan,0,0
32940,66667,213,0,0,0,0,.00nan,0,0
32942,34152,224,0,0,0,0,.00nan,0,0
32942,34222,184,0,0,0,0,.00nan,0,0
32942,45415,224,61,43,5,38,.884,3813000,0
32942,55581,184,52,26,4,22,.846,3813000,0
32944,6262,198,69,21,1,20,.952,3600000,0
32944,35266,198,0,0,0,0,.00nan,0,0
32944,45439,191,54,31,4,27,.871,3600000,0
32944,59538,191,0,0,0,0,.00nan,0,0
32946,9246,181,0,0,0,0,.00nan,0,0
32946,41884,2620,0,0,0,0,.00nan,0,0
32946,45733,181,62,37,5,32,.865,3900000,0
32946,58682,2620,51,38,5,33,.868,3900000,0
32948,34144,228,63,39,4,35,.897,3600000,0
32948,43589,176,0,0,0,0,.00nan,0,0
32948,58410,176,82,27,1,26,.963,3600000,0
32948,68192,228,0,0,0,0,.00nan,0,0
32950,2043,222,75,44,3,41,.932,3522000,0
32950,44927,190,77,24,1,23,.958,3600000,0
32950,45629,222,0,0,0,0,.00nan,0,0
32950,56010,190,0,0,0,0,.00nan,0,0
32952,8448,204,0,0,0,0,.00nan,0,0
32952,33008,204,49,35,5,30,.857,3600000,0
32952,34574,178,87,17,0,17,1000,3600000,0
32952,78525,178,0,0,0,0,.00nan,0,0
32954,36100,206,59,19,2,17,.895,3581000,0
32954,54105,225,0,0,0,0,.00nan,0,0
32954,56376,225,93,40,1,39,.975,3600000,0
32954,63862,206,0,0,0,0,.00nan,0,0
32956,53385,209,87,45,3,42,.933,3560000,0
32956,55582,207,0,0,0,0,.00nan,0,0
32956,55702,207,71,27,2,25,.926,3600000,0
32956,63752,209,0,0,0,0,.00nan,0,0
32958,34128,186,51,26,3,23,.885,3537000,0
32958,45054,231,0,0,0,0,.00nan,0,0
32958,50372,231,84,33,1,32,.970,3600000,0
32958,67868,186,0,0,0,0,.00nan,0,0
32960,35510,193,20,17,5,12,.706,3600000,0
32960,56045,205,75,56,6,50,.893,3600000,0
32960,63590,193,0,0,0,0,.00nan,0,0
32960,77982,205,0,0,0,0,.00nan,0,0
32962,38684,218,0,0,0,0,.00nan,0,0
32962,44452,220,30,22,5,17,.773,3900000,0
32962,44933,218,87,47,5,42,.894,3900000,0
32962,65261,220,0,0,0,0,.00nan,0,0
32964,35118,219,74,31,2,29,.935,3600000,0
32964,42095,219,0,0,0,0,.00nan,0,0
32964,56006,195,80,29,1,28,.966,3600000,0
32964,63601,195,0,0,0,0,.00nan,0,0
32966,34497,189,0,0,0,0,.00nan,0,0
32966,37959,189,88,19,0,19,1000,3600000,0
32966,42036,182,0,0,0,0,.00nan,0,0
32966,70585,182,75,35,3,32,.914,3600000,0
32968,35170,185,51,25,4,21,.840,3900000,0
32968,37691,229,64,37,4,33,.892,3900000,0
32968,54127,229,0,0,0,0,.00nan,0,0
32968,55500,185,0,0,0,0,.00nan,0,0
32970,45608,197,0,0,0,0,.00nan,0,0
32970,45701,200,75,27,1,26,.963,3900000,0
32970,59361,197,100,48,1,47,.979,3900000,0
32970,63702,200,0,0,0,0,.00nan,0,0
32972,34496,192,0,0,0,0,.00nan,0,0
32972,35301,216,32,27,6,21,.778,3045000,0
32972,36994,216,46,5,1,4,.800,555000,0
32972,45670,192,58,20,2,18,.900,3600000,0
32974,37974,212,70,23,2,21,.913,3900000,0
32974,42595,212,0,0,0,0,.00nan,0,0
32974,45665,180,78,36,2,34,.944,3900000,0
32974,60584,180,0,0,0,0,.00nan,0,0
32976,36908,194,54,28,4,24,.857,3575000,0
32976,42148,203,0,0,0,0,.00nan,0,0
32976,44342,194,0,0,0,0,.00nan,0,0
32976,45449,203,73,34,3,31,.912,3600000,0
32978,39117,177,0,0,0,0,.00nan,0,0
32978,64580,215,53,19,2,17,.895,3543000,0
32978,65223,215,0,0,0,0,.00nan,0,0
32978,76131,177,93,35,1,34,.971,3600000,0
32980,43589,176,0,0,0,0,.00nan,0,0
32980,45725,223,73,24,1,23,.958,3900000,0
32980,56138,223,0,0,0,0,.00nan,0,0
32980,58410,176,88,29,1,28,.966,3900000,0
32982,34496,192,43,32,5,27,.844,3545000,0
32982,44452,220,0,0,0,0,.00nan,0,0
32982,45670,192,0,0,0,0,.00nan,0,0
32982,65261,220,68,39,4,35,.897,3600000,0
32984,39182,1371,88,42,3,39,.929,3568000,0
32984,55582,207,69,25,2,23,.920,3600000,0
32984,55702,207,0,0,0,0,.00nan,0,0
32984,79637,1371,0,0,0,0,.00nan,0,0
32986,33418,226,0,0,0,0,.00nan,0,0
32986,34497,189,0,0,0,0,.00nan,0,0
32986,34756,226,87,45,4,41,.911,3742000,0
32986,37959,189,50,20,3,17,.850,3742000,0
32988,5034,199,69,34,2,32,.941,3600000,0
32988,34128,186,0,0,0,0,.00nan,0,0
32988,42503,199,0,0,0,0,.00nan,0,0
32988,67868,186,56,28,3,25,.893,3571000,0
32990,45608,197,83,37,2,35,.946,3639000,0
32990,45665,180,0,0,0,0,.00nan,0,0
32990,59361,197,0,0,0,0,.00nan,0,0
32990,60584,180,53,26,3,23,.885,3639000,0
32992,40174,183,0,0,0,0,.00nan,0,0
32992,48932,183,44,31,5,26,.839,3578000,0
32992,52598,4959,0,0,0,0,.00nan,0,0
32992,56185,4959,61,24,3,21,.875,3600000,0
32994,2043,222,83,30,1,29,.967,3600000,0
32994,36100,206,74,32,3,29,.906,3600000,0
32994,45629,222,0,0,0,0,.00nan,0,0
32994,63862,206,0,0,0,0,.00nan,0,0
32996,7213,208,0,0,0,0,.00nan,0,0
32996,18631,217,82,14,0,14,1000,3600000,0
32996,47063,208,61,24,2,22,.917,3534000,0
32996,54504,217,0,0,0,0,.00nan,0,0
32998,42036,182,85,45,3,42,.933,3534000,0
32998,59231,232,84,29,1,28,.966,3600000,0
32998,70585,182,0,0,0,0,.00nan,0,0
32998,77251,232,0,0,0,0,.00nan,0,0
33000,35510,193,63,16,1,15,.938,3600000,0
33000,50247,227,0,0,0,0,.00nan,0,0
33000,52415,227,73,52,6,46,.885,3600000,0
33000,63590,193,0,0,0,0,.00nan,0,0
33002,9246,181,0,0,0,0,.00nan,0,0
33002,42148,203,55,37,5,32,.865,3543000,0
33002,45449,203,0,0,0,0,.00nan,0,0
33002,45733,181,50,27,4,23,.852,3600000,0
33004,34564,188,96,58,3,55,.948,3900000,0
33004,55616,188,0,0,0,0,.00nan,0,0
33004,64580,215,50,22,3,19,.864,3900000,0
33004,65223,215,0,0,0,0,.00nan,0,0
33006,29935,213,0,0,0,0,.00nan,0,0
33006,36909,179,91,20,0,20,1000,3600000,0
33006,37964,179,0,0,0,0,.00nan,0,0
33006,66667,213,98,44,2,42,.955,3558000,0
33008,35293,187,56,24,3,21,.875,3600000,0
33008,45054,231,0,0,0,0,.00nan,0,0
33008,45482,187,0,0,0,0,.00nan,0,0
33008,50372,231,100,37,0,37,1000,3600000,0
33010,934,4864,73,26,2,24,.923,3600000,0
33010,45789,4864,0,0,0,0,.00nan,0,0
33010,56045,205,0,0,0,0,.00nan,0,0
33010,77982,205,52,33,4,29,.879,3553000,0
33012,37974,212,0,0,0,0,.00nan,0,0
33012,42595,212,55,27,3,24,.889,3571000,0
33012,45439,191,99,42,2,40,.952,3600000,0
33012,59538,191,0,0,0,0,.00nan,0,0
33014,35301,216,45,27,4,23,.852,3600000,0
33014,36994,216,0,0,0,0,.00nan,0,0
33014,54105,225,83,23,1,22,.957,3600000,0
33014,56376,225,0,0,0,0,.00nan,0,0
33016,38669,210,82,28,1,27,.964,3600000,0
33016,44927,190,0,0,0,0,.00nan,0,0
33016,56010,190,77,31,2,29,.935,3583000,0
33016,60471,210,0,0,0,0,.00nan,0,0
33018,52460,211,83,24,1,23,.958,3600000,0
33018,55710,211,0,0,0,0,.00nan,0,0
33018,56006,195,66,35,4,31,.886,3600000,0
33018,63601,195,0,0,0,0,.00nan,0,0
33020,34144,228,70,23,1,22,.957,3600000,0
33020,43444,196,0,0,0,0,.00nan,0,0
33020,67737,196,68,35,3,32,.914,3600000,0
33020,68192,228,0,0,0,0,.00nan,0,0
33022,34222,184,0,0,0,0,.00nan,0,0
33022,35118,219,74,50,4,46,.920,3600000,0
33022,42095,219,0,0,0,0,.00nan,0,0
33022,55581,184,91,31,1,30,.968,3600000,0
33024,36908,194,0,0,0,0,.00nan,0,0
33024,44342,194,86,39,2,37,.949,3600000,0
33024,44929,214,0,0,0,0,.00nan,0,0
33024,55624,214,65,32,3,29,.906,3600000,0
33026,8448,204,37,12,3,9,.750,490000,0
33026,33008,204,42,41,7,34,.829,3110000,0
33026,45701,200,0,0,0,0,.00nan,0,0
33026,63702,200,39,20,4,16,.800,3600000,0
33028,7437,201,0,0,0,0,.00nan,0,0
33028,41795,201,83,28,2,26,.929,3900000,0
33028,41884,2620,59,20,2,18,.900,3900000,0
33028,58682,2620,0,0,0,0,.00nan,0,0
33030,6262,198,89,51,4,47,.922,3600000,0
33030,35266,198,0,0,0,0,.00nan,0,0
33030,37691,229,92,21,0,21,1000,3600000,0
33030,54127,229,0,0,0,0,.00nan,0,0
33032,34134,202,68,35,3,32,.914,3600000,0
33032,39398,202,0,0,0,0,.00nan,0,0
33032,53385,209,42,27,5,22,.815,3553000,0
33032,63752,209,0,0,0,0,.00nan,0,0
33034,34152,224,84,27,1,26,.963,3600000,0
33034,35170,185,0,0,0,0,.00nan,0,0
33034,45415,224,0,0,0,0,.00nan,0,0
33034,55500,185,32,27,5,22,.815,3600000,0
33036,34574,178,98,39,2,37,.949,3575000,0
33036,39190,221,83,25,1,24,.960,3600000,0
33036,44366,221,0,0,0,0,.00nan,0,0
33036,78525,178,0,0,0,0,.00nan,0,0
33038,38684,218,0,0,0,0,.00nan,0,0
33038,44933,218,68,16,1,15,.938,3600000,0
33038,60371,4949,13,29,8,21,.724,2028000,0
33038,64187,4949,86,18,0,18,1000,1572000,0
33040,34134,202,100,29,0,29,1000,3600000,0
33040,39398,202,0,0,0,0,.00nan,0,0
33040,55582,207,0,0,0,0,.00nan,0,0
33040,55702,207,44,22,3,19,.864,3600000,0
33042,52460,211,81,24,1,23,.958,3600000,0
33042,55710,211,0,0,0,0,.00nan,0,0
33042,60371,4949,89,47,3,44,.936,3591000,0
33042,64187,4949,0,0,0,0,.00nan,0,0
33044,6262,198,61,32,3,29,.906,3553000,0
33044,7437,201,0,0,0,0,.00nan,0,0
33044,35266,198,0,0,0,0,.00nan,0,0
33044,41795,201,92,25,1,24,.960,3600000,0
33046,36909,179,79,23,1,22,.957,3600000,0
33046,37964,179,0,0,0,0,.00nan,0,0
33046,41884,2620,59,31,3,28,.903,3548000,0
33046,58682,2620,0,0,0,0,.00nan,0,0
33048,37974,212,0,0,0,0,.00nan,0,0
33048,42595,212,44,20,4,16,.800,3600000,0
33048,52598,4959,68,35,3,32,.914,3600000,0
33048,56185,4959,0,0,0,0,.00nan,0,0
33050,5034,199,49,35,5,30,.857,3554000,0
33050,42503,199,0,0,0,0,.00nan,0,0
33050,45665,180,0,0,0,0,.00nan,0,0
33050,60584,180,51,27,4,23,.852,3600000,0
33052,34128,186,0,0,0,0,.00nan,0,0
33052,45701,200,0,0,0,0,.00nan,0,0
33052,63702,200,64,36,4,32,.889,3900000,0
33052,67868,186,52,27,4,23,.852,3893000,0
33054,42036,182,77,38,4,34,.895,3215000,0
33054,56006,195,0,0,0,0,.00nan,0,0
33054,63601,195,58,19,2,17,.895,3600000,0
33054,70585,182,25,7,3,4,.571,385000,0
33056,35118,219,0,0,0,0,.00nan,0,0
33056,42095,219,41,28,4,24,.857,3600000,0
33056,53385,209,0,0,0,0,.00nan,0,0
33056,63752,209,79,28,1,27,.964,3600000,0
33058,2043,222,92,22,0,22,1000,3600000,0
33058,45054,231,0,0,0,0,.00nan,0,0
33058,45629,222,0,0,0,0,.00nan,0,0
33058,50372,231,88,44,3,41,.932,3600000,0
33060,42148,203,59,19,2,17,.895,3600000,0
33060,45449,203,0,0,0,0,.00nan,0,0
33060,54105,225,64,40,4,36,.900,3567000,0
33060,56376,225,0,0,0,0,.00nan,0,0
33062,934,4864,77,26,2,24,.923,3545000,0
33062,34152,224,100,35,0,35,1000,3600000,0
33062,45415,224,0,0,0,0,.00nan,0,0
33062,45789,4864,0,0,0,0,.00nan,0,0
33064,38669,210,72,25,2,23,.920,3600000,0
33064,39182,1371,54,24,3,21,.875,3565000,0
33064,60471,210,0,0,0,0,.00nan,0,0
33064,79637,1371,0,0,0,0,.00nan,0,0
33066,18631,217,78,32,3,29,.906,3608000,0
33066,39117,177,65,23,2,21,.913,3608000,0
33066,54504,217,0,0,0,0,.00nan,0,0
33066,76131,177,0,0,0,0,.00nan,0,0
33068,35301,216,0,0,0,0,.00nan,0,0
33068,36100,206,70,20,1,19,.950,3600000,0
33068,36994,216,81,47,3,44,.936,3600000,0
33068,63862,206,0,0,0,0,.00nan,0,0
33070,34497,189,0,0,0,0,.00nan,0,0
33070,34574,178,34,31,5,26,.839,3600000,0
33070,37959,189,62,16,1,15,.938,3600000,0
33070,78525,178,0,0,0,0,.00nan,0,0
33072,9246,181,60,20,3,17,.850,3525000,0
33072,34144,228,100,50,1,49,.980,3600000,0
33072,45733,181,0,0,0,0,.00nan,0,0
33072,68192,228,0,0,0,0,.00nan,0,0
33074,35170,185,53,41,5,36,.878,3600000,0
33074,44452,220,100,29,0,29,1000,3600000,0
33074,55500,185,0,0,0,0,.00nan,0,0
33074,65261,220,0,0,0,0,.00nan,0,0
33076,35293,187,98,47,2,45,.957,3554000,0
33076,40174,183,0,0,0,0,.00nan,0,0
33076,45482,187,0,0,0,0,.00nan,0,0
33076,48932,183,73,25,1,24,.960,3600000,0
33078,34496,192,0,0,0,0,.00nan,0,0
33078,43589,176,74,24,1,23,.958,1556000,0
33078,45670,192,70,15,1,14,.933,3600000,0
33078,58410,176,28,28,6,22,.786,2044000,0
33080,37691,229,51,38,6,32,.842,3600000,0
33080,44927,190,75,23,2,21,.913,3600000,0
33080,54127,229,0,0,0,0,.00nan,0,0
33080,56010,190,0,0,0,0,.00nan,0,0
33082,33418,226,0,0,0,0,.00nan,0,0
33082,34564,188,97,40,1,39,.975,3600000,0
33082,34756,226,80,33,2,31,.939,3600000,0
33082,55616,188,0,0,0,0,.00nan,0,0
33084,34222,184,0,0,0,0,.00nan,0,0
33084,55581,184,56,22,3,19,.864,3558000,0
33084,59231,232,71,21,1,20,.952,3600000,0
33084,77251,232,0,0,0,0,.00nan,0,0
33086,7213,208,0,0,0,0,.00nan,0,0
33086,47063,208,54,13,2,11,.846,3600000,0
33086,50247,227,0,0,0,0,.00nan,0,0
33086,52415,227,53,30,4,26,.867,3570000,0
33088,35510,193,48,23,4,19,.826,3600000,0
33088,39190,221,56,35,5,30,.857,3556000,0
33088,44366,221,0,0,0,0,.00nan,0,0
33088,63590,193,0,0,0,0,.00nan,0,0
33090,43444,196,0,0,0,0,.00nan,0,0
33090,64580,215,37,22,4,18,.818,3513000,0
33090,65223,215,0,0,0,0,.00nan,0,0
33090,67737,196,75,33,2,31,.939,3600000,0
33092,29935,213,0,0,0,0,.00nan,0,0
33092,38684,218,0,0,0,0,.00nan,0,0
33092,44933,218,77,22,2,20,.909,3600000,0
33092,66667,213,61,44,6,38,.864,3600000,0
33094,8448,204,83,28,1,27,.964,3600000,0
33094,33008,204,0,0,0,0,.00nan,0,0
33094,45725,223,0,0,0,0,.00nan,0,0
33094,56138,223,63,32,3,29,.906,3571000,0
33096,45439,191,0,0,0,0,.00nan,0,0
33096,56045,205,68,22,1,21,.955,3600000,0
33096,59538,191,89,18,0,18,1000,3600000,0
33096,77982,205,0,0,0,0,.00nan,0,0
33098,44929,214,84,14,0,14,1000,3600000,0
33098,45608,197,0,0,0,0,.00nan,0,0
33098,55624,214,0,0,0,0,.00nan,0,0
33098,59361,197,68,52,5,47,.904,3600000,0
33099,884,713,0,0,0,0,.00nan,0,0
33099,10453,706,25,30,7,23,.767,3007000,0
33099,13791,706,52,4,0,4,1000,593000,0
33099,19078,713,88,34,1,33,.971,3600000,0
33100,15257,710,89,43,3,40,.930,3900000,0
33100,17183,710,0,0,0,0,.00nan,0,0
33100,17415,712,0,0,0,0,.00nan,0,0
33100,20103,712,85,37,3,34,.919,3900000,0
33101,1304,2466,85,31,1,30,.968,3541000,0
33101,5299,714,0,0,0,0,.00nan,0,0
33101,26548,714,81,13,0,13,1000,3600000,0
33101,52447,2466,0,0,0,0,.00nan,0,0
33102,13817,2470,0,0,0,0,.00nan,0,0
33102,16307,705,53,33,4,29,.879,3569000,0
33102,17785,705,0,0,0,0,.00nan,0,0
33102,22951,2470,77,32,2,30,.938,3600000,0
33103,13817,2470,0,0,0,0,.00nan,0,0
33103,22951,2470,100,47,2,45,.957,3900000,0
33103,33800,2473,74,32,2,30,.938,3900000,0
33103,60040,2473,0,0,0,0,.00nan,0,0
33104,10453,706,89,34,3,31,.912,3600000,0
33104,13791,706,0,0,0,0,.00nan,0,0
33104,15257,710,52,33,5,28,.848,3594000,0
33104,17183,710,0,0,0,0,.00nan,0,0
33105,14642,711,100,23,0,23,1000,3600000,0
33105,17415,712,0,0,0,0,.00nan,0,0
33105,20103,712,73,39,3,36,.923,3600000,0
33105,69094,711,0,0,0,0,.00nan,0,0
33106,884,713,91,30,1,29,.967,3600000,0
33106,1304,2466,62,28,3,25,.893,3520000,0
33106,19078,713,0,0,0,0,.00nan,0,0
33106,52447,2466,0,0,0,0,.00nan,0,0
33107,5299,714,0,0,0,0,.00nan,0,0
33107,16307,705,0,0,0,0,.00nan,0,0
33107,17785,705,89,26,1,25,.962,3600000,0
33107,26548,714,68,37,3,34,.919,3571000,0
33108,13817,2470,0,0,0,0,.00nan,0,0
33108,17415,712,0,0,0,0,.00nan,0,0
33108,20103,712,100,44,2,42,.955,3600000,0
33108,22951,2470,46,41,5,36,.878,3600000,0
33109,14642,711,80,28,2,26,.929,3600000,0
33109,15257,710,38,37,6,31,.838,3211000,0
33109,17183,710,52,3,0,3,1000,389000,0
33109,69094,711,0,0,0,0,.00nan,0,0
33110,5299,714,0,0,0,0,.00nan,0,0
33110,18086,2473,47,33,6,27,.818,3600000,0
33110,26548,714,59,21,3,18,.857,3600000,0
33110,33800,2473,0,0,0,0,.00nan,0,0
33111,1304,2466,0,0,0,0,.00nan,0,0
33111,8678,706,79,22,1,21,.955,3600000,0
33111,10453,706,0,0,0,0,.00nan,0,0
33111,52447,2466,66,32,3,29,.906,3571000,0
33112,884,713,62,11,0,11,1000,742000,0
33112,17785,705,60,30,3,27,.900,3600000,0
33112,19078,713,37,28,6,22,.786,2858000,0
33112,32935,705,0,0,0,0,.00nan,0,0
33113,8678,706,0,0,0,0,.00nan,0,0
33113,10453,706,77,34,2,32,.941,3600000,0
33113,17785,705,50,27,4,23,.852,3580000,0
33113,32935,705,0,0,0,0,.00nan,0,0
33114,13817,2470,0,0,0,0,.00nan,0,0
33114,14642,711,100,30,0,30,1000,3600000,0
33114,22951,2470,47,30,4,26,.867,3600000,0
33114,69094,711,0,0,0,0,.00nan,0,0
33115,1304,2466,33,10,3,7,.700,567000,0
33115,15257,710,72,23,2,21,.913,3600000,0
33115,17183,710,0,0,0,0,.00nan,0,0
33115,52447,2466,56,37,4,33,.892,3033000,0
33116,5299,714,0,0,0,0,.00nan,0,0
33116,17415,712,0,0,0,0,.00nan,0,0
33116,20103,712,56,41,5,36,.878,3600000,0
33116,26548,714,78,33,3,30,.909,3600000,0
33117,884,713,0,0,0,0,.00nan,0,0
33117,18086,2473,85,26,1,25,.962,3600000,0
33117,19078,713,76,31,2,29,.935,3571000,0
33117,33800,2473,0,0,0,0,.00nan,0,0
33118,1304,2466,71,47,4,43,.915,3600000,0
33118,17785,705,95,37,1,36,.973,3600000,0
33118,32935,705,0,0,0,0,.00nan,0,0
33118,52447,2466,0,0,0,0,.00nan,0,0
33119,13817,2470,0,0,0,0,.00nan,0,0
33119,15257,710,75,22,1,21,.955,3600000,0
33119,17183,710,0,0,0,0,.00nan,0,0
33119,22951,2470,74,38,3,35,.921,3574000,0
33120,5299,714,0,0,0,0,.00nan,0,0
33120,14642,711,76,24,2,22,.917,3600000,0
33120,26548,714,74,38,3,35,.921,3569000,0
33120,69094,711,0,0,0,0,.00nan,0,0
33121,8678,706,88,40,3,37,.925,3600000,0
33121,10453,706,0,0,0,0,.00nan,0,0
33121,18086,2473,57,27,4,23,.852,3548000,0
33121,33800,2473,0,0,0,0,.00nan,0,0
33122,884,713,0,0,0,0,.00nan,0,0
33122,17415,712,0,0,0,0,.00nan,0,0
33122,19078,713,50,27,4,23,.852,3900000,0
33122,20103,712,77,50,4,46,.920,3900000,0
33123,1304,2466,65,36,5,31,.861,3809000,0
33123,18086,2473,70,40,4,36,.900,3809000,0
33123,33800,2473,0,0,0,0,.00nan,0,0
33123,52447,2466,0,0,0,0,.00nan,0,0
33124,884,713,0,0,0,0,.00nan,0,0
33124,14642,711,75,41,3,38,.927,3543000,0
33124,19078,713,67,24,2,22,.917,3600000,0
33124,69094,711,0,0,0,0,.00nan,0,0
33125,8678,706,0,0,0,0,.00nan,0,0
33125,10453,706,92,31,1,30,.968,3600000,0
33125,17415,712,0,0,0,0,.00nan,0,0
33125,20103,712,75,30,2,28,.933,3600000,0
33126,15257,710,37,34,6,28,.824,1981000,0
33126,17183,710,71,29,3,26,.897,1619000,0
33126,17785,705,0,0,0,0,.00nan,0,0
33126,32935,705,60,15,1,14,.933,3600000,0
33127,5299,714,0,0,0,0,.00nan,0,0
33127,13817,2470,66,49,5,44,.898,3600000,0
33127,22951,2470,0,0,0,0,.00nan,0,0
33127,26548,714,9,15,6,9,.600,3568000,0
33128,14642,711,62,39,5,34,.872,3600000,0
33128,18086,2473,83,23,1,22,.957,3600000,0
33128,33800,2473,0,0,0,0,.00nan,0,0
33128,69094,711,0,0,0,0,.00nan,0,0
33129,5299,714,0,0,0,0,.00nan,0,0
33129,15257,710,0,0,0,0,.00nan,0,0
33129,17183,710,71,30,2,28,.933,3558000,0
33129,26548,714,99,21,0,21,1000,3600000,0
33130,8678,706,0,0,0,0,.00nan,0,0
33130,10453,706,95,46,2,44,.957,3600000,0
33130,14642,711,0,0,0,0,.00nan,0,0
33130,69094,711,78,38,3,35,.921,3554000,0
33131,884,713,0,0,0,0,.00nan,0,0
33131,13817,2470,0,0,0,0,.00nan,0,0
33131,19078,713,50,23,3,20,.870,3512000,0
33131,22951,2470,99,43,1,42,.977,3600000,0
33132,1304,2466,0,0,0,0,.00nan,0,0
33132,17415,712,70,20,1,19,.950,3600000,0
33132,20103,712,0,0,0,0,.00nan,0,0
33132,52447,2466,55,37,5,32,.865,3600000,0
33133,8678,706,66,33,3,30,.909,3900000,0
33133,10453,706,0,0,0,0,.00nan,0,0
33133,13817,2470,0,0,0,0,.00nan,0,0
33133,22951,2470,97,46,3,43,.935,3900000,0
33134,15257,710,48,36,6,30,.833,3150000,0
33134,17183,710,49,5,1,4,.800,450000,0
33134,18086,2473,82,26,2,24,.923,3600000,0
33134,33800,2473,0,0,0,0,.00nan,0,0
33135,884,713,0,0,0,0,.00nan,0,0
33135,5299,714,0,0,0,0,.00nan,0,0
33135,19078,713,87,30,1,29,.967,3600000,0
33135,26548,714,53,21,3,18,.857,3538000,0
33136,17415,712,0,0,0,0,.00nan,0,0
33136,17785,705,48,20,3,17,.850,3600000,0
33136,20103,712,75,45,4,41,.911,3579000,0
33136,32935,705,0,0,0,0,.00nan,0,0
33137,1304,2466,72,34,3,31,.912,3867000,0
33137,14642,711,56,18,2,16,.889,3867000,0
33137,52447,2466,0,0,0,0,.00nan,0,0
33137,69094,711,0,0,0,0,.00nan,0,0
33138,884,713,41,10,2,8,.800,1353000,0
33138,15257,710,62,43,4,39,.907,3600000,0
33138,17183,710,0,0,0,0,.00nan,0,0
33138,19078,713,32,26,6,20,.769,2247000,0
33139,14642,711,72,28,2,26,.929,3600000,0
33139,17785,705,31,27,6,21,.778,2916000,0
33139,32935,705,33,5,2,3,.600,684000,0
33139,69094,711,0,0,0,0,.00nan,0,0
33140,1304,2466,0,0,0,0,.00nan,0,0
33140,13817,2470,0,0,0,0,.00nan,0,0
33140,22951,2470,84,30,3,27,.900,3520000,0
33140,52447,2466,90,29,1,28,.966,3600000,0
33141,5299,714,92,28,1,27,.964,3600000,0
33141,8678,706,32,29,6,23,.793,1920000,0
33141,10453,706,53,18,2,16,.889,1680000,0
33141,26548,714,0,0,0,0,.00nan,0,0
33142,17415,712,0,0,0,0,.00nan,0,0
33142,18086,2473,32,26,5,21,.808,3544000,0
33142,20103,712,72,41,4,37,.902,3600000,0
33142,33800,2473,0,0,0,0,.00nan,0,0
33143,15257,710,35,17,4,13,.765,1184000,0
33143,17183,710,54,15,2,13,.867,2333000,0
33143,17415,712,0,0,0,0,.00nan,0,0
33143,20103,712,59,34,4,30,.882,3600000,0
33144,13817,2470,0,0,0,0,.00nan,0,0
33144,17785,705,73,27,1,26,.963,3600000,0
33144,22951,2470,82,39,3,36,.923,3571000,0
33144,32935,705,0,0,0,0,.00nan,0,0
33145,1304,2466,0,0,0,0,.00nan,0,0
33145,5299,714,0,0,0,0,.00nan,0,0
33145,26548,714,85,27,1,26,.963,3600000,0
33145,52447,2466,69,35,4,31,.886,3600000,0
33146,884,713,0,0,0,0,.00nan,0,0
33146,8678,706,30,33,6,27,.818,2542000,0
33146,10453,706,56,16,2,14,.875,1058000,0
33146,19078,713,84,16,0,16,1000,3600000,0
33147,14642,711,90,25,1,24,.960,3600000,0
33147,18086,2473,82,43,3,40,.930,3600000,0
33147,33800,2473,0,0,0,0,.00nan,0,0
33147,69094,711,0,0,0,0,.00nan,0,0
33148,8678,706,0,0,0,0,.00nan,0,0
33148,10453,706,46,39,6,33,.846,3600000,0
33148,15257,710,97,30,1,29,.967,3600000,0
33148,17183,710,0,0,0,0,.00nan,0,0
33149,5299,714,0,0,0,0,.00nan,0,0
33149,17785,705,0,0,0,0,.00nan,0,0
33149,26548,714,50,25,3,22,.880,3518000,0
33149,32935,705,99,36,1,35,.972,3600000,0
33151,14642,711,38,33,6,27,.818,3600000,0
33151,17415,712,0,0,0,0,.00nan,0,0
33151,20103,712,90,34,1,33,.971,3600000,0
33151,69094,711,0,0,0,0,.00nan,0,0
33152,1304,2466,0,0,0,0,.00nan,0,0
33152,8678,706,54,21,3,18,.857,3597000,0
33152,10453,706,0,0,0,0,.00nan,0,0
33152,21846,2466,83,33,2,31,.939,3600000,0
33153,14642,711,69,34,4,30,.882,3600000,0
33153,15257,710,0,0,0,0,.00nan,0,0
33153,17183,710,76,24,1,23,.958,3600000,0
33153,69094,711,0,0,0,0,.00nan,0,0
33154,13817,2470,0,0,0,0,.00nan,0,0
33154,17415,712,0,0,0,0,.00nan,0,0
33154,20103,712,57,20,2,18,.900,3571000,0
33154,22951,2470,70,22,1,21,.955,3600000,0
33155,5299,714,0,0,0,0,.00nan,0,0
33155,18086,2473,100,42,1,41,.976,3600000,0
33155,26548,714,69,32,4,28,.875,3600000,0
33155,33800,2473,0,0,0,0,.00nan,0,0
33156,884,713,0,0,0,0,.00nan,0,0
33156,17785,705,83,30,1,29,.967,3600000,0
33156,19078,713,71,25,2,23,.920,3546000,0
33156,32935,705,0,0,0,0,.00nan,0,0
33157,1304,2466,0,0,0,0,.00nan,0,0
33157,18086,2473,0,0,0,0,.00nan,0,0
33157,21846,2466,54,39,5,34,.872,3600000,0
33157,33800,2473,76,31,2,29,.935,3600000,0
33158,884,713,0,0,0,0,.00nan,0,0
33158,17785,705,73,26,2,24,.923,3600000,0
33158,19078,713,34,26,5,21,.808,3600000,0
33158,32935,705,0,0,0,0,.00nan,0,0
33159,884,713,0,0,0,0,.00nan,0,0
33159,18086,2473,90,48,1,47,.979,3600000,0
33159,19078,713,51,18,2,16,.889,3551000,0
33159,33800,2473,0,0,0,0,.00nan,0,0
33160,8678,706,47,42,6,36,.857,3600000,0
33160,10453,706,0,0,0,0,.00nan,0,0
33160,17785,705,0,0,0,0,.00nan,0,0
33160,32935,705,71,19,1,18,.947,3600000,0
33161,1304,2466,0,0,0,0,.00nan,0,0
33161,15257,710,100,28,0,28,1000,3600000,0
33161,17183,710,0,0,0,0,.00nan,0,0
33161,21846,2466,97,36,1,35,.972,3600000,0
33162,13817,2470,58,7,0,7,1000,473000,0
33162,14642,711,62,23,3,20,.870,3600000,0
33162,22951,2470,50,39,6,33,.846,3127000,0
33162,69094,711,0,0,0,0,.00nan,0,0
33163,5299,714,0,0,0,0,.00nan,0,0
33163,17415,712,0,0,0,0,.00nan,0,0
33163,20103,712,69,46,5,41,.891,3900000,0
33163,26548,714,41,35,5,30,.857,3900000,0
33164,13817,2470,0,0,0,0,.00nan,0,0
33164,15257,710,46,24,3,21,.875,3576000,0
33164,17183,710,0,0,0,0,.00nan,0,0
33164,22951,2470,87,33,2,31,.939,3600000,0
33165,8678,706,86,30,2,28,.933,3600000,0
33165,10453,706,0,0,0,0,.00nan,0,0
33165,18086,2473,45,20,3,17,.850,3547000,0
33165,33800,2473,0,0,0,0,.00nan,0,0
33166,1304,2466,44,41,6,35,.854,3600000,0
33166,17785,705,74,28,2,26,.929,3600000,0
33166,21846,2466,0,0,0,0,.00nan,0,0
33166,32935,705,0,0,0,0,.00nan,0,0
33167,5299,714,76,29,2,27,.931,3600000,0
33167,14642,711,62,30,3,27,.900,3589000,0
33167,26548,714,0,0,0,0,.00nan,0,0
33167,69094,711,0,0,0,0,.00nan,0,0
33168,884,713,0,0,0,0,.00nan,0,0
33168,17415,712,0,0,0,0,.00nan,0,0
33168,19078,713,70,24,2,22,.917,3600000,0
33168,20103,712,66,29,3,26,.897,3555000,0
33325,16307,705,0,0,0,0,.00nan,0,0
33325,17415,712,0,0,0,0,.00nan,0,0
33325,17785,705,80,28,2,26,.929,3900000,0
33325,20103,712,71,27,2,25,.926,3900000,0
33327,1304,2466,0,0,0,0,.00nan,0,0
33327,10453,706,35,28,5,23,.821,3593000,0
33327,13791,706,0,0,0,0,.00nan,0,0
33327,52447,2466,66,30,3,27,.900,3600000,0
33329,13817,2470,0,0,0,0,.00nan,0,0
33329,18086,2473,96,42,3,39,.929,3900000,0
33329,22951,2470,88,42,3,39,.929,3900000,0
33329,33800,2473,0,0,0,0,.00nan,0,0
33333,14642,711,89,37,2,35,.946,3600000,0
33333,15257,710,58,26,3,23,.885,3560000,0
33333,17183,710,0,0,0,0,.00nan,0,0
33333,69094,711,0,0,0,0,.00nan,0,0
33335,14642,711,0,0,0,0,.00nan,0,0
33335,15257,710,0,0,0,0,.00nan,0,0
33335,17183,710,70,32,4,28,.875,3600000,0
33335,69094,711,53,38,5,33,.868,3600000,0
33337,10453,706,0,0,0,0,.00nan,0,0
33337,13791,706,69,20,2,18,.900,3600000,0
33337,13817,2470,31,16,4,12,.750,1105000,0
33337,22951,2470,53,27,3,24,.889,2495000,0
33339,1304,2466,54,27,3,24,.889,3564000,0
33339,18086,2473,0,0,0,0,.00nan,0,0
33339,33800,2473,85,33,2,31,.939,3600000,0
33339,52447,2466,0,0,0,0,.00nan,0,0
33341,5299,714,0,0,0,0,.00nan,0,0
33341,17415,712,74,27,2,25,.926,3521000,0
33341,20103,712,0,0,0,0,.00nan,0,0
33341,26548,714,100,29,0,29,1000,3600000,0
33345,13817,2470,0,0,0,0,.00nan,0,0
33345,14642,711,61,30,4,26,.867,3900000,0
33345,22951,2470,70,44,4,40,.909,3900000,0
33345,69094,711,0,0,0,0,.00nan,0,0
33347,1304,2466,0,0,0,0,.00nan,0,0
33347,16307,705,0,0,0,0,.00nan,0,0
33347,17785,705,54,28,4,24,.857,3600000,0
33347,52447,2466,40,29,5,24,.828,3560000,0
33349,5299,714,77,24,2,22,.917,3799000,0
33349,15257,710,70,34,3,31,.912,3799000,0
33349,17183,710,0,0,0,0,.00nan,0,0
33349,26548,714,0,0,0,0,.00nan,0,0
33351,17415,712,0,0,0,0,.00nan,0,0
33351,18086,2473,43,35,5,30,.857,3525000,0
33351,20103,712,70,32,3,29,.906,3600000,0
33351,33800,2473,0,0,0,0,.00nan,0,0
33355,5299,714,0,0,0,0,.00nan,0,0
33355,10453,706,66,59,6,53,.898,3600000,0
33355,13791,706,0,0,0,0,.00nan,0,0
33355,26548,714,73,24,2,22,.917,3600000,0
33357,13817,2470,0,0,0,0,.00nan,0,0
33357,18086,2473,66,32,3,29,.906,3600000,0
33357,22951,2470,48,29,5,24,.828,3546000,0
33357,33800,2473,0,0,0,0,.00nan,0,0
33359,14642,711,76,26,1,25,.962,3600000,0
33359,15257,710,58,31,4,27,.871,3600000,0
33359,17183,710,0,0,0,0,.00nan,0,0
33359,69094,711,0,0,0,0,.00nan,0,0
33361,884,713,0,0,0,0,.00nan,0,0
33361,16307,705,0,0,0,0,.00nan,0,0
33361,17785,705,72,26,2,24,.923,3562000,0
33361,19078,713,95,34,1,33,.971,3600000,0
33363,1304,2466,70,36,3,33,.917,3574000,0
33363,17415,712,0,0,0,0,.00nan,0,0
33363,20103,712,91,30,2,28,.933,3600000,0
33363,52447,2466,0,0,0,0,.00nan,0,0
33365,1304,2466,0,0,0,0,.00nan,0,0
33365,16307,705,54,34,5,29,.853,3540000,0
33365,17785,705,0,0,0,0,.00nan,0,0
33365,52447,2466,91,51,4,47,.922,3600000,0
33367,13817,2470,53,31,3,28,.903,3900000,0
33367,18086,2473,64,28,3,25,.893,3900000,0
33367,22951,2470,0,0,0,0,.00nan,0,0
33367,33800,2473,0,0,0,0,.00nan,0,0
33371,5299,714,64,23,2,21,.913,3600000,0
33371,15257,710,0,0,0,0,.00nan,0,0
33371,17183,710,78,33,3,30,.909,3543000,0
33371,26548,714,0,0,0,0,.00nan,0,0
33373,14642,711,0,0,0,0,.00nan,0,0
33373,17415,712,59,38,4,34,.895,3600000,0
33373,20103,712,0,0,0,0,.00nan,0,0
33373,69094,711,54,39,6,33,.846,3552000,0
33375,16307,705,0,0,0,0,.00nan,0,0
33375,17785,705,51,15,2,13,.867,3571000,0
33375,18086,2473,0,0,0,0,.00nan,0,0
33375,33800,2473,100,36,0,36,1000,3600000,0
33377,1304,2466,99,44,1,43,.977,3600000,0
33377,15257,710,54,22,3,19,.864,3583000,0
33377,17183,710,0,0,0,0,.00nan,0,0
33377,52447,2466,0,0,0,0,.00nan,0,0
33379,10453,706,77,24,1,23,.958,3900000,0
33379,13791,706,0,0,0,0,.00nan,0,0
33379,13817,2470,0,0,0,0,.00nan,0,0
33379,22951,2470,78,29,1,28,.966,3900000,0
33383,14642,711,84,32,1,31,.969,3900000,0
33383,17415,712,0,0,0,0,.00nan,0,0
33383,20103,712,92,32,1,31,.969,3900000,0
33383,69094,711,0,0,0,0,.00nan,0,0
33385,15257,710,0,0,0,0,.00nan,0,0
33385,17183,710,69,27,2,25,.926,3600000,0
33385,17415,712,61,37,4,33,.892,3538000,0
33385,20103,712,0,0,0,0,.00nan,0,0
33389,10453,706,0,0,0,0,.00nan,0,0
33389,13791,706,67,30,3,27,.900,3900000,0
33389,18086,2473,0,0,0,0,.00nan,0,0
33389,33800,2473,82,45,3,42,.933,3900000,0
33391,13817,2470,22,10,4,6,.600,818000,0
33391,16307,705,100,26,0,26,1000,3600000,0
33391,17785,705,0,0,0,0,.00nan,0,0
33391,22951,2470,73,32,2,30,.938,2782000,0
33393,5299,714,59,40,5,35,.875,3543000,0
33393,14642,711,0,0,0,0,.00nan,0,0
33393,26548,714,0,0,0,0,.00nan,0,0
33393,69094,711,75,29,3,26,.897,3600000,0
33394,586,4534,0,0,0,0,.00nan,0,0
33394,11197,2306,0,0,0,0,.00nan,0,0
33394,11228,2306,76,29,2,27,.931,3600000,0
33394,13074,4534,61,35,5,30,.857,3600000,0
33395,12937,2308,58,39,5,34,.872,3600000,0
33395,13011,2308,0,0,0,0,.00nan,0,0
33395,13019,619,0,0,0,0,.00nan,0,0
33395,40280,619,99,44,1,43,.977,3600000,0
33396,8212,612,72,37,4,33,.892,3600000,0
33396,13858,2319,0,0,0,0,.00nan,0,0
33396,30426,612,0,0,0,0,.00nan,0,0
33396,30751,2319,67,45,5,40,.889,3556000,0
33397,14321,3923,45,32,5,27,.844,3600000,0
33397,30859,3923,0,0,0,0,.00nan,0,0
33397,31368,2310,0,0,0,0,.00nan,0,0
33397,58378,2310,64,22,2,20,.909,3600000,0
33398,9482,2316,0,0,0,0,.00nan,0,0
33398,27990,618,80,34,2,32,.941,3638000,0
33398,29799,2316,68,19,1,18,.947,3638000,0
33398,65334,618,0,0,0,0,.00nan,0,0
33399,833,611,70,42,5,37,.881,3600000,0
33399,14321,3923,62,18,2,16,.889,3600000,0
33399,30859,3923,0,0,0,0,.00nan,0,0
33399,65313,611,0,0,0,0,.00nan,0,0
33400,9482,2316,0,0,0,0,.00nan,0,0
33400,11197,2306,89,43,2,41,.953,3600000,0
33400,11228,2306,0,0,0,0,.00nan,0,0
33400,29799,2316,43,34,5,29,.853,3600000,0
33401,27990,618,70,46,4,42,.913,3596000,0
33401,31368,2310,0,0,0,0,.00nan,0,0
33401,58378,2310,49,22,3,19,.864,3600000,0
33401,65334,618,0,0,0,0,.00nan,0,0
33402,10744,619,48,20,3,17,.850,3600000,0
33402,16956,622,0,0,0,0,.00nan,0,0
33402,30193,622,55,31,4,27,.871,3591000,0
33402,40280,619,0,0,0,0,.00nan,0,0
33403,586,4534,0,0,0,0,.00nan,0,0
33403,8212,612,76,36,3,33,.917,3868000,0
33403,13074,4534,92,36,2,34,.944,3868000,0
33403,30426,612,0,0,0,0,.00nan,0,0
33404,12937,2308,63,27,3,24,.889,3543000,0
33404,13011,2308,0,0,0,0,.00nan,0,0
33404,13858,2319,75,28,2,26,.929,3600000,0
33404,30751,2319,0,0,0,0,.00nan,0,0
33405,586,4534,0,0,0,0,.00nan,0,0
33405,12937,2308,89,36,1,35,.972,4089000,0
33405,13011,2308,0,0,0,0,.00nan,0,0
33405,13074,4534,77,32,2,30,.938,4089000,0
33406,833,611,95,30,1,29,.967,3600000,0
33406,10744,619,57,20,2,18,.900,3543000,0
33406,40280,619,0,0,0,0,.00nan,0,0
33406,65313,611,0,0,0,0,.00nan,0,0
33407,11197,2306,75,21,1,20,.952,3600000,0
33407,11228,2306,0,0,0,0,.00nan,0,0
33407,31368,2310,0,0,0,0,.00nan,0,0
33407,58378,2310,73,29,2,27,.931,3544000,0
33408,8212,612,87,35,1,34,.971,3600000,0
33408,9482,2316,0,0,0,0,.00nan,0,0
33408,29799,2316,73,40,4,36,.900,3600000,0
33408,30426,612,0,0,0,0,.00nan,0,0
33409,14321,3923,47,34,5,29,.853,3547000,0
33409,27990,618,59,36,4,32,.889,3600000,0
33409,30859,3923,0,0,0,0,.00nan,0,0
33409,65334,618,0,0,0,0,.00nan,0,0
33410,13858,2319,41,34,5,29,.853,3590000,0
33410,16956,622,0,0,0,0,.00nan,0,0
33410,30193,622,57,19,2,17,.895,3600000,0
33410,30751,2319,0,0,0,0,.00nan,0,0
33411,586,4534,0,0,0,0,.00nan,0,0
33411,13074,4534,62,23,2,21,.913,3521000,0
33411,27990,618,100,29,0,29,1000,3600000,0
33411,65334,618,0,0,0,0,.00nan,0,0
33412,8212,612,83,31,1,30,.968,3600000,0
33412,30426,612,0,0,0,0,.00nan,0,0
33412,31368,2310,0,0,0,0,.00nan,0,0
33412,58378,2310,88,43,4,39,.907,3600000,0
33413,11197,2306,82,27,1,26,.963,3600000,0
33413,11228,2306,0,0,0,0,.00nan,0,0
33413,14321,3923,60,46,5,41,.891,3600000,0
33413,30859,3923,0,0,0,0,.00nan,0,0
33414,833,611,50,30,4,26,.867,3554000,0
33414,27990,618,62,25,3,22,.880,3600000,0
33414,65313,611,0,0,0,0,.00nan,0,0
33414,65334,618,0,0,0,0,.00nan,0,0
33415,586,4534,0,0,0,0,.00nan,0,0
33415,13074,4534,53,25,3,22,.880,3641000,0
33415,16956,622,91,41,2,39,.951,3667000,0
33415,30193,622,0,0,0,0,.00nan,0,0
33416,9482,2316,0,0,0,0,.00nan,0,0
33416,12937,2308,72,24,2,22,.917,3573000,0
33416,13011,2308,0,0,0,0,.00nan,0,0
33416,29799,2316,70,21,1,20,.952,3600000,0
33417,10744,619,0,0,0,0,.00nan,0,0
33417,13858,2319,77,23,1,22,.957,3600000,0
33417,30751,2319,0,0,0,0,.00nan,0,0
33417,40280,619,46,23,3,20,.870,3515000,0
33418,833,611,100,51,2,49,.961,4200000,0
33418,13858,2319,67,24,2,22,.917,4200000,0
33418,30751,2319,0,0,0,0,.00nan,0,0
33418,65313,611,0,0,0,0,.00nan,0,0
33419,12937,2308,87,28,1,27,.964,3600000,0
33419,13011,2308,0,0,0,0,.00nan,0,0
33419,31368,2310,58,7,0,7,1000,622000,0
33419,58378,2310,16,21,6,15,.714,2978000,0
33420,9482,2316,0,0,0,0,.00nan,0,0
33420,16956,622,0,0,0,0,.00nan,0,0
33420,29799,2316,69,23,2,21,.913,3600000,0
33420,30193,622,33,35,6,29,.829,3600000,0
33421,11197,2306,65,29,3,26,.897,3595000,0
33421,11228,2306,0,0,0,0,.00nan,0,0
33421,27990,618,0,0,0,0,.00nan,0,0
33421,29775,618,86,37,2,35,.946,3600000,0
33422,8212,612,48,36,5,31,.861,3561000,0
33422,14321,3923,54,35,4,31,.886,3600000,0
33422,30426,612,0,0,0,0,.00nan,0,0
33422,30859,3923,0,0,0,0,.00nan,0,0
33423,586,4534,0,0,0,0,.00nan,0,0
33423,10744,619,0,0,0,0,.00nan,0,0
33423,13074,4534,96,35,1,34,.971,4200000,0
33423,40280,619,86,29,1,28,.966,4200000,0
33424,8212,612,63,26,3,23,.885,3546000,0
33424,16956,622,86,34,2,32,.941,3600000,0
33424,30193,622,0,0,0,0,.00nan,0,0
33424,30426,612,0,0,0,0,.00nan,0,0
33425,8212,612,48,21,4,17,.810,3835000,0
33425,27990,618,0,0,0,0,.00nan,0,0
33425,29775,618,49,33,5,28,.848,3835000,0
33425,30426,612,0,0,0,0,.00nan,0,0
33426,586,4534,0,0,0,0,.00nan,0,0
33426,13074,4534,74,24,1,23,.958,3600000,0
33426,13858,2319,57,37,5,32,.865,3600000,0
33426,30751,2319,0,0,0,0,.00nan,0,0
33427,16956,622,0,0,0,0,.00nan,0,0
33427,30193,622,95,49,2,47,.959,4200000,0
33427,31368,2310,0,0,0,0,.00nan,0,0
33427,58378,2310,98,39,2,37,.949,4200000,0
33428,12937,2308,60,20,2,18,.900,3600000,0
33428,13011,2308,0,0,0,0,.00nan,0,0
33428,14321,3923,85,40,3,37,.925,3551000,0
33428,30859,3923,0,0,0,0,.00nan,0,0
33429,9482,2316,0,0,0,0,.00nan,0,0
33429,10744,619,75,26,2,24,.923,3600000,0
33429,29799,2316,24,43,9,34,.791,3600000,0
33429,40280,619,0,0,0,0,.00nan,0,0
33430,833,611,60,29,3,26,.897,3600000,0
33430,11197,2306,89,33,1,32,.970,3600000,0
33430,11228,2306,0,0,0,0,.00nan,0,0
33430,65313,611,0,0,0,0,.00nan,0,0
33431,10744,619,61,26,3,23,.885,3600000,0
33431,31368,2310,0,0,0,0,.00nan,0,0
33431,40280,619,0,0,0,0,.00nan,0,0
33431,58378,2310,65,41,5,36,.878,3574000,0
33432,12937,2308,49,19,3,16,.842,3600000,0
33432,13011,2308,0,0,0,0,.00nan,0,0
33432,27990,618,0,0,0,0,.00nan,0,0
33432,29775,618,76,42,4,38,.905,3571000,0
33433,14321,3923,72,38,3,35,.921,3562000,0
33433,16956,622,80,24,1,23,.958,3600000,0
33433,30193,622,0,0,0,0,.00nan,0,0
33433,30859,3923,0,0,0,0,.00nan,0,0
33434,586,4534,0,0,0,0,.00nan,0,0
33434,833,611,93,33,2,31,.939,3564000,0
33434,13074,4534,95,33,1,32,.970,3600000,0
33434,65313,611,0,0,0,0,.00nan,0,0
33435,8212,612,73,24,2,22,.917,3600000,0
33435,11197,2306,48,31,5,26,.839,3600000,0
33435,11228,2306,0,0,0,0,.00nan,0,0
33435,30426,612,0,0,0,0,.00nan,0,0
33436,833,611,0,0,0,0,.00nan,0,0
33436,31368,2310,0,0,0,0,.00nan,0,0
33436,58378,2310,42,18,4,14,.778,3600000,0
33436,65313,611,52,31,5,26,.839,3560000,0
33437,9482,2316,0,0,0,0,.00nan,0,0
33437,13858,2319,70,23,1,22,.957,3600000,0
33437,29799,2316,61,28,3,25,.893,3571000,0
33437,30751,2319,0,0,0,0,.00nan,0,0
33438,16956,622,64,21,2,19,.905,3806000,0
33438,27990,618,0,0,0,0,.00nan,0,0
33438,29775,618,69,33,3,30,.909,3806000,0
33438,30193,622,0,0,0,0,.00nan,0,0
33439,833,611,62,29,3,26,.897,3683000,0
33439,8212,612,0,0,0,0,.00nan,0,0
33439,30426,612,62,31,4,27,.871,3635000,0
33439,65313,611,0,0,0,0,.00nan,0,0
33440,13858,2319,94,22,0,22,1000,3600000,0
33440,30751,2319,0,0,0,0,.00nan,0,0
33440,31368,2310,0,0,0,0,.00nan,0,0
33440,58378,2310,34,29,6,23,.793,3600000,0
33441,586,4534,0,0,0,0,.00nan,0,0
33441,9482,2316,0,0,0,0,.00nan,0,0
33441,13074,4534,98,33,1,32,.970,3570000,0
33441,29799,2316,91,25,0,25,1000,3600000,0
33442,11197,2306,89,42,2,40,.952,4200000,0
33442,11228,2306,0,0,0,0,.00nan,0,0
33442,12937,2308,82,36,2,34,.944,4200000,0
33442,13011,2308,0,0,0,0,.00nan,0,0
33443,10744,619,0,0,0,0,.00nan,0,0
33443,14321,3923,60,38,4,34,.895,3600000,0
33443,30859,3923,0,0,0,0,.00nan,0,0
33443,40280,619,73,23,1,22,.957,3600000,0
33444,8212,612,80,30,2,28,.933,3551000,0
33444,12937,2308,76,24,1,23,.958,3600000,0
33444,13011,2308,0,0,0,0,.00nan,0,0
33444,30426,612,0,0,0,0,.00nan,0,0
33445,833,611,76,44,4,40,.909,3572000,0
33445,9482,2316,0,0,0,0,.00nan,0,0
33445,29799,2316,51,21,3,18,.857,3600000,0
33445,65313,611,0,0,0,0,.00nan,0,0
33446,586,4534,0,0,0,0,.00nan,0,0
33446,13074,4534,91,38,3,35,.921,3600000,0
33446,31368,2310,70,36,4,32,.889,3600000,0
33446,58378,2310,0,0,0,0,.00nan,0,0
33447,11197,2306,73,41,4,37,.902,4200000,0
33447,11228,2306,0,0,0,0,.00nan,0,0
33447,16956,622,77,34,4,30,.882,4200000,0
33447,30193,622,0,0,0,0,.00nan,0,0
33448,10744,619,83,33,2,31,.939,3600000,0
33448,27990,618,0,0,0,0,.00nan,0,0
33448,29775,618,68,33,3,30,.909,3551000,0
33448,40280,619,0,0,0,0,.00nan,0,0
33449,13858,2319,76,21,1,20,.952,3600000,0
33449,14321,3923,0,0,0,0,.00nan,0,0
33449,30751,2319,0,0,0,0,.00nan,0,0
33449,30859,3923,70,30,3,27,.900,3552000,0
33450,833,611,88,28,1,27,.964,3600000,0
33450,12937,2308,43,26,5,21,.808,3600000,0
33450,13011,2308,0,0,0,0,.00nan,0,0
33450,65313,611,0,0,0,0,.00nan,0,0
33451,13858,2319,76,17,1,16,.941,3600000,0
33451,27990,618,0,0,0,0,.00nan,0,0
33451,29775,618,81,39,3,36,.923,3589000,0
33451,30751,2319,0,0,0,0,.00nan,0,0
33452,9482,2316,0,0,0,0,.00nan,0,0
33452,29799,2316,56,27,4,23,.852,3892000,0
33452,31368,2310,0,0,0,0,.00nan,0,0
33452,58378,2310,65,34,3,31,.912,3892000,0
33453,586,4534,0,0,0,0,.00nan,0,0
33453,13074,4534,86,37,2,35,.946,3600000,0
33453,14321,3923,68,41,4,37,.902,3600000,0
33453,30859,3923,0,0,0,0,.00nan,0,0
33454,10744,619,0,0,0,0,.00nan,0,0
33454,11197,2306,82,44,3,41,.932,3644000,0
33454,11228,2306,0,0,0,0,.00nan,0,0
33454,40280,619,77,24,2,22,.917,3644000,0
33455,8212,612,67,39,4,35,.897,3572000,0
33455,10744,619,87,33,2,31,.939,3600000,0
33455,30426,612,0,0,0,0,.00nan,0,0
33455,40280,619,0,0,0,0,.00nan,0,0
33456,11197,2306,0,0,0,0,.00nan,0,0
33456,11228,2306,75,32,2,30,.938,3586000,0
33456,13858,2319,68,22,1,21,.955,3600000,0
33456,30751,2319,0,0,0,0,.00nan,0,0
33457,9482,2316,46,6,1,5,.833,750000,0
33457,14321,3923,60,37,4,33,.892,3600000,0
33457,29799,2316,16,20,6,14,.700,2850000,0
33457,30859,3923,0,0,0,0,.00nan,0,0
33458,833,611,89,30,2,28,.933,3600000,0
33458,14321,3923,53,37,5,32,.865,3600000,0
33458,30859,3923,0,0,0,0,.00nan,0,0
33458,65313,611,0,0,0,0,.00nan,0,0
33459,27990,618,0,0,0,0,.00nan,0,0
33459,29775,618,86,28,1,27,.964,3600000,0
33459,31368,2310,0,0,0,0,.00nan,0,0
33459,58378,2310,29,24,5,19,.792,3600000,0
33460,12937,2308,49,21,3,18,.857,3529000,0
33460,13011,2308,0,0,0,0,.00nan,0,0
33460,13858,2319,95,34,1,33,.971,3600000,0
33460,30751,2319,0,0,0,0,.00nan,0,0
33461,9482,2316,0,0,0,0,.00nan,0,0
33461,11197,2306,78,31,2,29,.935,3600000,0
33461,11228,2306,0,0,0,0,.00nan,0,0
33461,29799,2316,78,26,1,25,.962,3600000,0
33462,586,4534,48,0,0,0,.00nan,317000,0
33462,8212,612,60,19,2,17,.895,3600000,0
33462,13074,4534,44,36,6,30,.833,3283000,0
33462,30426,612,0,0,0,0,.00nan,0,0
33463,10744,619,0,0,0,0,.00nan,0,0
33463,16956,622,0,0,0,0,.00nan,0,0
33463,30193,622,80,42,3,39,.929,3572000,0
33463,40280,619,83,30,1,29,.967,3600000,0
33464,833,611,73,30,2,28,.933,3600000,0
33464,16956,622,66,42,5,37,.881,3600000,0
33464,30193,622,0,0,0,0,.00nan,0,0
33464,65313,611,0,0,0,0,.00nan,0,0
33465,9482,2316,0,0,0,0,.00nan,0,0
33465,29799,2316,81,38,2,36,.947,4200000,0
33465,31368,2310,0,0,0,0,.00nan,0,0
33465,58378,2310,74,32,2,30,.938,4200000,0
33659,586,4534,0,0,0,0,.00nan,0,0
33659,12937,2308,42,26,4,22,.846,3581000,0
33659,13011,2308,0,0,0,0,.00nan,0,0
33659,13074,4534,69,26,3,23,.885,3600000,0
33661,14321,3923,68,31,3,28,.903,3600000,0
33661,16956,622,51,32,5,27,.844,3551000,0
33661,30193,622,0,0,0,0,.00nan,0,0
33661,30859,3923,0,0,0,0,.00nan,0,0
33665,11197,2306,78,34,3,31,.912,3600000,0
33665,11228,2306,0,0,0,0,.00nan,0,0
33665,13019,611,44,26,4,22,.846,3522000,0
33665,65313,611,0,0,0,0,.00nan,0,0
33667,29775,618,61,29,3,26,.897,4200000,0
33667,31368,2310,0,0,0,0,.00nan,0,0
33667,58378,2310,59,33,3,30,.909,4200000,0
33667,65334,618,0,0,0,0,.00nan,0,0
33669,833,619,0,0,0,0,.00nan,0,0
33669,9482,2316,0,0,0,0,.00nan,0,0
33669,29799,2316,93,20,0,20,1000,3600000,0
33669,40280,619,72,45,5,40,.889,3600000,0
33671,11197,2306,55,4,0,4,1000,686000,0
33671,11228,2306,21,33,7,26,.788,2914000,0
33671,16956,622,0,0,0,0,.00nan,0,0
33671,30193,622,44,23,4,19,.826,3600000,0
33673,12937,2308,0,0,0,0,.00nan,0,0
33673,13011,2308,93,25,0,25,1000,3600000,0
33673,14321,3923,0,0,0,0,.00nan,0,0
33673,30859,3923,72,47,4,43,.915,3600000,0
33675,13019,611,0,0,0,0,.00nan,0,0
33675,31368,2310,0,0,0,0,.00nan,0,0
33675,58378,2310,87,45,3,42,.933,3588000,0
33675,65313,611,66,21,2,19,.905,3600000,0
33677,833,619,79,33,3,30,.909,3600000,0
33677,13858,2319,47,29,4,25,.862,3545000,0
33677,30751,2319,0,0,0,0,.00nan,0,0
33677,40280,619,0,0,0,0,.00nan,0,0
33679,9482,2316,0,0,0,0,.00nan,0,0
33679,29775,618,0,0,0,0,.00nan,0,0
33679,29799,2316,39,31,5,26,.839,3600000,0
33679,65334,618,66,34,3,31,.912,3600000,0
33683,833,619,0,0,0,0,.00nan,0,0
33683,29775,618,86,40,2,38,.950,3564000,0
33683,40280,619,81,30,1,29,.967,3600000,0
33683,65334,618,0,0,0,0,.00nan,0,0
33685,586,4534,0,0,0,0,.00nan,0,0
33685,13074,4534,49,31,4,27,.871,3902000,0
33685,13858,2319,71,40,5,35,.875,3902000,0
33685,30751,2319,0,0,0,0,.00nan,0,0
33689,11197,2306,93,31,1,30,.968,3564000,0
33689,11228,2306,0,0,0,0,.00nan,0,0
33689,13019,611,100,26,0,26,1000,3600000,0
33689,65313,611,0,0,0,0,.00nan,0,0
33691,9482,2316,0,0,0,0,.00nan,0,0
33691,14321,3923,90,47,3,44,.936,4045000,0
33691,29799,2316,51,29,4,25,.862,4045000,0
33691,30859,3923,0,0,0,0,.00nan,0,0
33693,12937,2308,0,0,0,0,.00nan,0,0
33693,13011,2308,56,13,1,12,.923,3600000,0
33693,16956,622,58,35,4,31,.886,3600000,0
33693,30193,622,0,0,0,0,.00nan,0,0
33695,13019,611,100,24,0,24,1000,3600000,0
33695,14321,3923,59,32,4,28,.875,3600000,0
33695,30859,3923,0,0,0,0,.00nan,0,0
33695,65313,611,0,0,0,0,.00nan,0,0
33697,8212,612,95,30,1,29,.967,3600000,0
33697,9482,2316,0,0,0,0,.00nan,0,0
33697,29799,2316,30,28,6,22,.786,3600000,0
33697,30426,612,0,0,0,0,.00nan,0,0
33699,833,619,0,0,0,0,.00nan,0,0
33699,12937,2308,41,29,5,24,.828,3600000,0
33699,13011,2308,0,0,0,0,.00nan,0,0
33699,40280,619,88,28,1,27,.964,3600000,0
33701,586,4534,0,0,0,0,.00nan,0,0
33701,13074,4534,62,23,2,21,.913,3600000,0
33701,16956,622,48,31,4,27,.871,3596000,0
33701,30193,622,0,0,0,0,.00nan,0,0
33703,13858,2319,97,31,1,30,.968,3600000,0
33703,29775,618,93,43,2,41,.953,3549000,0
33703,30751,2319,0,0,0,0,.00nan,0,0
33703,65334,618,0,0,0,0,.00nan,0,0
33705,11197,2306,0,0,0,0,.00nan,0,0
33705,11228,2306,91,47,3,44,.936,3674000,0
33705,31368,2310,0,0,0,0,.00nan,0,0
33705,58378,2310,49,24,4,20,.833,3674000,0
33707,833,611,0,0,0,0,.00nan,0,0
33707,11197,2306,80,48,4,44,.917,3600000,0
33707,11228,2306,0,0,0,0,.00nan,0,0
33707,65313,611,61,40,5,35,.875,3571000,0
33711,12937,2308,0,0,0,0,.00nan,0,0
33711,13011,2308,65,26,2,24,.923,3600000,0
33711,13019,619,29,22,5,17,.773,2665000,0
33711,40280,619,29,10,4,6,.600,935000,0
33713,586,4534,100,28,0,28,1000,3600000,0
33713,13074,4534,0,0,0,0,.00nan,0,0
33713,16956,622,0,0,0,0,.00nan,0,0
33713,30193,622,89,51,3,48,.941,3600000,0
33715,13858,2319,0,0,0,0,.00nan,0,0
33715,30751,2319,69,25,2,23,.920,3600000,0
33715,31368,2310,0,0,0,0,.00nan,0,0
33715,58378,2310,87,42,3,39,.929,3565000,0
33717,9482,2316,74,20,1,19,.950,3600000,0
33717,14321,3923,74,15,0,15,1000,1700000,0
33717,29799,2316,0,0,0,0,.00nan,0,0
33717,30859,3923,17,22,6,16,.727,1900000,0
33719,14321,3923,46,36,5,31,.861,3598000,0
33719,29775,618,94,35,3,32,.914,3600000,0
33719,30859,3923,0,0,0,0,.00nan,0,0
33719,65334,618,0,0,0,0,.00nan,0,0
33721,586,4534,27,31,6,25,.806,3600000,0
33721,13074,4534,0,0,0,0,.00nan,0,0
33721,13858,2319,61,19,2,17,.895,3600000,0
33721,30751,2319,0,0,0,0,.00nan,0,0
33723,16956,622,77,43,3,40,.930,3542000,0
33723,30193,622,0,0,0,0,.00nan,0,0
33723,31368,2310,0,0,0,0,.00nan,0,0
33723,58378,2310,86,36,2,34,.944,3600000,0
33725,12937,2308,59,34,3,31,.912,3542000,0
33725,13011,2308,0,0,0,0,.00nan,0,0
33725,13019,619,0,0,0,0,.00nan,0,0
33725,40280,619,99,40,2,38,.950,3600000,0
33729,833,611,100,26,0,26,1000,3600000,0
33729,11197,2306,0,0,0,0,.00nan,0,0
33729,11228,2306,73,29,2,27,.931,3600000,0
33729,65313,611,0,0,0,0,.00nan,0,0
33731,14321,3923,0,0,0,0,.00nan,0,0
33731,16956,622,0,0,0,0,.00nan,0,0
33731,30193,622,100,29,0,29,1000,3600000,0
33731,30859,3923,68,43,4,39,.907,3600000,0
33733,9482,2316,0,0,0,0,.00nan,0,0
33733,11197,2306,43,34,5,29,.853,3579000,0
33733,11228,2306,0,0,0,0,.00nan,0,0
33733,29799,2316,52,20,3,17,.850,3600000,0
33735,833,611,58,23,3,20,.870,3600000,0
33735,13858,2319,0,0,0,0,.00nan,0,0
33735,30751,2319,100,27,0,27,1000,3600000,0
33735,65313,611,0,0,0,0,.00nan,0,0
33739,586,4534,0,0,0,0,.00nan,0,0
33739,13074,4534,82,21,1,20,.952,3600000,0
33739,31368,2310,0,0,0,0,.00nan,0,0
33739,58378,2310,58,26,3,23,.885,3565000,0
33741,13019,619,74,31,2,29,.935,3600000,0
33741,27990,618,0,0,0,0,.00nan,0,0
33741,40280,619,0,0,0,0,.00nan,0,0
33741,65334,618,28,23,5,18,.783,3566000,0
33742,7813,715,51,19,3,16,.842,3600000,0
33742,28175,719,0,0,0,0,.00nan,0,0
33742,32223,715,0,0,0,0,.00nan,0,0
33742,54385,719,27,27,6,21,.778,3600000,0
33743,7533,717,0,0,0,0,.00nan,0,0
33743,14082,718,73,25,2,23,.920,3900000,0
33743,32181,718,0,0,0,0,.00nan,0,0
33743,54836,717,84,36,2,34,.944,3900000,0
33744,14082,718,65,26,2,24,.923,3600000,0
33744,28175,719,0,0,0,0,.00nan,0,0
33744,32181,718,0,0,0,0,.00nan,0,0
33744,54385,719,71,38,3,35,.921,3569000,0
33745,1543,2188,85,30,1,29,.967,3600000,0
33745,3212,2188,0,0,0,0,.00nan,0,0
33745,7813,715,73,35,3,32,.914,3556000,0
33745,32223,715,0,0,0,0,.00nan,0,0
33746,26684,716,69,21,1,20,.952,3600000,0
33746,28175,719,100,33,0,33,1000,3600000,0
33746,54385,719,0,0,0,0,.00nan,0,0
33746,61162,716,0,0,0,0,.00nan,0,0
33747,1543,2188,0,0,0,0,.00nan,0,0
33747,3212,2188,85,36,3,33,.917,3600000,0
33747,14082,718,0,0,0,0,.00nan,0,0
33747,32181,718,47,31,4,27,.871,3543000,0
33748,88,720,53,38,5,33,.868,3600000,0
33748,28151,721,65,24,2,22,.917,3600000,0
33748,28396,721,0,0,0,0,.00nan,0,0
33748,30734,720,0,0,0,0,.00nan,0,0
33749,14082,718,0,0,0,0,.00nan,0,0
33749,19186,2529,55,29,4,25,.862,3579000,0
33749,32181,718,66,33,3,30,.909,3600000,0
33749,61082,2529,0,0,0,0,.00nan,0,0
33750,1543,2188,55,26,4,22,.846,3600000,0
33750,3212,2188,0,0,0,0,.00nan,0,0
33750,26684,716,58,28,3,25,.893,3600000,0
33750,61162,716,0,0,0,0,.00nan,0,0
33751,7533,717,0,0,0,0,.00nan,0,0
33751,28175,719,46,28,4,24,.857,3600000,0
33751,54385,719,0,0,0,0,.00nan,0,0
33751,54836,717,41,25,5,20,.800,3578000,0
33752,7813,715,100,23,0,23,1000,3600000,0
33752,28151,721,47,36,5,31,.861,3600000,0
33752,28396,721,0,0,0,0,.00nan,0,0
33752,32223,715,0,0,0,0,.00nan,0,0
33753,19186,2529,60,35,4,31,.886,3600000,0
33753,26684,716,78,15,0,15,1000,3600000,0
33753,61082,2529,0,0,0,0,.00nan,0,0
33753,61162,716,0,0,0,0,.00nan,0,0
33754,88,720,49,21,3,18,.857,3553000,0
33754,7813,715,85,34,1,33,.971,3600000,0
33754,30734,720,0,0,0,0,.00nan,0,0
33754,32223,715,0,0,0,0,.00nan,0,0
33755,14082,718,62,21,2,19,.905,3517000,0
33755,28151,721,0,0,0,0,.00nan,0,0
33755,28396,721,100,26,0,26,1000,3600000,0
33755,32181,718,0,0,0,0,.00nan,0,0
33756,1543,2188,0,0,0,0,.00nan,0,0
33756,3212,2188,66,31,3,28,.903,3900000,0
33756,7533,717,0,0,0,0,.00nan,0,0
33756,54836,717,75,38,3,35,.921,3900000,0
33757,88,720,33,33,6,27,.818,3600000,0
33757,1543,2188,53,16,2,14,.875,3600000,0
33757,3212,2188,0,0,0,0,.00nan,0,0
33757,30734,720,0,0,0,0,.00nan,0,0
33758,7533,717,0,0,0,0,.00nan,0,0
33758,26684,716,66,39,4,35,.897,3600000,0
33758,54836,717,72,22,1,21,.955,3600000,0
33758,61162,716,0,0,0,0,.00nan,0,0
33759,19186,2529,98,35,1,34,.971,3600000,0
33759,28151,721,0,0,0,0,.00nan,0,0
33759,28396,721,78,36,3,33,.917,3563000,0
33759,61082,2529,0,0,0,0,.00nan,0,0
33760,88,720,72,40,4,36,.900,3600000,0
33760,14082,718,0,0,0,0,.00nan,0,0
33760,30734,720,0,0,0,0,.00nan,0,0
33760,32181,718,59,13,1,12,.923,3600000,0
33761,1543,2188,0,0,0,0,.00nan,0,0
33761,3212,2188,67,22,2,20,.909,3600000,0
33761,28175,719,0,0,0,0,.00nan,0,0
33761,54385,719,38,37,6,31,.838,3600000,0
33762,26684,716,61,26,3,23,.885,3900000,0
33762,28151,721,0,0,0,0,.00nan,0,0
33762,28396,721,70,31,3,28,.903,3900000,0
33762,61162,716,0,0,0,0,.00nan,0,0
33763,7533,717,36,25,5,20,.800,3596000,0
33763,19186,2529,71,36,4,32,.889,3600000,0
33763,30444,717,0,0,0,0,.00nan,0,0
33763,61082,2529,0,0,0,0,.00nan,0,0
33764,19186,2529,67,32,3,29,.906,3518000,0
33764,28175,719,76,23,1,22,.957,3600000,0
33764,54385,719,0,0,0,0,.00nan,0,0
33764,61082,2529,0,0,0,0,.00nan,0,0
33765,88,720,98,41,2,39,.951,3560000,0
33765,26684,716,74,24,1,23,.958,3600000,0
33765,30734,720,0,0,0,0,.00nan,0,0
33765,61162,716,0,0,0,0,.00nan,0,0
33766,7533,717,79,21,1,20,.952,2603000,0
33766,28151,721,0,0,0,0,.00nan,0,0
33766,28396,721,71,26,2,24,.923,3600000,0
33766,30444,717,9,12,5,7,.583,997000,0
33767,7813,715,45,35,5,30,.857,3545000,0
33767,14082,718,70,38,4,34,.895,3600000,0
33767,32181,718,0,0,0,0,.00nan,0,0
33767,32223,715,0,0,0,0,.00nan,0,0
33768,88,720,57,30,4,26,.867,3600000,0
33768,19186,2529,67,19,1,18,.947,3600000,0
33768,30734,720,0,0,0,0,.00nan,0,0
33768,61082,2529,0,0,0,0,.00nan,0,0
33769,7533,717,0,0,0,0,.00nan,0,0
33769,26684,716,0,0,0,0,.00nan,0,0
33769,30444,717,55,33,4,29,.879,3600000,0
33769,61162,716,37,28,5,23,.821,3582000,0
33770,28151,721,66,36,4,32,.889,3600000,0
33770,28175,719,90,18,0,18,1000,3600000,0
33770,28396,721,0,0,0,0,.00nan,0,0
33770,54385,719,0,0,0,0,.00nan,0,0
33771,1543,2188,0,0,0,0,.00nan,0,0
33771,3212,2188,81,35,2,33,.943,3600000,0
33771,19186,2529,82,23,1,22,.957,3600000,0
33771,61082,2529,0,0,0,0,.00nan,0,0
33772,88,720,40,20,4,16,.800,3600000,0
33772,7533,717,0,0,0,0,.00nan,0,0
33772,30444,717,86,40,3,37,.925,3600000,0
33772,30734,720,0,0,0,0,.00nan,0,0
33773,7813,715,70,37,3,34,.919,3900000,0
33773,26684,716,68,29,3,26,.897,3900000,0
33773,32223,715,0,0,0,0,.00nan,0,0
33773,61162,716,0,0,0,0,.00nan,0,0
33774,14082,718,81,26,1,25,.962,3600000,0
33774,26684,716,64,28,2,26,.929,3573000,0
33774,32181,718,0,0,0,0,.00nan,0,0
33774,61162,716,0,0,0,0,.00nan,0,0
33775,88,720,70,39,4,35,.897,3542000,0
33775,28175,719,58,25,3,22,.880,3600000,0
33775,30734,720,0,0,0,0,.00nan,0,0
33775,54385,719,0,0,0,0,.00nan,0,0
33776,1543,2188,46,22,4,18,.818,3540000,0
33776,3212,2188,0,0,0,0,.00nan,0,0
33776,28151,721,0,0,0,0,.00nan,0,0
33776,28396,721,79,32,2,30,.938,3600000,0
33777,7533,717,0,0,0,0,.00nan,0,0
33777,7813,715,0,0,0,0,.00nan,0,0
33777,30444,717,52,30,4,26,.867,3635000,0
33777,32223,715,44,27,5,22,.815,3635000,0
33778,7533,717,66,19,1,18,.947,2985000,0
33778,14082,718,0,0,0,0,.00nan,0,0
33778,30444,717,27,7,3,4,.571,591000,0
33778,32181,718,65,30,3,27,.900,3600000,0
33779,88,720,100,35,0,35,1000,3600000,0
33779,1543,2188,0,0,0,0,.00nan,0,0
33779,3212,2188,68,27,2,25,.926,3569000,0
33779,30734,720,0,0,0,0,.00nan,0,0
33780,7813,715,57,18,2,16,.889,3577000,0
33780,28175,719,0,0,0,0,.00nan,0,0
33780,32223,715,0,0,0,0,.00nan,0,0
33780,54385,719,92,30,1,29,.967,3600000,0
33781,14082,718,96,35,1,34,.971,3600000,0
33781,28175,719,13,20,6,14,.700,3324000,0
33781,32181,718,0,0,0,0,.00nan,0,0
33781,54385,719,51,3,0,3,1000,276000,0
33782,1543,2188,50,28,3,25,.893,3900000,0
33782,3212,2188,0,0,0,0,.00nan,0,0
33782,7813,715,56,23,3,20,.870,3900000,0
33782,32223,715,0,0,0,0,.00nan,0,0
33783,88,720,84,44,3,41,.932,3578000,0
33783,19186,2529,0,0,0,0,.00nan,0,0
33783,30734,720,0,0,0,0,.00nan,0,0
33783,61082,2529,69,23,2,21,.913,3600000,0
33785,88,720,100,33,0,33,1000,3600000,0
33785,28151,721,0,0,0,0,.00nan,0,0
33785,28396,721,61,16,2,14,.875,3552000,0
33785,30734,720,0,0,0,0,.00nan,0,0
33786,26684,716,67,26,2,24,.923,3600000,0
33786,28175,719,65,33,3,30,.909,3555000,0
33786,54385,719,0,0,0,0,.00nan,0,0
33786,61162,716,0,0,0,0,.00nan,0,0
33787,7813,715,72,28,2,26,.929,3600000,0
33787,19186,2529,31,27,6,21,.778,3078000,0
33787,32223,715,0,0,0,0,.00nan,0,0
33787,61082,2529,52,4,0,4,1000,522000,0
33788,7533,717,0,0,0,0,.00nan,0,0
33788,28175,719,70,22,1,21,.955,3600000,0
33788,30444,717,43,31,5,26,.839,3600000,0
33788,54385,719,0,0,0,0,.00nan,0,0
33789,1543,2188,0,0,0,0,.00nan,0,0
33789,3212,2188,75,29,2,27,.931,3600000,0
33789,26684,716,58,28,4,24,.857,3559000,0
33789,61162,716,0,0,0,0,.00nan,0,0
33790,14082,718,42,25,4,21,.840,3600000,0
33790,19186,2529,100,39,1,38,.974,3600000,0
33790,32181,718,0,0,0,0,.00nan,0,0
33790,61082,2529,0,0,0,0,.00nan,0,0
33791,7813,715,64,25,2,23,.920,3600000,0
33791,28151,721,30,14,4,10,.714,3600000,0
33791,28396,721,0,0,0,0,.00nan,0,0
33791,32223,715,0,0,0,0,.00nan,0,0
33792,7533,717,37,25,5,20,.800,3600000,0
33792,28175,719,0,0,0,0,.00nan,0,0
33792,30444,717,0,0,0,0,.00nan,0,0
33792,54385,719,73,25,2,23,.920,3600000,0
33793,7813,715,0,0,0,0,.00nan,0,0
33793,14082,718,52,22,3,19,.864,3600000,0
33793,32181,718,0,0,0,0,.00nan,0,0
33793,32223,715,73,41,4,37,.902,3562000,0
33794,14082,718,0,0,0,0,.00nan,0,0
33794,28151,721,48,8,1,7,.875,1052000,0
33794,28396,721,32,30,6,24,.800,2548000,0
33794,32181,718,70,18,1,17,.944,3600000,0
33795,1543,2188,0,0,0,0,.00nan,0,0
33795,3212,2188,48,25,3,22,.880,3552000,0
33795,7533,717,0,0,0,0,.00nan,0,0
33795,30444,717,83,34,2,32,.941,3600000,0
33796,19186,2529,43,32,6,26,.813,3873000,0
33796,26684,716,30,29,6,23,.793,3900000,0
33796,61082,2529,0,0,0,0,.00nan,0,0
33796,61162,716,0,0,0,0,.00nan,0,0
33797,88,720,97,37,1,36,.973,3900000,0
33797,7813,715,94,31,1,30,.968,3900000,0
33797,30734,720,0,0,0,0,.00nan,0,0
33797,32223,715,0,0,0,0,.00nan,0,0
33798,26684,716,87,28,1,27,.964,3600000,0
33798,28151,721,0,0,0,0,.00nan,0,0
33798,28396,721,78,28,2,26,.929,3548000,0
33798,61162,716,0,0,0,0,.00nan,0,0
33799,88,720,94,31,1,30,.968,3900000,0
33799,14082,718,99,39,1,38,.974,3900000,0
33799,30734,720,0,0,0,0,.00nan,0,0
33799,32181,718,0,0,0,0,.00nan,0,0
33800,1543,2188,70,25,2,23,.920,3600000,0
33800,3212,2188,0,0,0,0,.00nan,0,0
33800,28175,719,0,0,0,0,.00nan,0,0
33800,54385,719,55,23,3,20,.870,3600000,0
33801,7533,717,0,0,0,0,.00nan,0,0
33801,19186,2529,68,33,3,30,.909,3900000,0
33801,30444,717,67,36,3,33,.917,3900000,0
33801,61082,2529,0,0,0,0,.00nan,0,0
33887,1543,2188,0,0,0,0,.00nan,0,0
33887,3212,2188,43,30,5,25,.833,3900000,0
33887,28151,719,0,0,0,0,.00nan,0,0
33887,54385,719,57,35,5,30,.857,3900000,0
33889,7533,717,0,0,0,0,.00nan,0,0
33889,26684,716,41,25,4,21,.840,3515000,0
33889,30444,717,86,42,2,40,.952,3600000,0
33889,33546,716,0,0,0,0,.00nan,0,0
33891,7813,715,78,26,1,25,.962,3600000,0
33891,19186,2529,73,31,3,28,.903,3583000,0
33891,32223,715,0,0,0,0,.00nan,0,0
33891,61082,2529,0,0,0,0,.00nan,0,0
33893,14082,718,83,26,1,25,.962,3600000,0
33893,28175,721,62,28,3,25,.893,3588000,0
33893,28396,721,0,0,0,0,.00nan,0,0
33893,32181,718,0,0,0,0,.00nan,0,0
33895,88,720,90,59,4,55,.932,3600000,0
33895,26684,716,0,0,0,0,.00nan,0,0
33895,30734,720,0,0,0,0,.00nan,0,0
33895,33546,716,69,20,1,19,.950,3600000,0
33897,7533,717,55,18,2,16,.889,3600000,0
33897,28151,719,61,38,5,33,.868,3600000,0
33897,30444,717,0,0,0,0,.00nan,0,0
33897,54385,719,0,0,0,0,.00nan,0,0
33899,14082,718,0,0,0,0,.00nan,0,0
33899,28175,721,80,21,0,21,1000,1835000,0
33899,28396,721,31,29,6,23,.793,1765000,0
33899,32181,718,66,27,3,24,.889,3600000,0
33901,7813,715,0,0,0,0,.00nan,0,0
33901,19186,2529,49,34,6,28,.824,3600000,0
33901,32223,715,44,15,3,12,.800,3600000,0
33901,61082,2529,0,0,0,0,.00nan,0,0
33903,7533,717,0,0,0,0,.00nan,0,0
33903,7813,715,51,34,5,29,.853,3522000,0
33903,30444,717,58,23,3,20,.870,3600000,0
33903,32223,715,0,0,0,0,.00nan,0,0
33905,88,720,77,40,3,37,.925,3589000,0
33905,26684,716,55,21,2,19,.905,3600000,0
33905,30734,720,0,0,0,0,.00nan,0,0
33905,61162,716,0,0,0,0,.00nan,0,0
33909,1543,2188,59,29,3,26,.897,3600000,0
33909,3212,2188,0,0,0,0,.00nan,0,0
33909,19186,2529,0,0,0,0,.00nan,0,0
33909,61082,2529,38,26,5,21,.808,3548000,0
33911,19186,2529,51,36,4,32,.889,3600000,0
33911,26684,716,0,0,0,0,.00nan,0,0
33911,61082,2529,0,0,0,0,.00nan,0,0
33911,61162,716,76,21,1,20,.952,3600000,0
33913,88,720,0,0,0,0,.00nan,0,0
33913,1543,2188,0,0,0,0,.00nan,0,0
33913,3212,2188,63,21,2,19,.905,3600000,0
33913,30734,720,54,32,4,28,.875,3559000,0
33915,7533,717,57,28,3,25,.893,3900000,0
33915,28151,721,67,34,3,31,.912,3900000,0
33915,28396,721,0,0,0,0,.00nan,0,0
33915,30444,717,0,0,0,0,.00nan,0,0
33919,1543,2188,68,25,3,22,.880,3587000,0
33919,3212,2188,0,0,0,0,.00nan,0,0
33919,7813,715,99,44,2,42,.955,3600000,0
33919,32223,715,0,0,0,0,.00nan,0,0
33923,7533,717,0,0,0,0,.00nan,0,0
33923,28175,719,82,30,1,29,.967,3900000,0
33923,30444,717,100,38,1,37,.974,3900000,0
33923,54385,719,0,0,0,0,.00nan,0,0
33925,19186,2529,57,32,3,29,.906,3519000,0
33925,28151,721,0,0,0,0,.00nan,0,0
33925,28396,721,69,22,1,21,.955,3600000,0
33925,61082,2529,0,0,0,0,.00nan,0,0
33926,1730,480,65,27,3,24,.889,3600000,0
33926,26393,472,62,37,4,33,.892,3585000,0
33926,30633,480,0,0,0,0,.00nan,0,0
33926,50764,472,0,0,0,0,.00nan,0,0
33927,10413,5004,0,0,0,0,.00nan,0,0
33927,22192,676,50,28,4,24,.857,3564000,0
33927,30691,676,0,0,0,0,.00nan,0,0
33927,40727,5004,66,26,3,23,.885,3600000,0
33928,12787,4535,74,45,4,41,.911,3600000,0
33928,34425,476,0,0,0,0,.00nan,0,0
33928,44268,476,94,32,1,31,.969,3600000,0
33928,58617,4535,0,0,0,0,.00nan,0,0
33929,4461,490,78,35,2,33,.943,4020000,0
33929,12467,482,63,25,2,23,.920,4020000,0
33929,26501,490,0,0,0,0,.00nan,0,0
33929,28316,482,0,0,0,0,.00nan,0,0
33930,12526,675,68,25,2,23,.920,3600000,0
33930,16026,481,29,28,6,22,.786,3600000,0
33930,20196,675,0,0,0,0,.00nan,0,0
33930,47051,481,0,0,0,0,.00nan,0,0
33931,617,682,69,25,2,23,.920,4020000,0
33931,14248,473,66,22,2,20,.909,4020000,0
33931,45056,473,0,0,0,0,.00nan,0,0
33931,54165,682,0,0,0,0,.00nan,0,0
33932,12467,482,0,0,0,0,.00nan,0,0
33932,14248,473,0,0,0,0,.00nan,0,0
33932,28316,482,61,18,2,16,.889,3600000,0
33932,45056,473,60,30,3,27,.900,3600000,0
33933,1730,480,0,0,0,0,.00nan,0,0
33933,12787,4535,68,42,5,37,.881,3600000,0
33933,30633,480,70,25,2,23,.920,3600000,0
33933,58617,4535,0,0,0,0,.00nan,0,0
33934,10413,5004,0,0,0,0,.00nan,0,0
33934,13841,474,0,0,0,0,.00nan,0,0
33934,26995,474,80,28,1,27,.964,3600000,0
33934,40727,5004,43,23,4,19,.826,3600000,0
33935,16026,481,0,0,0,0,.00nan,0,0
33935,34425,476,0,0,0,0,.00nan,0,0
33935,44268,476,65,31,3,28,.903,3600000,0
33935,47051,481,95,33,2,31,.939,3600000,0
33936,617,682,86,49,3,46,.939,3600000,0
33936,26393,472,0,0,0,0,.00nan,0,0
33936,50764,472,81,16,0,16,1000,3600000,0
33936,54165,682,0,0,0,0,.00nan,0,0
33937,12526,675,57,13,1,12,.923,1134000,0
33937,20196,675,25,27,6,21,.778,2466000,0
33937,22192,676,30,35,7,28,.800,2980000,0
33937,30691,676,49,7,1,6,.857,569000,0
33938,12467,482,34,21,5,16,.762,3545000,0
33938,28316,482,0,0,0,0,.00nan,0,0
33938,34425,476,0,0,0,0,.00nan,0,0
33938,44268,476,37,22,4,18,.818,3600000,0
33939,1730,480,0,0,0,0,.00nan,0,0
33939,10413,5004,99,24,0,24,1000,3600000,0
33939,30633,480,45,25,4,21,.840,3600000,0
33939,40727,5004,0,0,0,0,.00nan,0,0
33940,13841,474,0,0,0,0,.00nan,0,0
33940,14248,473,88,34,2,32,.941,4020000,0
33940,26995,474,82,34,2,32,.941,4020000,0
33940,45056,473,0,0,0,0,.00nan,0,0
33941,12787,4535,0,0,0,0,.00nan,0,0
33941,16026,481,80,31,3,28,.903,3551000,0
33941,47051,481,0,0,0,0,.00nan,0,0
33941,58617,4535,60,14,1,13,.929,3600000,0
33942,4461,490,81,28,1,27,.964,3600000,0
33942,12526,675,91,41,3,38,.927,3521000,0
33942,20196,675,0,0,0,0,.00nan,0,0
33942,26501,490,0,0,0,0,.00nan,0,0
33943,22192,676,0,0,0,0,.00nan,0,0
33943,26393,472,49,2,0,2,1000,319000,0
33943,30691,676,62,21,2,19,.905,3600000,0
33943,50764,472,45,29,5,24,.828,3281000,0
33944,26393,472,59,28,3,25,.893,3541000,0
33944,34425,476,89,24,1,23,.958,3600000,0
33944,44268,476,0,0,0,0,.00nan,0,0
33944,50764,472,0,0,0,0,.00nan,0,0
33945,617,682,67,35,3,32,.914,3600000,0
33945,1730,480,44,20,4,16,.800,3578000,0
33945,30633,480,0,0,0,0,.00nan,0,0
33945,54165,682,0,0,0,0,.00nan,0,0
33946,12526,675,44,29,5,24,.828,3600000,0
33946,13841,474,83,34,2,32,.941,3600000,0
33946,20196,675,0,0,0,0,.00nan,0,0
33946,26995,474,0,0,0,0,.00nan,0,0
33947,12467,482,54,20,2,18,.900,3600000,0
33947,12787,4535,46,30,5,25,.833,3600000,0
33947,28316,482,0,0,0,0,.00nan,0,0
33947,58617,4535,0,0,0,0,.00nan,0,0
33948,14248,473,48,22,4,18,.818,3562000,0
33948,22192,676,91,38,2,36,.947,3600000,0
33948,30691,676,0,0,0,0,.00nan,0,0
33948,45056,473,0,0,0,0,.00nan,0,0
33949,4461,490,35,22,4,18,.818,2003000,0
33949,22192,676,90,39,2,37,.949,3600000,0
33949,26501,490,56,5,0,5,1000,1548000,0
33949,30691,676,0,0,0,0,.00nan,0,0
33950,10413,5004,79,30,2,28,.933,3545000,0
33950,16026,481,0,0,0,0,.00nan,0,0
33950,40727,5004,0,0,0,0,.00nan,0,0
33950,47051,481,82,23,1,22,.957,3600000,0
33951,14248,473,30,8,3,5,.625,520000,0
33951,34425,476,54,3,0,3,1000,452000,0
33951,44268,476,45,36,6,30,.833,3148000,0
33951,45056,473,40,28,5,23,.821,3014000,0
33952,12526,675,64,29,3,26,.897,3581000,0
33952,12787,4535,77,25,1,24,.960,3600000,0
33952,20196,675,0,0,0,0,.00nan,0,0
33952,58617,4535,0,0,0,0,.00nan,0,0
33953,617,682,49,38,5,33,.868,3600000,0
33953,12467,482,64,16,1,15,.938,3600000,0
33953,28316,482,0,0,0,0,.00nan,0,0
33953,54165,682,0,0,0,0,.00nan,0,0
33954,4461,490,0,0,0,0,.00nan,0,0
33954,13841,474,62,7,0,7,1000,317000,0
33954,26501,490,56,29,4,25,.862,3600000,0
33954,26995,474,35,34,6,28,.824,3283000,0
33955,1730,480,55,27,3,24,.889,3826000,0
33955,22192,676,0,0,0,0,.00nan,0,0
33955,30633,480,0,0,0,0,.00nan,0,0
33955,30691,676,100,53,2,51,.962,3826000,0
33956,1730,480,0,0,0,0,.00nan,0,0
33956,16026,481,70,30,3,27,.900,3600000,0
33956,30633,480,35,27,5,22,.815,3580000,0
33956,47051,481,0,0,0,0,.00nan,0,0
33957,13841,474,0,0,0,0,.00nan,0,0
33957,14248,473,0,0,0,0,.00nan,0,0
33957,26995,474,66,37,5,32,.865,3519000,0
33957,45056,473,60,25,3,22,.880,3600000,0
33958,12467,482,61,16,1,15,.938,3600000,0
33958,12526,675,94,42,2,40,.952,3573000,0
33958,20196,675,0,0,0,0,.00nan,0,0
33958,28316,482,0,0,0,0,.00nan,0,0
33959,617,682,61,41,4,37,.902,3600000,0
33959,4461,490,86,25,1,24,.960,3600000,0
33959,26501,490,0,0,0,0,.00nan,0,0
33959,54165,682,0,0,0,0,.00nan,0,0
33960,12787,4535,68,33,3,30,.909,3544000,0
33960,26393,472,63,22,2,20,.909,3600000,0
33960,50764,472,0,0,0,0,.00nan,0,0
33960,58617,4535,0,0,0,0,.00nan,0,0
33961,10413,5004,0,0,0,0,.00nan,0,0
33961,22192,676,87,19,0,19,1000,3600000,0
33961,30691,676,0,0,0,0,.00nan,0,0
33961,40727,5004,80,23,1,22,.957,3565000,0
33962,16026,481,36,26,5,21,.808,3600000,0
33962,34425,476,0,0,0,0,.00nan,0,0
33962,44268,476,57,12,1,11,.917,3600000,0
33962,47051,481,0,0,0,0,.00nan,0,0
33963,617,682,77,33,2,31,.939,3587000,0
33963,1730,480,85,26,1,25,.962,3600000,0
33963,30633,480,0,0,0,0,.00nan,0,0
33963,54165,682,0,0,0,0,.00nan,0,0
33964,12787,4535,88,52,4,48,.923,3600000,0
33964,14248,473,61,18,1,17,.944,3600000,0
33964,45056,473,0,0,0,0,.00nan,0,0
33964,58617,4535,0,0,0,0,.00nan,0,0
33965,10413,5004,56,4,0,4,1000,524000,0
33965,12467,482,54,4,0,4,1000,385000,0
33965,28316,482,26,34,7,27,.794,3193000,0
33965,40727,5004,24,23,6,17,.739,3076000,0
33966,4461,490,93,46,3,43,.935,3969000,0
33966,26393,472,84,47,4,43,.915,3969000,0
33966,26501,490,0,0,0,0,.00nan,0,0
33966,50764,472,0,0,0,0,.00nan,0,0
33967,13841,474,66,9,0,9,1000,280000,0
33967,22192,676,51,24,4,20,.833,3600000,0
33967,26995,474,38,31,6,25,.806,3320000,0
33967,30691,676,0,0,0,0,.00nan,0,0
33968,14248,473,0,0,0,0,.00nan,0,0
33968,26393,472,0,0,0,0,.00nan,0,0
33968,45056,473,68,52,5,47,.904,3549000,0
33968,50764,472,65,37,4,33,.892,3600000,0
33969,13841,474,0,0,0,0,.00nan,0,0
33969,16026,481,0,0,0,0,.00nan,0,0
33969,26995,474,67,29,3,26,.897,3600000,0
33969,47051,481,38,27,5,22,.815,3550000,0
33970,1730,480,0,0,0,0,.00nan,0,0
33970,12526,675,73,43,4,39,.907,4006000,0
33970,20196,675,0,0,0,0,.00nan,0,0
33970,30633,480,80,42,3,39,.929,4006000,0
33971,12467,482,89,29,1,28,.966,3600000,0
33971,22192,676,66,37,4,33,.892,3600000,0
33971,28316,482,0,0,0,0,.00nan,0,0
33971,30691,676,0,0,0,0,.00nan,0,0
33972,617,682,0,0,0,0,.00nan,0,0
33972,10413,5004,59,19,2,17,.895,3600000,0
33972,40727,5004,0,0,0,0,.00nan,0,0
33972,54165,682,54,29,4,25,.862,3520000,0
33974,10413,5004,0,0,0,0,.00nan,0,0
33974,12787,4535,73,32,3,29,.906,3570000,0
33974,40727,5004,60,20,2,18,.900,3600000,0
33974,58617,4535,0,0,0,0,.00nan,0,0
33975,12467,482,100,34,1,33,.971,3600000,0
33975,13841,474,0,0,0,0,.00nan,0,0
33975,26995,474,71,33,3,30,.909,3521000,0
33975,28316,482,0,0,0,0,.00nan,0,0
33976,617,682,78,35,3,32,.914,3600000,0
33976,26393,472,53,41,5,36,.878,3571000,0
33976,50764,472,0,0,0,0,.00nan,0,0
33976,54165,682,0,0,0,0,.00nan,0,0
33977,14248,473,84,37,2,35,.946,3600000,0
33977,22192,676,0,0,0,0,.00nan,0,0
33977,30691,676,84,27,1,26,.963,3600000,0
33977,45056,473,0,0,0,0,.00nan,0,0
33978,14248,473,45,26,4,22,.846,3804000,0
33978,16026,481,0,0,0,0,.00nan,0,0
33978,45056,473,0,0,0,0,.00nan,0,0
33978,47051,481,51,26,3,23,.885,3804000,0
33979,617,682,0,0,0,0,.00nan,0,0
33979,12787,4535,0,0,0,0,.00nan,0,0
33979,54165,682,100,25,0,25,1000,3600000,0
33979,58617,4535,56,36,4,32,.889,3600000,0
33980,10413,5004,56,31,4,27,.871,3600000,0
33980,13841,474,0,0,0,0,.00nan,0,0
33980,26995,474,70,28,1,27,.964,3600000,0
33980,40727,5004,0,0,0,0,.00nan,0,0
33981,12526,675,45,36,5,31,.861,3542000,0
33981,20196,675,0,0,0,0,.00nan,0,0
33981,22192,676,0,0,0,0,.00nan,0,0
33981,30691,676,49,25,4,21,.840,3600000,0
33982,1730,480,0,0,0,0,.00nan,0,0
33982,4461,490,0,0,0,0,.00nan,0,0
33982,26501,490,51,20,3,17,.850,3529000,0
33982,30633,480,96,28,1,27,.964,3600000,0
33983,1730,480,0,0,0,0,.00nan,0,0
33983,16026,481,51,33,4,29,.879,3531000,0
33983,30633,480,59,18,2,16,.889,3600000,0
33983,47051,481,0,0,0,0,.00nan,0,0
33985,10413,5004,45,40,6,34,.850,3815000,0
33985,34425,476,43,29,5,24,.828,3815000,0
33985,40727,5004,0,0,0,0,.00nan,0,0
33985,44268,476,0,0,0,0,.00nan,0,0
33986,12467,482,35,27,5,22,.815,3600000,0
33986,14248,473,0,0,0,0,.00nan,0,0
33986,28316,482,0,0,0,0,.00nan,0,0
33986,45056,473,55,47,6,41,.872,3600000,0
33987,12787,4535,82,16,0,16,1000,3600000,0
33987,13841,474,0,0,0,0,.00nan,0,0
33987,26995,474,40,27,5,22,.815,3600000,0
33987,58617,4535,0,0,0,0,.00nan,0,0
33988,1730,480,0,0,0,0,.00nan,0,0
33988,12526,675,0,0,0,0,.00nan,0,0
33988,20196,675,70,31,2,29,.935,3600000,0
33988,30633,480,79,23,1,22,.957,3600000,0
33989,16026,481,0,0,0,0,.00nan,0,0
33989,26393,472,68,40,5,35,.875,3600000,0
33989,47051,481,77,31,2,29,.935,3600000,0
33989,50764,472,0,0,0,0,.00nan,0,0
33990,617,682,0,0,0,0,.00nan,0,0
33990,4461,490,100,29,0,29,1000,3600000,0
33990,26501,490,0,0,0,0,.00nan,0,0
33990,54165,682,73,23,1,22,.957,3600000,0
33991,1730,480,62,26,3,23,.885,3600000,0
33991,14248,473,74,24,1,23,.958,3600000,0
33991,30633,480,0,0,0,0,.00nan,0,0
33991,45056,473,0,0,0,0,.00nan,0,0
33993,10413,5004,0,0,0,0,.00nan,0,0
33993,12526,675,77,32,2,30,.938,3839000,0
33993,20196,675,0,0,0,0,.00nan,0,0
33993,40727,5004,63,24,3,21,.875,3839000,0
33994,617,682,71,37,3,34,.919,3585000,0
33994,13841,474,81,30,1,29,.967,3600000,0
33994,26995,474,0,0,0,0,.00nan,0,0
33994,54165,682,0,0,0,0,.00nan,0,0
33995,12467,482,60,40,5,35,.875,3600000,0
33995,26393,472,80,31,2,29,.935,3600000,0
33995,28316,482,0,0,0,0,.00nan,0,0
33995,50764,472,0,0,0,0,.00nan,0,0
33996,4461,490,69,29,3,26,.897,3600000,0
33996,22192,676,0,0,0,0,.00nan,0,0
33996,26501,490,0,0,0,0,.00nan,0,0
33996,30691,676,65,34,4,30,.882,3544000,0
34241,10413,5004,0,0,0,0,.00nan,0,0
34241,26393,472,99,40,1,39,.975,3600000,0
34241,40727,5004,65,36,4,32,.889,3600000,0
34241,50764,472,0,0,0,0,.00nan,0,0
34243,617,682,55,39,5,34,.872,3557000,0
34243,12787,4535,72,38,4,34,.895,3600000,0
34243,30313,682,0,0,0,0,.00nan,0,0
34243,58617,4535,0,0,0,0,.00nan,0,0
34247,12526,675,53,22,3,19,.864,3568000,0
34247,12869,473,0,0,0,0,.00nan,0,0
34247,14248,473,99,40,1,39,.975,3600000,0
34247,20196,675,0,0,0,0,.00nan,0,0
34253,12547,481,0,0,0,0,.00nan,0,0
34253,13841,474,0,0,0,0,.00nan,0,0
34253,16026,481,100,39,1,38,.974,4020000,0
34253,26995,474,81,26,1,25,.962,4020000,0
34255,1730,480,0,0,0,0,.00nan,0,0
34255,26393,472,0,0,0,0,.00nan,0,0
34255,30633,480,60,36,4,32,.889,3600000,0
34255,50764,472,77,32,1,31,.969,3600000,0
34259,617,682,0,0,0,0,.00nan,0,0
34259,10413,5004,59,27,3,24,.889,3542000,0
34259,30313,682,99,34,1,33,.971,3600000,0
34259,40727,5004,0,0,0,0,.00nan,0,0
34261,12526,675,0,0,0,0,.00nan,0,0
34261,12752,490,0,0,0,0,.00nan,0,0
34261,20196,675,52,27,4,23,.852,3543000,0
34261,26501,490,64,30,3,27,.900,3600000,0
34263,1730,480,53,34,4,30,.882,4020000,0
34263,10413,5004,0,0,0,0,.00nan,0,0
34263,30633,480,0,0,0,0,.00nan,0,0
34263,40727,5004,68,38,4,34,.895,4020000,0
34265,617,682,78,23,1,22,.957,3600000,0
34265,13841,474,66,39,4,35,.897,3600000,0
34265,26995,474,0,0,0,0,.00nan,0,0
34265,30313,682,0,0,0,0,.00nan,0,0
34269,12869,473,0,0,0,0,.00nan,0,0
34269,14248,473,75,28,2,26,.929,3600000,0
34269,26393,472,0,0,0,0,.00nan,0,0
34269,50764,472,71,43,5,38,.884,3600000,0
34271,12547,481,72,24,1,23,.958,4020000,0
34271,12787,4535,97,43,1,42,.977,4019000,0
34271,16026,481,0,0,0,0,.00nan,0,0
34271,58617,4535,0,0,0,0,.00nan,0,0
34275,12547,481,0,0,0,0,.00nan,0,0
34275,12869,473,0,0,0,0,.00nan,0,0
34275,14248,473,56,23,3,20,.870,3600000,0
34275,16026,481,45,27,5,22,.815,3555000,0
34277,12467,482,68,28,2,26,.929,3600000,0
34277,13841,474,0,0,0,0,.00nan,0,0
34277,26995,474,92,34,1,33,.971,3600000,0
34277,28316,482,0,0,0,0,.00nan,0,0
34279,10413,5004,69,46,4,42,.913,3544000,0
34279,26393,472,0,0,0,0,.00nan,0,0
34279,40727,5004,0,0,0,0,.00nan,0,0
34279,50764,472,59,26,3,23,.885,3600000,0
34281,1730,480,0,0,0,0,.00nan,0,0
34281,22192,676,0,0,0,0,.00nan,0,0
34281,30633,480,38,22,4,18,.818,3549000,0
34281,30691,676,81,35,3,32,.914,3600000,0
34283,12526,675,98,33,2,31,.939,3600000,0
34283,20196,675,0,0,0,0,.00nan,0,0
34283,33581,476,0,0,0,0,.00nan,0,0
34283,44268,476,62,28,3,25,.893,3561000,0
34285,617,682,100,36,0,36,1000,3600000,0
34285,12752,490,0,0,0,0,.00nan,0,0
34285,26501,490,31,23,5,18,.783,3600000,0
34285,30313,682,0,0,0,0,.00nan,0,0
34287,12467,482,0,0,0,0,.00nan,0,0
34287,26393,472,93,32,1,31,.969,3600000,0
34287,28316,482,73,31,2,29,.935,3548000,0
34287,50764,472,0,0,0,0,.00nan,0,0
34289,1730,480,55,25,3,22,.880,3600000,0
34289,30633,480,0,0,0,0,.00nan,0,0
34289,33581,476,43,36,5,31,.861,3564000,0
34289,44268,476,0,0,0,0,.00nan,0,0
34291,12752,490,67,24,2,22,.917,3600000,0
34291,12787,4535,47,26,4,22,.846,3590000,0
34291,26501,490,0,0,0,0,.00nan,0,0
34291,58617,4535,0,0,0,0,.00nan,0,0
34293,617,682,28,31,6,25,.806,3600000,0
34293,13841,474,52,23,3,20,.870,3600000,0
34293,26995,474,0,0,0,0,.00nan,0,0
34293,30313,682,0,0,0,0,.00nan,0,0
34295,10413,5004,0,0,0,0,.00nan,0,0
34295,22192,676,52,35,5,30,.857,4020000,0
34295,30691,676,0,0,0,0,.00nan,0,0
34295,40727,5004,42,35,5,30,.857,4020000,0
34297,12526,675,0,0,0,0,.00nan,0,0
34297,12869,473,78,35,1,34,.971,3545000,0
34297,14248,473,0,0,0,0,.00nan,0,0
34297,20196,675,100,29,0,29,1000,3600000,0
34299,12526,675,0,0,0,0,.00nan,0,0
34299,12752,490,0,0,0,0,.00nan,0,0
34299,20196,675,60,26,3,23,.885,3600000,0
34299,26501,490,81,35,2,33,.943,3600000,0
34301,22192,676,0,0,0,0,.00nan,0,0
34301,26393,472,78,20,1,19,.950,3600000,0
34301,30691,676,64,29,3,26,.897,3523000,0
34301,50764,472,0,0,0,0,.00nan,0,0
34303,617,682,86,35,2,33,.943,3600000,0
34303,1730,480,66,21,1,20,.952,3600000,0
34303,30313,682,0,0,0,0,.00nan,0,0
34303,30633,480,0,0,0,0,.00nan,0,0
34305,12467,482,100,39,0,39,1000,3600000,0
34305,28316,482,0,0,0,0,.00nan,0,0
34305,33581,476,0,0,0,0,.00nan,0,0
34305,44268,476,86,27,1,26,.963,3600000,0
34307,10413,5004,0,0,0,0,.00nan,0,0
34307,12547,481,0,0,0,0,.00nan,0,0
34307,16026,481,100,22,0,22,1000,3600000,0
34307,40727,5004,67,34,3,31,.912,3600000,0
34309,12869,473,0,0,0,0,.00nan,0,0
34309,13841,474,0,0,0,0,.00nan,0,0
34309,14248,473,81,21,1,20,.952,3600000,0
34309,26995,474,77,29,2,27,.931,3562000,0
34311,13841,474,37,24,5,19,.792,3521000,0
34311,22192,676,57,28,3,25,.893,3600000,0
34311,26995,474,0,0,0,0,.00nan,0,0
34311,30691,676,0,0,0,0,.00nan,0,0
34313,12467,482,82,25,2,23,.920,3600000,0
34313,12752,490,58,29,3,26,.897,3586000,0
34313,26501,490,0,0,0,0,.00nan,0,0
34313,28316,482,0,0,0,0,.00nan,0,0
34315,10413,5004,68,38,4,34,.895,3600000,0
34315,12526,675,77,27,1,26,.963,3600000,0
34315,20196,675,0,0,0,0,.00nan,0,0
34315,40727,5004,0,0,0,0,.00nan,0,0
34317,1730,480,0,0,0,0,.00nan,0,0
34317,26393,472,0,0,0,0,.00nan,0,0
34317,30633,480,57,18,3,15,.833,4020000,0
34317,50764,472,59,32,3,29,.906,4020000,0
34319,617,682,91,41,3,38,.927,3600000,0
34319,12787,4535,95,21,0,21,1000,3600000,0
34319,30313,682,0,0,0,0,.00nan,0,0
34319,58617,4535,0,0,0,0,.00nan,0,0
34321,12547,481,0,0,0,0,.00nan,0,0
34321,12869,473,14,27,7,20,.741,3102000,0
34321,14248,473,60,8,0,8,1000,498000,0
34321,16026,481,70,27,2,25,.926,3600000,0
34322,6730,495,0,0,0,0,.00nan,0,0
34322,9153,2591,0,0,0,0,.00nan,0,0
34322,31033,2591,63,22,2,20,.909,3600000,0
34322,52902,495,51,29,4,25,.862,3556000,0
34323,17814,505,54,20,3,17,.850,3600000,0
34323,34013,497,0,0,0,0,.00nan,0,0
34323,65449,497,85,52,4,48,.923,3563000,0
34323,144535,505,0,0,0,0,.00nan,0,0
34324,5968,504,0,0,0,0,.00nan,0,0
34324,6722,503,88,32,1,31,.969,3557000,0
34324,17732,504,100,30,0,30,1000,3600000,0
34324,54538,503,0,0,0,0,.00nan,0,0
34325,11901,502,0,0,0,0,.00nan,0,0
34325,17361,502,100,29,0,29,1000,3600000,0
34325,20384,498,0,0,0,0,.00nan,0,0
34325,62429,498,75,29,2,27,.931,3597000,0
34326,26060,496,0,0,0,0,.00nan,0,0
34326,31229,500,66,19,2,17,.895,3600000,0
34326,62672,496,55,24,3,21,.875,3544000,0
34326,144517,500,0,0,0,0,.00nan,0,0
34327,17052,499,77,47,4,43,.915,3540000,0
34327,26216,499,0,0,0,0,.00nan,0,0
34327,32601,4636,75,24,2,22,.917,3600000,0
34327,47884,4636,0,0,0,0,.00nan,0,0
34328,31229,500,80,29,2,27,.931,3900000,0
34328,32601,4636,0,0,0,0,.00nan,0,0
34328,47884,4636,63,24,2,22,.917,3900000,0
34328,144517,500,0,0,0,0,.00nan,0,0
34329,11901,502,0,0,0,0,.00nan,0,0
34329,17361,502,63,34,3,31,.912,3561000,0
34329,31033,2591,0,0,0,0,.00nan,0,0
34329,32871,2591,100,26,0,26,1000,3600000,0
34330,20384,498,54,31,5,26,.839,3565000,0
34330,26060,496,64,28,3,25,.893,3600000,0
34330,62429,498,0,0,0,0,.00nan,0,0
34330,62672,496,0,0,0,0,.00nan,0,0
34331,5968,504,0,0,0,0,.00nan,0,0
34331,17052,499,65,36,4,32,.889,3600000,0
34331,17732,504,89,29,1,28,.966,3600000,0
34331,26216,499,0,0,0,0,.00nan,0,0
34332,6722,503,0,0,0,0,.00nan,0,0
34332,34013,497,63,28,3,25,.893,3600000,0
34332,54538,503,72,41,4,37,.902,3600000,0
34332,65449,497,0,0,0,0,.00nan,0,0
34333,1180,495,99,43,1,42,.977,3900000,0
34333,17814,505,79,24,1,23,.958,3900000,0
34333,52902,495,0,0,0,0,.00nan,0,0
34333,144535,505,0,0,0,0,.00nan,0,0
34334,11901,502,75,33,2,31,.939,3600000,0
34334,17361,502,0,0,0,0,.00nan,0,0
34334,31033,2591,0,0,0,0,.00nan,0,0
34334,32871,2591,73,42,4,38,.905,3598000,0
34335,31229,500,68,39,5,34,.872,3650000,0
34335,32601,4636,55,25,4,21,.840,3650000,0
34335,47884,4636,0,0,0,0,.00nan,0,0
34335,144517,500,0,0,0,0,.00nan,0,0
34336,20384,498,59,22,2,20,.909,3600000,0
34336,26060,496,78,40,3,37,.925,3557000,0
34336,62429,498,0,0,0,0,.00nan,0,0
34336,62672,496,0,0,0,0,.00nan,0,0
34337,5968,504,0,0,0,0,.00nan,0,0
34337,17052,499,84,33,2,31,.939,3600000,0
34337,17732,504,91,24,1,23,.958,3600000,0
34337,26216,499,0,0,0,0,.00nan,0,0
34338,6722,503,0,0,0,0,.00nan,0,0
34338,34013,497,0,0,0,0,.00nan,0,0
34338,54538,503,74,38,3,35,.921,3600000,0
34338,65449,497,31,23,5,18,.783,3581000,0
34339,1180,495,55,32,4,28,.875,3744000,0
34339,17814,505,61,26,3,23,.885,3744000,0
34339,52902,495,0,0,0,0,.00nan,0,0
34339,144535,505,0,0,0,0,.00nan,0,0
34340,1180,495,51,16,2,14,.875,3600000,0
34340,6722,503,67,35,3,32,.914,3600000,0
34340,52902,495,0,0,0,0,.00nan,0,0
34340,54538,503,0,0,0,0,.00nan,0,0
34341,17052,499,92,46,4,42,.913,3600000,0
34341,26216,499,0,0,0,0,.00nan,0,0
34341,34013,497,89,19,0,19,1000,3600000,0
34341,65449,497,0,0,0,0,.00nan,0,0
34342,17814,505,65,24,2,22,.917,3779000,0
34342,31033,2591,0,0,0,0,.00nan,0,0
34342,32871,2591,91,36,1,35,.972,3779000,0
34342,144535,505,0,0,0,0,.00nan,0,0
34343,11901,502,87,32,1,31,.969,3600000,0
34343,17361,502,0,0,0,0,.00nan,0,0
34343,26060,496,66,39,5,34,.872,3600000,0
34343,62672,496,0,0,0,0,.00nan,0,0
34344,5968,504,0,0,0,0,.00nan,0,0
34344,17732,504,83,23,1,22,.957,3600000,0
34344,31229,500,75,31,2,29,.935,3571000,0
34344,144517,500,0,0,0,0,.00nan,0,0
34345,20384,498,0,0,0,0,.00nan,0,0
34345,32601,4636,59,26,3,23,.885,3600000,0
34345,47884,4636,0,0,0,0,.00nan,0,0
34345,62429,498,63,37,4,33,.892,3552000,0
34346,1180,495,84,22,1,21,.955,3600000,0
34346,6722,503,79,38,4,34,.895,3600000,0
34346,52902,495,0,0,0,0,.00nan,0,0
34346,54538,503,0,0,0,0,.00nan,0,0
34347,17052,499,88,38,2,36,.947,3600000,0
34347,26216,499,0,0,0,0,.00nan,0,0
34347,34013,497,54,23,3,20,.870,3545000,0
34347,65449,497,0,0,0,0,.00nan,0,0
34348,17814,505,78,25,1,24,.960,3600000,0
34348,31033,2591,46,21,3,18,.857,3539000,0
34348,32871,2591,0,0,0,0,.00nan,0,0
34348,144535,505,0,0,0,0,.00nan,0,0
34349,20384,498,84,26,1,25,.962,3600000,0
34349,32601,4636,73,33,2,31,.939,3541000,0
34349,47884,4636,0,0,0,0,.00nan,0,0
34349,62429,498,0,0,0,0,.00nan,0,0
34350,11901,502,0,0,0,0,.00nan,0,0
34350,17361,502,72,22,1,21,.955,3600000,0
34350,26060,496,91,57,4,53,.930,3600000,0
34350,62672,496,0,0,0,0,.00nan,0,0
34351,5968,504,0,0,0,0,.00nan,0,0
34351,17732,504,96,36,2,34,.944,3600000,0
34351,31229,500,64,29,3,26,.897,3575000,0
34351,144517,500,0,0,0,0,.00nan,0,0
34352,5968,504,53,24,3,21,.875,3557000,0
34352,17732,504,0,0,0,0,.00nan,0,0
34352,20384,498,0,0,0,0,.00nan,0,0
34352,62429,498,88,37,2,35,.946,3600000,0
34353,11901,502,0,0,0,0,.00nan,0,0
34353,17361,502,75,48,4,44,.917,3600000,0
34353,32601,4636,0,0,0,0,.00nan,0,0
34353,47884,4636,69,16,1,15,.938,3600000,0
34354,31229,500,80,25,0,25,1000,3900000,0
34354,34013,497,97,29,0,29,1000,3900000,0
34354,65449,497,0,0,0,0,.00nan,0,0
34354,144517,500,0,0,0,0,.00nan,0,0
34355,6722,503,0,0,0,0,.00nan,0,0
34355,17814,505,0,0,0,0,.00nan,0,0
34355,54538,503,44,31,6,25,.806,3600000,0
34355,144535,505,89,18,0,18,1000,3600000,0
34356,1180,495,100,27,0,27,1000,3600000,0
34356,17052,499,98,54,3,51,.944,3600000,0
34356,26216,499,0,0,0,0,.00nan,0,0
34356,52902,495,0,0,0,0,.00nan,0,0
34357,26060,496,0,0,0,0,.00nan,0,0
34357,31033,2591,0,0,0,0,.00nan,0,0
34357,32871,2591,72,27,2,25,.926,3900000,0
34357,62672,496,73,31,2,29,.935,3900000,0
34358,11901,502,85,39,3,36,.923,3600000,0
34358,17361,502,0,0,0,0,.00nan,0,0
34358,32601,4636,41,23,4,19,.826,3555000,0
34358,47884,4636,0,0,0,0,.00nan,0,0
34359,5968,504,0,0,0,0,.00nan,0,0
34359,17732,504,80,11,0,11,1000,3600000,0
34359,20384,498,88,39,2,37,.949,3584000,0
34359,62429,498,0,0,0,0,.00nan,0,0
34360,31229,500,50,27,4,23,.852,3600000,0
34360,34013,497,76,22,1,21,.955,3600000,0
34360,65449,497,0,0,0,0,.00nan,0,0
34360,144517,500,0,0,0,0,.00nan,0,0
34361,6722,503,0,0,0,0,.00nan,0,0
34361,17814,505,0,0,0,0,.00nan,0,0
34361,54538,503,76,29,2,27,.931,3571000,0
34361,144535,505,100,36,1,35,.972,3600000,0
34362,26060,496,75,25,2,23,.920,3600000,0
34362,31033,2591,0,0,0,0,.00nan,0,0
34362,32871,2591,59,35,4,31,.886,3600000,0
34362,62672,496,0,0,0,0,.00nan,0,0
34363,1180,495,55,14,2,12,.857,3600000,0
34363,17052,499,92,62,4,58,.935,3600000,0
34363,26216,499,0,0,0,0,.00nan,0,0
34363,52902,495,0,0,0,0,.00nan,0,0
34364,5968,504,0,0,0,0,.00nan,0,0
34364,11901,502,0,0,0,0,.00nan,0,0
34364,17361,502,56,33,4,29,.879,3600000,0
34364,17732,504,85,52,5,47,.904,3531000,0
34365,1180,495,75,24,1,23,.958,3600000,0
34365,31229,500,97,59,4,55,.932,3600000,0
34365,52902,495,0,0,0,0,.00nan,0,0
34365,144517,500,0,0,0,0,.00nan,0,0
34366,17052,499,72,27,2,25,.926,3600000,0
34366,17814,505,0,0,0,0,.00nan,0,0
34366,26216,499,0,0,0,0,.00nan,0,0
34366,144535,505,49,32,4,28,.875,3547000,0
34367,20384,498,0,0,0,0,.00nan,0,0
34367,34013,497,93,27,1,26,.963,3600000,0
34367,62429,498,62,35,3,32,.914,3575000,0
34367,65449,497,0,0,0,0,.00nan,0,0
34368,26060,496,66,30,3,27,.900,3790000,0
34368,32601,4636,0,0,0,0,.00nan,0,0
34368,47884,4636,59,20,2,18,.900,3790000,0
34368,62672,496,0,0,0,0,.00nan,0,0
34369,6722,503,0,0,0,0,.00nan,0,0
34369,31033,2591,69,32,2,30,.938,3556000,0
34369,32871,2591,0,0,0,0,.00nan,0,0
34369,54538,503,100,38,1,37,.974,3600000,0
34370,1180,495,23,32,6,26,.813,3546000,0
34370,31229,500,52,27,5,22,.815,3076000,0
34370,52902,495,0,0,0,0,.00nan,0,0
34370,144517,500,57,4,0,4,1000,524000,0
34371,17052,499,81,41,2,39,.951,3600000,0
34371,17814,505,84,17,0,17,1000,3600000,0
34371,26216,499,0,0,0,0,.00nan,0,0
34371,144535,505,0,0,0,0,.00nan,0,0
34372,5968,504,0,0,0,0,.00nan,0,0
34372,11901,502,83,27,1,26,.963,3600000,0
34372,17361,502,0,0,0,0,.00nan,0,0
34372,17732,504,61,30,4,26,.867,3600000,0
34373,20384,498,71,24,1,23,.958,3600000,0
34373,34013,497,62,26,3,23,.885,3535000,0
34373,62429,498,0,0,0,0,.00nan,0,0
34373,65449,497,0,0,0,0,.00nan,0,0
34374,6722,503,83,43,3,40,.930,3597000,0
34374,17266,503,0,0,0,0,.00nan,0,0
34374,31033,2591,0,0,0,0,.00nan,0,0
34374,32871,2591,86,22,1,21,.955,3600000,0
34375,26060,496,100,31,0,31,1000,3600000,0
34375,32601,4636,62,27,3,24,.889,3600000,0
34375,47884,4636,0,0,0,0,.00nan,0,0
34375,62672,496,0,0,0,0,.00nan,0,0
34376,5968,504,72,35,3,32,.914,3565000,0
34376,17732,504,0,0,0,0,.00nan,0,0
34376,26060,496,82,37,2,35,.946,3600000,0
34376,62672,496,0,0,0,0,.00nan,0,0
34377,6722,503,47,13,2,11,.846,3600000,0
34377,17052,499,56,42,5,37,.881,3600000,0
34377,17266,503,0,0,0,0,.00nan,0,0
34377,26216,499,0,0,0,0,.00nan,0,0
34378,11901,502,0,0,0,0,.00nan,0,0
34378,17361,502,77,24,1,23,.958,3600000,0
34378,34013,497,0,0,0,0,.00nan,0,0
34378,65449,497,83,38,2,36,.947,3600000,0
34379,17814,505,100,44,2,42,.955,3847000,0
34379,31229,500,78,36,3,33,.917,3847000,0
34379,144517,500,0,0,0,0,.00nan,0,0
34379,144535,505,0,0,0,0,.00nan,0,0
34380,31033,2591,59,7,0,7,1000,607000,0
34380,32601,4636,83,33,2,31,.939,3600000,0
34380,32871,2591,36,31,6,25,.806,2993000,0
34380,47884,4636,0,0,0,0,.00nan,0,0
34381,1180,495,41,26,4,22,.846,3900000,0
34381,20384,498,0,0,0,0,.00nan,0,0
34381,52902,495,0,0,0,0,.00nan,0,0
34381,62429,498,71,37,4,33,.892,3900000,0
34382,5968,504,0,0,0,0,.00nan,0,0
34382,17732,504,82,26,1,25,.962,3600000,0
34382,26060,496,44,38,6,32,.842,3600000,0
34382,62672,496,0,0,0,0,.00nan,0,0
34383,6722,503,66,27,2,25,.926,3600000,0
34383,17052,499,67,31,3,28,.903,3582000,0
34383,17266,503,0,0,0,0,.00nan,0,0
34383,26216,499,0,0,0,0,.00nan,0,0
34384,11901,502,89,33,1,32,.970,3900000,0
34384,17361,502,0,0,0,0,.00nan,0,0
34384,34013,497,99,32,1,31,.969,3900000,0
34384,65449,497,0,0,0,0,.00nan,0,0
34385,17814,505,70,26,2,24,.923,3900000,0
34385,31229,500,84,32,2,30,.938,3900000,0
34385,144517,500,0,0,0,0,.00nan,0,0
34385,144535,505,0,0,0,0,.00nan,0,0
34386,1180,495,93,34,2,32,.941,3900000,0
34386,20384,498,84,44,2,42,.955,3900000,0
34386,52902,495,0,0,0,0,.00nan,0,0
34386,62429,498,0,0,0,0,.00nan,0,0
34387,31033,2591,100,33,0,33,1000,3600000,0
34387,32601,4636,53,23,3,20,.870,3600000,0
34387,32871,2591,0,0,0,0,.00nan,0,0
34387,47884,4636,0,0,0,0,.00nan,0,0
34388,17814,505,63,16,1,15,.938,3600000,0
34388,20384,498,0,0,0,0,.00nan,0,0
34388,62429,498,72,34,2,32,.941,3566000,0
34388,144535,505,0,0,0,0,.00nan,0,0
34389,6722,503,73,23,1,22,.957,3600000,0
34389,17266,503,0,0,0,0,.00nan,0,0
34389,31229,500,77,31,2,29,.935,3544000,0
34389,144517,500,0,0,0,0,.00nan,0,0
34390,5968,504,0,0,0,0,.00nan,0,0
34390,17732,504,95,40,2,38,.950,3515000,0
34390,32601,4636,0,0,0,0,.00nan,0,0
34390,47884,4636,100,25,0,25,1000,3600000,0
34392,26060,496,34,34,6,28,.824,3600000,0
34392,34013,497,96,34,2,32,.941,3600000,0
34392,62672,496,0,0,0,0,.00nan,0,0
34392,65449,497,0,0,0,0,.00nan,0,0
34393,17052,499,62,30,3,27,.900,3600000,0
34393,26216,499,0,0,0,0,.00nan,0,0
34393,31033,2591,69,16,1,15,.938,3600000,0
34393,32871,2591,0,0,0,0,.00nan,0,0
34394,17814,505,42,27,5,22,.815,3600000,0
34394,20384,498,0,0,0,0,.00nan,0,0
34394,62429,498,96,29,1,28,.966,3600000,0
34394,144535,505,0,0,0,0,.00nan,0,0
34395,6722,503,81,28,1,27,.964,3600000,0
34395,17266,503,0,0,0,0,.00nan,0,0
34395,31229,500,100,51,0,51,1000,3600000,0
34395,144517,500,0,0,0,0,.00nan,0,0
34396,5968,504,0,0,0,0,.00nan,0,0
34396,17732,504,90,42,2,40,.952,3900000,0
34396,32601,4636,0,0,0,0,.00nan,0,0
34396,47884,4636,80,36,2,34,.944,3900000,0
34397,1180,495,40,38,6,32,.842,2991000,0
34397,11901,502,72,25,2,23,.920,3600000,0
34397,17361,502,0,0,0,0,.00nan,0,0
34397,52902,495,47,3,1,2,.667,609000,0
34398,26060,496,0,0,0,0,.00nan,0,0
34398,34013,497,80,33,2,31,.939,3600000,0
34398,62672,496,49,21,3,18,.857,3572000,0
34398,65449,497,0,0,0,0,.00nan,0,0
34399,17052,499,70,48,5,43,.896,3524000,0
34399,26216,499,0,0,0,0,.00nan,0,0
34399,31033,2591,75,36,3,33,.917,3600000,0
34399,32871,2591,0,0,0,0,.00nan,0,0
34400,6722,503,0,0,0,0,.00nan,0,0
34400,17266,503,60,25,2,23,.920,3600000,0
34400,20384,498,0,0,0,0,.00nan,0,0
34400,62429,498,66,31,3,28,.903,3576000,0
34401,32601,4636,0,0,0,0,.00nan,0,0
34401,34013,497,0,0,0,0,.00nan,0,0
34401,47884,4636,58,32,3,29,.906,3900000,0
34401,65449,497,90,46,3,43,.935,3900000,0
34402,1180,495,75,30,2,28,.933,3796000,0
34402,26060,496,76,32,3,29,.906,3796000,0
34402,52902,495,0,0,0,0,.00nan,0,0
34402,62672,496,0,0,0,0,.00nan,0,0
34403,11901,502,66,22,2,20,.909,3600000,0
34403,17361,502,0,0,0,0,.00nan,0,0
34403,17814,505,0,0,0,0,.00nan,0,0
34403,144535,505,62,38,4,34,.895,3519000,0
34404,5968,504,0,0,0,0,.00nan,0,0
34404,17732,504,70,30,3,27,.900,3557000,0
34404,31033,2591,66,28,2,26,.929,3600000,0
34404,32871,2591,0,0,0,0,.00nan,0,0
34405,17052,499,0,0,0,0,.00nan,0,0
34405,26216,499,76,33,2,31,.939,3600000,0
34405,31229,500,67,34,5,29,.853,3600000,0
34405,144517,500,0,0,0,0,.00nan,0,0
34406,6722,503,73,30,2,28,.933,3900000,0
34406,17266,503,0,0,0,0,.00nan,0,0
34406,20384,498,81,30,2,28,.933,3900000,0
34406,62429,498,0,0,0,0,.00nan,0,0
34407,32601,4636,40,22,4,18,.818,3600000,0
34407,34013,497,100,32,1,31,.969,3600000,0
34407,47884,4636,0,0,0,0,.00nan,0,0
34407,65449,497,0,0,0,0,.00nan,0,0
34408,1180,495,0,0,0,0,.00nan,0,0
34408,26060,496,63,41,4,37,.902,3591000,0
34408,52902,495,47,12,2,10,.833,3600000,0
34408,62672,496,0,0,0,0,.00nan,0,0
34409,11901,502,0,0,0,0,.00nan,0,0
34409,17361,502,63,29,3,26,.897,3598000,0
34409,17814,505,73,20,1,19,.950,3600000,0
34409,144535,505,0,0,0,0,.00nan,0,0
34411,17052,499,68,29,3,26,.897,3592000,0
34411,26216,499,0,0,0,0,.00nan,0,0
34411,31229,500,69,28,2,26,.929,3600000,0
34411,144517,500,0,0,0,0,.00nan,0,0
34412,6722,503,70,53,5,48,.906,3600000,0
34412,11901,502,61,11,1,10,.909,3600000,0
34412,17266,503,0,0,0,0,.00nan,0,0
34412,17361,502,0,0,0,0,.00nan,0,0
34413,17052,499,84,34,2,32,.941,3734000,0
34413,20384,498,0,0,0,0,.00nan,0,0
34413,26216,499,0,0,0,0,.00nan,0,0
34413,62429,498,77,23,1,22,.957,3734000,0
34414,17814,505,65,26,2,24,.923,3900000,0
34414,26060,496,80,33,2,31,.939,3900000,0
34414,62672,496,0,0,0,0,.00nan,0,0
34414,144535,505,0,0,0,0,.00nan,0,0
34415,5968,504,78,35,3,32,.914,3833000,0
34415,17732,504,0,0,0,0,.00nan,0,0
34415,34013,497,72,29,2,27,.931,3833000,0
34415,65449,497,0,0,0,0,.00nan,0,0
34416,1180,495,78,32,2,30,.938,3794000,0
34416,32601,4636,60,26,3,23,.885,3794000,0
34416,47884,4636,0,0,0,0,.00nan,0,0
34416,52902,495,0,0,0,0,.00nan,0,0
34417,31033,2591,0,0,0,0,.00nan,0,0
34417,31229,500,76,29,2,27,.931,3882000,0
34417,32871,2591,84,38,3,35,.921,3882000,0
34417,144517,500,0,0,0,0,.00nan,0,0
34418,17052,499,53,35,5,30,.857,3598000,0
34418,20384,498,57,33,4,29,.879,3600000,0
34418,26216,499,0,0,0,0,.00nan,0,0
34418,62429,498,0,0,0,0,.00nan,0,0
34419,6722,503,0,0,0,0,.00nan,0,0
34419,11901,502,0,0,0,0,.00nan,0,0
34419,17361,502,91,28,1,27,.964,3600000,0
34419,54538,503,67,35,4,31,.886,3600000,0
34420,17814,505,80,30,2,28,.933,3818000,0
34420,26060,496,77,28,1,27,.964,3818000,0
34420,62672,496,0,0,0,0,.00nan,0,0
34420,144535,505,0,0,0,0,.00nan,0,0
34421,5968,504,0,0,0,0,.00nan,0,0
34421,17732,504,98,36,1,35,.972,3600000,0
34421,34013,497,65,29,4,25,.862,3600000,0
34421,65449,497,0,0,0,0,.00nan,0,0
34422,1180,495,74,25,1,24,.960,3600000,0
34422,32601,4636,0,0,0,0,.00nan,0,0
34422,47884,4636,66,28,2,26,.929,3543000,0
34422,52902,495,0,0,0,0,.00nan,0,0
34423,31033,2591,84,22,1,21,.955,3600000,0
34423,31229,500,73,30,3,27,.900,3534000,0
34423,32871,2591,0,0,0,0,.00nan,0,0
34423,144517,500,0,0,0,0,.00nan,0,0
34424,1180,495,43,26,4,22,.846,3600000,0
34424,5968,504,0,0,0,0,.00nan,0,0
34424,17732,504,55,36,5,31,.861,3600000,0
34424,52902,495,0,0,0,0,.00nan,0,0
34425,17814,505,92,45,2,43,.956,3568000,0
34425,32601,4636,100,26,0,26,1000,3600000,0
34425,47884,4636,0,0,0,0,.00nan,0,0
34425,144535,505,0,0,0,0,.00nan,0,0
34426,31033,2591,79,34,2,32,.941,3545000,0
34426,32871,2591,0,0,0,0,.00nan,0,0
34426,34013,497,0,0,0,0,.00nan,0,0
34426,65449,497,76,15,1,14,.933,3600000,0
34427,6722,503,64,30,3,27,.900,3572000,0
34427,26060,496,87,38,2,36,.947,3600000,0
34427,54538,503,0,0,0,0,.00nan,0,0
34427,62672,496,0,0,0,0,.00nan,0,0
34428,20384,498,0,0,0,0,.00nan,0,0
34428,31229,500,0,0,0,0,.00nan,0,0
34428,62429,498,90,41,2,39,.951,3600000,0
34428,144517,500,44,35,5,30,.857,3600000,0
34429,11901,502,69,22,2,20,.909,3600000,0
34429,17052,499,48,25,4,21,.840,3567000,0
34429,17361,502,0,0,0,0,.00nan,0,0
34429,26216,499,0,0,0,0,.00nan,0,0
34430,17814,505,63,29,2,27,.931,3900000,0
34430,32601,4636,92,41,2,39,.951,3900000,0
34430,47884,4636,0,0,0,0,.00nan,0,0
34430,144535,505,0,0,0,0,.00nan,0,0
34431,31033,2591,75,38,3,35,.921,3855000,0
34431,32871,2591,0,0,0,0,.00nan,0,0
34431,34013,497,56,18,2,16,.889,3855000,0
34431,65449,497,0,0,0,0,.00nan,0,0
34432,1180,495,96,21,0,21,1000,3600000,0
34432,5968,504,0,0,0,0,.00nan,0,0
34432,17732,504,75,46,5,41,.891,3600000,0
34432,52902,495,0,0,0,0,.00nan,0,0
34653,6722,503,55,5,0,5,1000,295000,0
34653,6730,495,0,0,0,0,.00nan,0,0
34653,52902,495,65,29,3,26,.897,3600000,0
34653,54538,503,61,47,6,41,.872,3305000,0
34655,17052,499,71,43,4,39,.907,3600000,0
34655,26216,499,0,0,0,0,.00nan,0,0
34655,34013,497,60,23,3,20,.870,3600000,0
34655,65449,497,0,0,0,0,.00nan,0,0
34657,5968,504,0,0,0,0,.00nan,0,0
34657,17732,504,79,27,1,26,.963,3600000,0
34657,20384,498,32,29,6,23,.793,2325000,0
34657,62429,498,31,20,4,16,.800,1275000,0
34659,263,502,0,0,0,0,.00nan,0,0
34659,9153,2591,0,0,0,0,.00nan,0,0
34659,11901,502,66,22,2,20,.909,3600000,0
34659,31033,2591,67,27,3,24,.889,3547000,0
34661,17814,505,57,26,3,23,.885,3580000,0
34661,31229,500,100,59,2,57,.966,3600000,0
34661,144517,500,0,0,0,0,.00nan,0,0
34661,144535,505,0,0,0,0,.00nan,0,0
34663,16186,4636,0,0,0,0,.00nan,0,0
34663,26060,496,64,33,3,30,.909,3568000,0
34663,32601,4636,84,26,1,25,.962,3600000,0
34663,62672,496,0,0,0,0,.00nan,0,0
34665,6730,495,54,24,3,21,.875,3531000,0
34665,20384,498,0,0,0,0,.00nan,0,0
34665,52902,495,0,0,0,0,.00nan,0,0
34665,62429,498,88,33,1,32,.970,3600000,0
34667,16186,4636,78,28,2,26,.929,3600000,0
34667,17814,505,0,0,0,0,.00nan,0,0
34667,32601,4636,0,0,0,0,.00nan,0,0
34667,144535,505,71,39,4,35,.897,3600000,0
34669,5968,504,74,40,4,36,.900,3600000,0
34669,9153,2591,0,0,0,0,.00nan,0,0
34669,17732,504,0,0,0,0,.00nan,0,0
34669,31033,2591,61,18,1,17,.944,3600000,0
34671,263,502,95,32,1,31,.969,3600000,0
34671,11901,502,0,0,0,0,.00nan,0,0
34671,31229,500,73,24,2,22,.917,3550000,0
34671,144517,500,0,0,0,0,.00nan,0,0
34673,6722,503,55,20,2,18,.900,3600000,0
34673,17052,499,0,0,0,0,.00nan,0,0
34673,26216,499,81,51,5,46,.902,3600000,0
34673,54538,503,0,0,0,0,.00nan,0,0
34675,26060,496,0,0,0,0,.00nan,0,0
34675,34013,497,0,0,0,0,.00nan,0,0
34675,62672,496,60,22,2,20,.909,3900000,0
34675,65449,497,100,47,2,45,.957,3900000,0
34677,31229,500,100,32,0,32,1000,3600000,0
34677,34013,497,33,21,4,17,.810,3600000,0
34677,65449,497,0,0,0,0,.00nan,0,0
34677,144517,500,0,0,0,0,.00nan,0,0
34679,17052,499,0,0,0,0,.00nan,0,0
34679,17814,505,78,11,0,11,1000,3600000,0
34679,26216,499,73,40,4,36,.900,3600000,0
34679,144535,505,0,0,0,0,.00nan,0,0
34681,6722,503,0,0,0,0,.00nan,0,0
34681,26060,496,77,38,4,34,.895,3900000,0
34681,54538,503,65,38,4,34,.895,3900000,0
34681,62672,496,0,0,0,0,.00nan,0,0
34683,5968,504,0,0,0,0,.00nan,0,0
34683,17732,504,65,31,4,27,.871,3532000,0
34683,32601,4636,0,0,0,0,.00nan,0,0
34683,47884,4636,60,20,2,18,.900,3600000,0
34685,9153,2591,0,0,0,0,.00nan,0,0
34685,20384,498,55,41,5,36,.878,3577000,0
34685,31033,2591,61,31,3,28,.903,3600000,0
34685,62429,498,0,0,0,0,.00nan,0,0
34687,263,502,0,0,0,0,.00nan,0,0
34687,6730,495,0,0,0,0,.00nan,0,0
34687,11901,502,65,32,3,29,.906,3600000,0
34687,52902,495,66,47,5,42,.894,3566000,0
34689,263,502,74,22,2,20,.909,3600000,0
34689,6722,503,90,45,3,42,.933,3561000,0
34689,11901,502,0,0,0,0,.00nan,0,0
34689,54538,503,0,0,0,0,.00nan,0,0
34691,5968,504,85,26,1,25,.962,3900000,0
34691,17052,499,100,50,1,49,.980,3900000,0
34691,17732,504,0,0,0,0,.00nan,0,0
34691,26216,499,0,0,0,0,.00nan,0,0
34693,20384,498,0,0,0,0,.00nan,0,0
34693,32601,4636,78,22,1,21,.955,3600000,0
34693,47884,4636,0,0,0,0,.00nan,0,0
34693,62429,498,66,44,4,40,.909,3600000,0
34695,9153,2591,59,26,3,23,.885,3666000,0
34695,26060,496,0,0,0,0,.00nan,0,0
34695,31033,2591,0,0,0,0,.00nan,0,0
34695,62672,496,67,32,4,28,.875,3666000,0
34697,6730,495,62,30,3,27,.900,3528000,0
34697,31229,500,100,40,1,39,.975,3600000,0
34697,52902,495,0,0,0,0,.00nan,0,0
34697,144517,500,0,0,0,0,.00nan,0,0
34699,17814,505,67,20,2,18,.900,3600000,0
34699,34013,497,0,0,0,0,.00nan,0,0
34699,65449,497,58,27,3,24,.889,3600000,0
34699,144535,505,0,0,0,0,.00nan,0,0
34701,9153,2591,0,0,0,0,.00nan,0,0
34701,17052,499,0,0,0,0,.00nan,0,0
34701,26216,499,100,56,3,53,.946,3900000,0
34701,31033,2591,59,29,3,26,.897,3900000,0
34703,5968,504,0,0,0,0,.00nan,0,0
34703,17732,504,100,42,1,41,.976,3600000,0
34703,32601,4636,0,0,0,0,.00nan,0,0
34703,47884,4636,63,23,2,21,.913,3563000,0
34705,31229,500,100,38,1,37,.974,3600000,0
34705,34013,497,97,43,2,41,.953,3544000,0
34705,65449,497,0,0,0,0,.00nan,0,0
34705,144517,500,0,0,0,0,.00nan,0,0
34707,6730,495,0,0,0,0,.00nan,0,0
34707,26060,496,91,45,2,43,.956,3575000,0
34707,52902,495,75,21,1,20,.952,3600000,0
34707,62672,496,0,0,0,0,.00nan,0,0
34709,263,502,0,0,0,0,.00nan,0,0
34709,11901,502,66,20,1,19,.950,3600000,0
34709,20384,498,76,41,4,37,.902,3600000,0
34709,62429,498,0,0,0,0,.00nan,0,0
34711,6722,503,77,15,0,15,1000,1246000,0
34711,17814,505,0,0,0,0,.00nan,0,0
34711,54538,503,38,33,6,27,.818,2354000,0
34711,144535,505,59,16,1,15,.938,3600000,0
34713,17052,499,80,26,1,25,.962,3600000,0
34713,26060,496,0,0,0,0,.00nan,0,0
34713,26216,499,0,0,0,0,.00nan,0,0
34713,62672,496,89,16,0,16,1000,3600000,0
34715,9153,2591,75,21,2,19,.905,3600000,0
34715,20384,498,0,0,0,0,.00nan,0,0
34715,31033,2591,0,0,0,0,.00nan,0,0
34715,62429,498,24,19,5,14,.737,3600000,0
34717,6722,503,96,45,1,44,.978,3900000,0
34717,17814,505,71,22,1,21,.955,3900000,0
34717,54538,503,0,0,0,0,.00nan,0,0
34717,144535,505,0,0,0,0,.00nan,0,0
34719,5968,504,67,36,3,33,.917,3548000,0
34719,17732,504,0,0,0,0,.00nan,0,0
34719,32601,4636,87,22,1,21,.955,3600000,0
34719,47884,4636,0,0,0,0,.00nan,0,0
34721,263,502,40,30,5,25,.833,3600000,0
34721,11901,502,0,0,0,0,.00nan,0,0
34721,31229,500,100,24,0,24,1000,3600000,0
34721,144517,500,0,0,0,0,.00nan,0,0
34723,6730,495,84,30,1,29,.967,3600000,0
34723,34013,497,0,0,0,0,.00nan,0,0
34723,52902,495,0,0,0,0,.00nan,0,0
34723,65449,497,71,34,3,31,.912,3582000,0
34725,17052,499,85,56,4,52,.929,3600000,0
34725,26216,499,0,0,0,0,.00nan,0,0
34725,31229,500,82,25,1,24,.960,3600000,0
34725,144517,500,0,0,0,0,.00nan,0,0
34731,17814,505,99,42,1,41,.976,3600000,0
34731,32601,4636,69,25,2,23,.920,3550000,0
34731,47884,4636,0,0,0,0,.00nan,0,0
34731,144535,505,0,0,0,0,.00nan,0,0
34733,9153,2591,0,0,0,0,.00nan,0,0
34733,31033,2591,69,30,3,27,.900,3600000,0
34733,34013,497,35,36,6,30,.833,3600000,0
34733,65449,497,0,0,0,0,.00nan,0,0
34735,6730,495,0,0,0,0,.00nan,0,0
34735,20384,498,64,30,3,27,.900,3900000,0
34735,52902,495,57,30,3,27,.900,3900000,0
34735,62429,498,0,0,0,0,.00nan,0,0
34736,937,543,0,0,0,0,.00nan,0,0
34736,17729,548,67,7,0,7,1000,688000,0
34736,25298,548,22,24,6,18,.750,2912000,0
34736,29293,543,69,33,3,30,.909,3600000,0
34737,1924,546,0,0,0,0,.00nan,0,0
34737,4820,545,61,20,2,18,.900,3600000,0
34737,21846,545,0,0,0,0,.00nan,0,0
34737,26948,546,74,35,3,32,.914,3576000,0
34738,9758,551,0,0,0,0,.00nan,0,0
34738,9835,549,50,22,3,19,.864,3600000,0
34738,10116,551,100,31,0,31,1000,3600000,0
34738,17355,549,0,0,0,0,.00nan,0,0
34739,7850,2190,0,0,0,0,.00nan,0,0
34739,9758,551,0,0,0,0,.00nan,0,0
34739,10116,551,73,28,2,26,.929,3900000,0
34739,25712,2190,86,37,2,35,.946,3900000,0
34740,1675,550,100,26,0,26,1000,3600000,0
34740,10568,547,94,39,2,37,.949,3536000,0
34740,45324,550,0,0,0,0,.00nan,0,0
34740,54126,547,0,0,0,0,.00nan,0,0
34741,937,543,0,0,0,0,.00nan,0,0
34741,9835,549,0,0,0,0,.00nan,0,0
34741,17355,549,41,41,6,35,.854,3600000,0
34741,29293,543,75,19,1,18,.947,3600000,0
34742,4820,545,36,26,5,21,.808,3600000,0
34742,7850,2190,0,0,0,0,.00nan,0,0
34742,21846,545,0,0,0,0,.00nan,0,0
34742,25712,2190,74,30,2,28,.933,3600000,0
34743,9758,551,97,27,1,26,.963,3600000,0
34743,10116,551,0,0,0,0,.00nan,0,0
34743,17729,548,0,0,0,0,.00nan,0,0
34743,25298,548,69,31,2,29,.935,3600000,0
34744,1675,550,71,37,4,33,.892,3550000,0
34744,1924,546,0,0,0,0,.00nan,0,0
34744,26948,546,79,31,2,29,.935,3600000,0
34744,45324,550,0,0,0,0,.00nan,0,0
34745,4820,545,49,30,4,26,.867,3900000,0
34745,9758,551,52,35,4,31,.886,3900000,0
34745,10116,551,0,0,0,0,.00nan,0,0
34745,21846,545,0,0,0,0,.00nan,0,0
34746,937,543,50,26,4,22,.846,3600000,0
34746,1675,550,89,44,3,41,.932,3600000,0
34746,29293,543,0,0,0,0,.00nan,0,0
34746,45324,550,0,0,0,0,.00nan,0,0
34747,7850,2190,72,26,3,23,.885,3600000,0
34747,10430,2190,0,0,0,0,.00nan,0,0
34747,17729,548,0,0,0,0,.00nan,0,0
34747,25298,548,57,36,5,31,.861,3581000,0
34748,1675,550,68,29,2,27,.931,3600000,0
34748,9835,549,88,29,1,28,.966,3600000,0
34748,17355,549,0,0,0,0,.00nan,0,0
34748,45324,550,0,0,0,0,.00nan,0,0
34749,937,543,0,0,0,0,.00nan,0,0
34749,4820,545,0,0,0,0,.00nan,0,0
34749,21846,545,83,37,1,36,.973,3600000,0
34749,29293,543,89,41,2,39,.951,3566000,0
34750,1675,550,0,0,0,0,.00nan,0,0
34750,9758,551,90,32,1,31,.969,3559000,0
34750,10116,551,0,0,0,0,.00nan,0,0
34750,45324,550,97,18,0,18,1000,3600000,0
34751,9835,549,85,32,2,30,.938,2810000,0
34751,10568,547,0,0,0,0,.00nan,0,0
34751,17355,549,23,10,4,6,.600,790000,0
34751,54126,547,76,23,2,21,.913,3600000,0
34752,1924,546,85,36,2,34,.944,3900000,0
34752,7850,2190,0,0,0,0,.00nan,0,0
34752,10430,2190,83,41,2,39,.951,3900000,0
34752,26948,546,0,0,0,0,.00nan,0,0
34753,937,543,0,0,0,0,.00nan,0,0
34753,10568,547,0,0,0,0,.00nan,0,0
34753,29293,543,54,28,4,24,.857,3900000,0
34753,54126,547,69,35,4,31,.886,3900000,0
34754,9835,549,0,0,0,0,.00nan,0,0
34754,17355,549,64,34,3,31,.912,3600000,0
34754,17729,548,55,33,5,28,.848,3524000,0
34754,25298,548,0,0,0,0,.00nan,0,0
34755,7850,2190,53,35,5,30,.857,3600000,0
34755,10430,2190,0,0,0,0,.00nan,0,0
34755,10568,547,81,39,2,37,.949,3600000,0
34755,52892,547,0,0,0,0,.00nan,0,0
34756,1924,546,0,0,0,0,.00nan,0,0
34756,9758,551,84,32,2,30,.938,3600000,0
34756,10116,551,0,0,0,0,.00nan,0,0
34756,26948,546,84,38,3,35,.921,3578000,0
34757,1675,550,63,9,0,9,1000,519000,0
34757,4820,545,100,27,0,27,1000,3600000,0
34757,21846,545,0,0,0,0,.00nan,0,0
34757,45324,550,36,34,6,28,.824,3081000,0
34758,4285,549,71,41,3,38,.927,3900000,0
34758,4820,545,66,27,3,24,.889,3900000,0
34758,9835,549,0,0,0,0,.00nan,0,0
34758,21846,545,0,0,0,0,.00nan,0,0
34759,937,543,0,0,0,0,.00nan,0,0
34759,1924,546,99,49,3,46,.939,3600000,0
34759,26948,546,0,0,0,0,.00nan,0,0
34759,29293,543,50,28,4,24,.857,3600000,0
34760,10568,547,73,33,2,31,.939,3600000,0
34760,17729,548,84,28,1,27,.964,3600000,0
34760,25298,548,0,0,0,0,.00nan,0,0
34760,52892,547,0,0,0,0,.00nan,0,0
34761,1675,550,51,27,4,23,.852,3550000,0
34761,7850,2190,0,0,0,0,.00nan,0,0
34761,25712,2190,71,32,3,29,.906,3600000,0
34761,45324,550,0,0,0,0,.00nan,0,0
34762,4285,549,0,0,0,0,.00nan,0,0
34762,7850,2190,0,0,0,0,.00nan,0,0
34762,9835,549,51,27,4,23,.852,3514000,0
34762,25712,2190,75,34,2,32,.941,3600000,0
34763,9758,551,43,24,4,20,.833,3575000,0
34763,10116,551,0,0,0,0,.00nan,0,0
34763,17729,548,0,0,0,0,.00nan,0,0
34763,25298,548,57,23,3,20,.870,3600000,0
34764,937,543,65,31,2,29,.935,3600000,0
34764,9758,551,66,37,4,33,.892,3534000,0
34764,10116,551,0,0,0,0,.00nan,0,0
34764,29293,543,0,0,0,0,.00nan,0,0
34765,1924,546,61,39,4,35,.897,3567000,0
34765,10568,547,51,20,3,17,.850,3600000,0
34765,26948,546,0,0,0,0,.00nan,0,0
34765,52892,547,0,0,0,0,.00nan,0,0
34766,1675,550,24,7,3,4,.571,511000,0
34766,17729,548,75,26,1,25,.962,3600000,0
34766,25298,548,0,0,0,0,.00nan,0,0
34766,45324,550,73,17,0,17,1000,3089000,0
34767,937,543,0,0,0,0,.00nan,0,0
34767,7850,2190,81,43,3,40,.930,2476000,0
34767,25712,2190,23,13,4,9,.692,1124000,0
34767,29293,543,80,24,1,23,.958,3600000,0
34768,1924,546,96,35,1,34,.971,3600000,0
34768,4285,549,0,0,0,0,.00nan,0,0
34768,9835,549,59,32,3,29,.906,3596000,0
34768,26948,546,0,0,0,0,.00nan,0,0
34769,4820,545,79,31,2,29,.935,3600000,0
34769,17729,548,62,29,3,26,.897,3594000,0
34769,21846,545,0,0,0,0,.00nan,0,0
34769,25298,548,0,0,0,0,.00nan,0,0
34770,9758,551,0,0,0,0,.00nan,0,0
34770,10116,551,98,40,2,38,.950,3543000,0
34770,10568,547,0,0,0,0,.00nan,0,0
34770,54126,547,92,26,1,25,.962,3600000,0
34771,10568,547,59,30,3,27,.900,3900000,0
34771,17729,548,75,35,3,32,.914,3900000,0
34771,25298,548,0,0,0,0,.00nan,0,0
34771,54126,547,0,0,0,0,.00nan,0,0
34772,1675,550,0,0,0,0,.00nan,0,0
34772,4820,545,69,42,3,39,.929,3900000,0
34772,21846,545,0,0,0,0,.00nan,0,0
34772,45324,550,78,43,3,40,.930,3900000,0
34773,1924,546,64,28,3,25,.893,3600000,0
34773,4285,549,91,21,0,21,1000,3600000,0
34773,9835,549,0,0,0,0,.00nan,0,0
34773,26948,546,0,0,0,0,.00nan,0,0
34774,937,543,0,0,0,0,.00nan,0,0
34774,7850,2190,96,39,1,38,.974,3600000,0
34774,25712,2190,0,0,0,0,.00nan,0,0
34774,29293,543,59,23,2,21,.913,3600000,0
34775,7850,2190,0,0,0,0,.00nan,0,0
34775,10568,547,0,0,0,0,.00nan,0,0
34775,25712,2190,97,56,2,54,.964,3600000,0
34775,54126,547,47,18,3,15,.833,3557000,0
34776,1924,546,100,40,0,40,1000,3600000,0
34776,9758,551,0,0,0,0,.00nan,0,0
34776,10116,551,73,30,2,28,.933,3580000,0
34776,26948,546,0,0,0,0,.00nan,0,0
34777,4285,549,83,31,2,29,.935,3600000,0
34777,4820,545,34,35,6,29,.829,2787000,0
34777,9835,549,0,0,0,0,.00nan,0,0
34777,21846,545,59,9,0,9,1000,813000,0
34778,1675,550,62,16,1,15,.938,3600000,0
34778,17729,548,0,0,0,0,.00nan,0,0
34778,25298,548,76,36,2,34,.944,3593000,0
34778,45324,550,0,0,0,0,.00nan,0,0
34779,4285,549,0,0,0,0,.00nan,0,0
34779,9835,549,100,31,0,31,1000,3600000,0
34779,10568,547,59,32,3,29,.906,3600000,0
34779,54126,547,0,0,0,0,.00nan,0,0
34780,937,543,0,0,0,0,.00nan,0,0
34780,4820,545,99,44,2,42,.955,3600000,0
34780,6681,545,0,0,0,0,.00nan,0,0
34780,29293,543,55,29,3,26,.897,3581000,0
34781,1924,546,93,34,1,33,.971,3600000,0
34781,7850,2190,0,0,0,0,.00nan,0,0
34781,25712,2190,68,38,4,34,.895,3600000,0
34781,26948,546,0,0,0,0,.00nan,0,0
34782,1675,550,0,0,0,0,.00nan,0,0
34782,9758,551,68,29,2,27,.931,3555000,0
34782,10116,551,0,0,0,0,.00nan,0,0
34782,45324,550,100,25,0,25,1000,3600000,0
34784,4285,549,34,5,2,3,.600,250000,0
34784,7850,2190,0,0,0,0,.00nan,0,0
34784,9835,549,40,33,6,27,.818,3350000,0
34784,25712,2190,81,27,1,26,.963,3600000,0
34785,4820,545,78,43,3,40,.930,3571000,0
34785,6681,545,0,0,0,0,.00nan,0,0
34785,17729,548,88,30,1,29,.967,3600000,0
34785,25298,548,0,0,0,0,.00nan,0,0
34786,937,543,0,0,0,0,.00nan,0,0
34786,1675,550,98,50,3,47,.940,3558000,0
34786,29293,543,67,21,2,19,.905,3600000,0
34786,45324,550,0,0,0,0,.00nan,0,0
34787,1924,546,24,11,4,7,.636,595000,0
34787,17729,548,0,0,0,0,.00nan,0,0
34787,25298,548,59,13,1,12,.923,3600000,0
34787,26948,546,72,47,4,43,.915,3005000,0
34788,4820,545,92,19,0,19,1000,3600000,0
34788,6681,545,0,0,0,0,.00nan,0,0
34788,10568,547,0,0,0,0,.00nan,0,0
34788,54126,547,49,24,3,21,.875,3600000,0
34789,1675,550,0,0,0,0,.00nan,0,0
34789,1924,546,52,34,5,29,.853,3600000,0
34789,26948,546,0,0,0,0,.00nan,0,0
34789,45324,550,85,19,0,19,1000,3600000,0
34790,937,543,57,25,3,22,.880,3557000,0
34790,4285,549,96,39,2,37,.949,3600000,0
34790,9835,549,0,0,0,0,.00nan,0,0
34790,29293,543,0,0,0,0,.00nan,0,0
34791,9758,551,66,35,4,31,.886,3581000,0
34791,10116,551,0,0,0,0,.00nan,0,0
34791,17729,548,0,0,0,0,.00nan,0,0
34791,25298,548,61,31,3,28,.903,3600000,0
34792,1924,546,68,36,4,32,.889,3900000,0
34792,17729,548,55,26,4,22,.846,3900000,0
34792,25298,548,0,0,0,0,.00nan,0,0
34792,26948,546,0,0,0,0,.00nan,0,0
34793,4820,545,85,26,1,25,.962,3900000,0
34793,6681,545,0,0,0,0,.00nan,0,0
34793,7850,2190,82,30,1,29,.967,3900000,0
34793,25712,2190,0,0,0,0,.00nan,0,0
34794,937,543,64,36,4,32,.889,3600000,0
34794,10568,547,0,0,0,0,.00nan,0,0
34794,29293,543,0,0,0,0,.00nan,0,0
34794,54126,547,100,27,0,27,1000,3600000,0
34795,4285,549,0,0,0,0,.00nan,0,0
34795,9758,551,0,0,0,0,.00nan,0,0
34795,9835,549,47,25,4,21,.840,3600000,0
34795,10116,551,96,21,0,21,1000,3600000,0
34796,1924,546,43,24,4,20,.833,3600000,0
34796,10568,547,0,0,0,0,.00nan,0,0
34796,26948,546,0,0,0,0,.00nan,0,0
34796,54126,547,88,25,1,24,.960,3600000,0
34797,937,543,0,0,0,0,.00nan,0,0
34797,17729,548,0,0,0,0,.00nan,0,0
34797,25298,548,99,40,1,39,.975,3600000,0
34797,29293,543,74,28,2,26,.929,3542000,0
34798,7850,2190,0,0,0,0,.00nan,0,0
34798,9758,551,0,0,0,0,.00nan,0,0
34798,10116,551,69,39,4,35,.897,3600000,0
34798,25712,2190,63,37,5,32,.865,3590000,0
34953,937,543,48,29,4,25,.862,3620000,0
34953,10568,547,0,0,0,0,.00nan,0,0
34953,29293,543,0,0,0,0,.00nan,0,0
34953,54126,547,34,21,5,16,.762,3620000,0
34955,4285,549,0,0,0,0,.00nan,0,0
34955,9758,551,85,43,3,40,.930,3600000,0
34955,10116,551,0,0,0,0,.00nan,0,0
34955,17355,549,96,29,0,29,1000,3600000,0
34957,1924,546,0,0,0,0,.00nan,0,0
34957,4820,545,100,28,0,28,1000,3600000,0
34957,21846,545,0,0,0,0,.00nan,0,0
34957,26948,546,70,32,3,29,.906,3600000,0
34959,1675,550,97,26,0,26,1000,3600000,0
34959,7850,2190,0,0,0,0,.00nan,0,0
34959,25712,2190,54,36,4,32,.889,3600000,0
34959,45324,550,0,0,0,0,.00nan,0,0
34961,1675,550,0,0,0,0,.00nan,0,0
34961,7850,2190,67,31,2,29,.935,3900000,0
34961,25712,2190,0,0,0,0,.00nan,0,0
34961,45324,550,72,26,2,24,.923,3900000,0
34963,9758,551,0,0,0,0,.00nan,0,0
34963,10116,551,64,26,2,24,.923,3600000,0
34963,10568,547,46,28,4,24,.857,3571000,0
34963,54126,547,0,0,0,0,.00nan,0,0
34965,4285,549,0,0,0,0,.00nan,0,0
34965,17355,549,27,22,5,17,.773,3600000,0
34965,17729,548,0,0,0,0,.00nan,0,0
34965,25298,548,100,53,2,51,.962,3600000,0
34967,937,543,0,0,0,0,.00nan,0,0
34967,1924,546,87,46,4,42,.913,3597000,0
34967,26948,546,0,0,0,0,.00nan,0,0
34967,29293,543,60,28,3,25,.893,3600000,0
34969,4285,549,55,22,2,20,.909,3600000,0
34969,9758,551,54,39,6,33,.846,3600000,0
34969,10116,551,0,0,0,0,.00nan,0,0
34969,17355,549,0,0,0,0,.00nan,0,0
34971,1675,550,49,22,3,19,.864,3600000,0
34971,1924,546,0,0,0,0,.00nan,0,0
34971,26948,546,65,41,5,36,.878,3588000,0
34971,45324,550,0,0,0,0,.00nan,0,0
34973,937,543,0,0,0,0,.00nan,0,0
34973,10568,547,0,0,0,0,.00nan,0,0
34973,29293,543,45,36,5,31,.861,3577000,0
34973,54126,547,57,25,3,22,.880,3600000,0
34975,7850,2190,0,0,0,0,.00nan,0,0
34975,17729,548,0,0,0,0,.00nan,0,0
34975,25298,548,59,24,2,22,.917,3900000,0
34975,25712,2190,88,35,2,33,.943,3900000,0
34977,4285,549,0,0,0,0,.00nan,0,0
34977,7850,2190,0,0,0,0,.00nan,0,0
34977,17355,549,59,25,3,22,.880,3832000,0
34977,25712,2190,55,31,4,27,.871,3832000,0
34979,1675,550,72,30,3,27,.900,3830000,0
34979,9758,551,0,0,0,0,.00nan,0,0
34979,10116,551,79,42,4,38,.905,3830000,0
34979,45324,550,0,0,0,0,.00nan,0,0
34981,1924,546,0,0,0,0,.00nan,0,0
34981,17729,548,0,0,0,0,.00nan,0,0
34981,25298,548,49,33,5,28,.848,3537000,0
34981,26948,546,73,33,3,30,.909,3600000,0
34983,4820,545,95,36,2,34,.944,3600000,0
34983,10568,547,0,0,0,0,.00nan,0,0
34983,21846,545,0,0,0,0,.00nan,0,0
34983,54126,547,79,40,3,37,.925,3545000,0
34985,4285,549,53,3,0,3,1000,475000,0
34985,4820,545,0,0,0,0,.00nan,0,0
34985,17355,549,41,27,5,22,.815,3069000,0
34985,21846,545,45,28,4,24,.857,3600000,0
34987,1675,550,0,0,0,0,.00nan,0,0
34987,17729,548,77,32,2,30,.938,3600000,0
34987,25298,548,0,0,0,0,.00nan,0,0
34987,45324,550,50,32,4,28,.875,3556000,0
34989,7850,2190,13,29,7,22,.759,2600000,0
34989,10568,547,51,29,4,25,.862,3600000,0
34989,25712,2190,55,5,0,5,1000,1000000,0
34989,54126,547,0,0,0,0,.00nan,0,0
34991,937,543,0,0,0,0,.00nan,0,0
34991,1924,546,78,53,6,47,.887,3600000,0
34991,26948,546,0,0,0,0,.00nan,0,0
34991,29293,543,51,23,3,20,.870,3600000,0
34993,937,543,71,23,2,21,.913,3543000,0
34993,1924,546,0,0,0,0,.00nan,0,0
34993,26948,546,91,39,1,38,.974,3600000,0
34993,29293,543,0,0,0,0,.00nan,0,0
34995,1675,550,72,46,5,41,.891,3600000,0
34995,9835,549,81,21,1,20,.952,3600000,0
34995,17355,549,0,0,0,0,.00nan,0,0
34995,45324,550,0,0,0,0,.00nan,0,0
34999,10568,547,0,0,0,0,.00nan,0,0
34999,17729,548,0,0,0,0,.00nan,0,0
34999,25298,548,69,31,3,28,.903,3590000,0
34999,54126,547,68,29,2,27,.931,3600000,0
35001,1675,550,0,0,0,0,.00nan,0,0
35001,10568,547,93,30,1,29,.967,3600000,0
35001,45324,550,49,15,2,13,.867,3598000,0
35001,54126,547,0,0,0,0,.00nan,0,0
35003,1924,546,59,34,4,30,.882,3521000,0
35003,4820,545,59,26,2,24,.923,3600000,0
35003,21846,545,0,0,0,0,.00nan,0,0
35003,26948,546,0,0,0,0,.00nan,0,0
35007,9835,549,0,0,0,0,.00nan,0,0
35007,17355,549,64,31,3,28,.903,3900000,0
35007,17729,548,79,38,3,35,.921,3900000,0
35007,25298,548,0,0,0,0,.00nan,0,0
35008,21207,459,0,0,0,0,.00nan,0,0
35008,23049,457,0,0,0,0,.00nan,0,0
35008,23079,459,36,26,5,21,.808,3600000,0
35008,74590,457,18,33,8,25,.758,3600000,0
35009,18115,2579,76,31,2,29,.935,3900000,0
35009,21208,460,73,29,2,27,.931,3900000,0
35009,74562,460,0,0,0,0,.00nan,0,0
35009,76872,2579,0,0,0,0,.00nan,0,0
35010,21207,459,67,20,2,18,.900,3600000,0
35010,23049,457,85,48,4,44,.917,3553000,0
35010,23079,459,0,0,0,0,.00nan,0,0
35010,74590,457,0,0,0,0,.00nan,0,0
35011,21208,460,0,0,0,0,.00nan,0,0
35011,74562,460,63,38,6,32,.842,3900000,0
35011,74634,455,0,0,0,0,.00nan,0,0
35011,77656,455,39,35,6,29,.829,3900000,0
35012,18115,2579,56,24,3,21,.875,3600000,0
35012,21207,459,50,35,5,30,.857,3539000,0
35012,23079,459,0,0,0,0,.00nan,0,0
35012,76872,2579,0,0,0,0,.00nan,0,0
35013,23049,457,61,30,4,26,.867,3775000,0
35013,23054,456,0,0,0,0,.00nan,0,0
35013,74563,456,50,22,3,19,.864,3775000,0
35013,76588,457,0,0,0,0,.00nan,0,0
35014,18115,2579,0,0,0,0,.00nan,0,0
35014,21208,460,72,38,4,34,.895,3815000,0
35014,74562,460,0,0,0,0,.00nan,0,0
35014,76872,2579,52,34,5,29,.853,3815000,0
35015,23049,457,0,0,0,0,.00nan,0,0
35015,23054,456,51,26,4,22,.846,3600000,0
35015,74563,456,0,0,0,0,.00nan,0,0
35015,76588,457,21,31,7,24,.774,3600000,0
35069,18115,2579,0,0,0,0,.00nan,0,0
35069,23054,456,0,0,0,0,.00nan,0,0
35069,74563,456,67,37,3,34,.919,3600000,0
35069,76872,2579,60,18,2,16,.889,3600000,0
35071,21207,459,6,19,7,12,.632,2784000,0
35071,23079,459,39,6,2,4,.667,781000,0
35071,74634,455,52,49,7,42,.857,3600000,0
35071,77656,455,0,0,0,0,.00nan,0,0
35073,21208,460,20,24,6,18,.750,2671000,0
35073,23049,457,32,36,8,28,.778,3706000,0
35073,74562,460,49,8,1,7,.875,1035000,0
35073,74590,457,0,0,0,0,.00nan,0,0
35075,21207,459,0,0,0,0,.00nan,0,0
35075,23049,457,0,0,0,0,.00nan,0,0
35075,23079,459,69,18,1,17,.944,3600000,0
35075,74590,457,88,35,2,33,.943,3545000,0
35077,21208,460,0,0,0,0,.00nan,0,0
35077,74562,460,85,26,1,25,.962,3600000,0
35077,74634,455,0,0,0,0,.00nan,0,0
35077,77656,455,69,27,2,25,.926,3600000,0
35079,18115,2579,61,14,1,13,.929,3600000,0
35079,23054,456,80,31,2,29,.935,3593000,0
35079,74563,456,0,0,0,0,.00nan,0,0
35079,76872,2579,0,0,0,0,.00nan,0,0
35081,18115,2579,0,0,0,0,.00nan,0,0
35081,74634,455,91,42,2,40,.952,3600000,0
35081,76872,2579,43,34,5,29,.853,3600000,0
35081,77656,455,0,0,0,0,.00nan,0,0
35083,21207,459,68,32,3,29,.906,3600000,0
35083,21208,460,53,31,4,27,.871,3594000,0
35083,23079,459,0,0,0,0,.00nan,0,0
35083,74562,460,0,0,0,0,.00nan,0,0
35085,23049,457,28,31,6,25,.806,2877000,0
35085,23054,456,0,0,0,0,.00nan,0,0
35085,74563,456,63,31,3,28,.903,3600000,0
35085,74590,457,38,18,4,14,.778,723000,0
35086,7543,4839,30,6,3,3,.500,231000,0
35086,14278,1368,56,23,3,20,.870,3600000,0
35086,34652,1368,0,0,0,0,.00nan,0,0
35086,35024,4839,64,27,3,24,.889,3369000,0
35087,15578,4919,0,0,0,0,.00nan,0,0
35087,20179,4715,41,22,4,18,.818,3953000,0
35087,24794,4919,73,36,3,33,.917,3953000,0
35087,53629,4715,0,0,0,0,.00nan,0,0
35088,15578,4919,70,37,5,32,.865,3600000,0
35088,20179,4715,0,0,0,0,.00nan,0,0
35088,24794,4919,0,0,0,0,.00nan,0,0
35088,53629,4715,56,19,3,16,.842,3600000,0
35089,7543,4839,21,3,3,0,.000,446000,0
35089,14278,1368,94,41,2,39,.951,3600000,0
35089,34652,1368,0,0,0,0,.00nan,0,0
35089,35024,4839,62,28,3,25,.893,3154000,0
35090,5278,4246,34,14,4,10,.714,1104000,0
35090,15578,4919,0,0,0,0,.00nan,0,0
35090,24794,4919,69,48,6,42,.875,3600000,0
35090,34602,4246,42,15,3,12,.800,2437000,0
35091,7543,4839,0,0,0,0,.00nan,0,0
35091,34154,4997,0,0,0,0,.00nan,0,0
35091,35024,4839,78,35,3,32,.914,3850000,0
35091,50483,4997,77,36,2,34,.944,3850000,0
35092,181,4714,0,0,0,0,.00nan,0,0
35092,3705,4714,77,21,1,20,.952,3600000,0
35092,35361,4715,0,0,0,0,.00nan,0,0
35092,53629,4715,70,30,2,28,.933,3600000,0
35093,17446,165,0,0,0,0,.00nan,0,0
35093,32460,4998,49,45,6,39,.867,3600000,0
35093,35812,165,49,24,4,20,.833,3600000,0
35093,52839,4998,0,0,0,0,.00nan,0,0
35094,14278,1368,70,42,4,38,.905,3811000,0
35094,22098,4716,51,29,5,24,.828,3811000,0
35094,34652,1368,0,0,0,0,.00nan,0,0
35094,40887,4716,0,0,0,0,.00nan,0,0
35095,181,4714,66,38,5,33,.868,3565000,0
35095,3705,4714,0,0,0,0,.00nan,0,0
35095,35361,4715,77,40,3,37,.925,3600000,0
35095,53629,4715,0,0,0,0,.00nan,0,0
35096,17446,165,71,25,2,23,.920,3600000,0
35096,32460,4998,0,0,0,0,.00nan,0,0
35096,35812,165,0,0,0,0,.00nan,0,0
35096,52839,4998,58,34,5,29,.853,3600000,0
35097,5278,4246,74,33,4,29,.879,1926000,0
35097,15578,4919,44,30,5,25,.833,3600000,0
35097,24794,4919,0,0,0,0,.00nan,0,0
35097,34602,4246,31,21,5,16,.762,1674000,0
35098,7543,4839,75,37,3,34,.919,3600000,0
35098,34154,4997,23,29,6,23,.793,3600000,0
35098,35024,4839,0,0,0,0,.00nan,0,0
35098,50483,4997,0,0,0,0,.00nan,0,0
35099,14278,1368,0,0,0,0,.00nan,0,0
35099,22098,4716,43,4,1,3,.750,469000,0
35099,34652,1368,67,23,2,21,.913,3600000,0
35099,40887,4716,34,30,6,24,.800,3131000,0
35367,32460,4998,70,34,3,31,.912,3544000,0
35367,34154,4997,0,0,0,0,.00nan,0,0
35367,50483,4997,69,21,2,19,.905,3600000,0
35367,52839,4998,0,0,0,0,.00nan,0,0
35369,4261,1368,20,25,6,19,.760,3600000,0
35369,14278,1368,0,0,0,0,.00nan,0,0
35369,17446,165,0,0,0,0,.00nan,0,0
35369,29241,165,56,26,3,23,.885,3600000,0
35371,181,4714,0,0,0,0,.00nan,0,0
35371,3705,4714,63,40,4,36,.900,3843000,0
35371,4077,4919,62,25,3,22,.880,3843000,0
35371,15578,4919,0,0,0,0,.00nan,0,0
35373,1102,4716,69,17,1,16,.941,3600000,0
35373,5278,4246,94,50,4,46,.920,3600000,0
35373,34602,4246,0,0,0,0,.00nan,0,0
35373,40887,4716,0,0,0,0,.00nan,0,0
35375,7543,4839,0,0,0,0,.00nan,0,0
35375,20179,4715,56,28,4,24,.857,3600000,0
35375,35024,4839,35,28,6,22,.786,3579000,0
35375,53629,4715,0,0,0,0,.00nan,0,0
35377,181,4714,0,0,0,0,.00nan,0,0
35377,3705,4714,50,40,6,34,.850,3600000,0
35377,15578,4919,87,16,0,16,1000,3600000,0
35377,24794,4919,0,0,0,0,.00nan,0,0
35379,17446,165,0,0,0,0,.00nan,0,0
35379,20179,4715,69,40,4,36,.900,3748000,0
35379,36309,165,70,34,3,31,.912,3748000,0
35379,53629,4715,0,0,0,0,.00nan,0,0
35381,7543,4839,0,0,0,0,.00nan,0,0
35381,32460,4998,44,34,5,29,.853,3600000,0
35381,35024,4839,59,20,2,18,.900,3600000,0
35381,52839,4998,0,0,0,0,.00nan,0,0
35383,5278,4246,61,21,2,19,.905,3600000,0
35383,14278,1368,0,0,0,0,.00nan,0,0
35383,34602,4246,0,0,0,0,.00nan,0,0
35383,34652,1368,38,30,5,25,.833,3600000,0
35385,1102,4716,59,21,2,19,.905,3571000,0
35385,34154,4997,70,21,1,20,.952,3600000,0
35385,40887,4716,0,0,0,0,.00nan,0,0
35385,50483,4997,0,0,0,0,.00nan,0,0
35387,15578,4919,46,32,6,26,.813,2812000,0
35387,24794,4919,55,8,1,7,.875,788000,0
35387,32460,4998,0,0,0,0,.00nan,0,0
35387,52839,4998,59,21,2,19,.905,3600000,0
35389,1102,4716,0,0,0,0,.00nan,0,0
35389,14278,1368,61,28,3,25,.893,3517000,0
35389,34652,1368,0,0,0,0,.00nan,0,0
35389,40887,4716,73,23,1,22,.957,3600000,0
35391,17446,165,49,19,3,16,.842,3519000,0
35391,34154,4997,0,0,0,0,.00nan,0,0
35391,36309,165,0,0,0,0,.00nan,0,0
35391,50483,4997,81,26,1,25,.962,3600000,0
35393,181,4714,49,36,5,31,.861,3600000,0
35393,3705,4714,0,0,0,0,.00nan,0,0
35393,7543,4839,33,16,4,12,.750,3600000,0
35393,35024,4839,0,0,0,0,.00nan,0,0
35395,5278,4246,66,17,1,16,.941,1661000,0
35395,20179,4715,0,0,0,0,.00nan,0,0
35395,34602,4246,30,19,4,15,.789,1939000,0
35395,53629,4715,72,30,3,27,.900,3600000,0
35397,14278,1368,100,29,0,29,1000,3600000,0
35397,34154,4997,0,0,0,0,.00nan,0,0
35397,34652,1368,0,0,0,0,.00nan,0,0
35397,50483,4997,27,25,6,19,.760,3600000,0
35399,1102,4716,46,17,3,14,.824,3600000,0
35399,5278,4246,0,0,0,0,.00nan,0,0
35399,34602,4246,82,43,4,39,.907,3600000,0
35399,40887,4716,0,0,0,0,.00nan,0,0
35401,7543,4839,0,0,0,0,.00nan,0,0
35401,20179,4715,0,0,0,0,.00nan,0,0
35401,35024,4839,48,23,3,20,.870,3600000,0
35401,53629,4715,91,20,0,20,1000,3600000,0
35403,181,4714,0,0,0,0,.00nan,0,0
35403,3705,4714,56,40,5,35,.875,3541000,0
35403,17446,165,39,20,4,16,.800,3600000,0
35403,36309,165,0,0,0,0,.00nan,0,0
35405,15578,4919,0,0,0,0,.00nan,0,0
35405,24794,4919,100,33,0,33,1000,3600000,0
35405,32460,4998,0,0,0,0,.00nan,0,0
35405,52839,4998,55,22,3,19,.864,3600000,0
35407,5278,4246,51,29,5,24,.828,3600000,0
35407,20179,4715,0,0,0,0,.00nan,0,0
35407,34602,4246,0,0,0,0,.00nan,0,0
35407,53629,4715,90,18,0,18,1000,3600000,0
35409,17446,165,0,0,0,0,.00nan,0,0
35409,32460,4998,51,31,4,27,.871,3600000,0
35409,36309,165,78,25,1,24,.960,3600000,0
35409,52839,4998,0,0,0,0,.00nan,0,0
35411,181,4714,51,25,3,22,.880,3600000,0
35411,3705,4714,0,0,0,0,.00nan,0,0
35411,7543,4839,42,30,5,25,.833,3559000,0
35411,35024,4839,0,0,0,0,.00nan,0,0
35413,14278,1368,76,28,1,27,.964,3600000,0
35413,34154,4997,34,34,6,28,.824,3600000,0
35413,34652,1368,0,0,0,0,.00nan,0,0
35413,50483,4997,0,0,0,0,.00nan,0,0
35415,1102,4716,0,0,0,0,.00nan,0,0
35415,15578,4919,58,32,4,28,.875,3524000,0
35415,24794,4919,0,0,0,0,.00nan,0,0
35415,40887,4716,56,18,2,16,.889,3600000,0
35417,181,4714,0,0,0,0,.00nan,0,0
35417,3705,4714,53,17,2,15,.882,3600000,0
35417,20179,4715,0,0,0,0,.00nan,0,0
35417,53629,4715,64,41,4,37,.902,3579000,0
35419,5278,4246,0,0,0,0,.00nan,0,0
35419,32460,4998,0,0,0,0,.00nan,0,0
35419,34602,4246,47,30,4,26,.867,3600000,0
35419,52839,4998,99,25,0,25,1000,3600000,0
35421,7543,4839,0,0,0,0,.00nan,0,0
35421,17446,165,0,0,0,0,.00nan,0,0
35421,35024,4839,69,44,4,40,.909,3600000,0
35421,36309,165,76,22,1,21,.955,3600000,0
35423,1102,4716,68,23,2,21,.913,3600000,0
35423,34154,4997,0,0,0,0,.00nan,0,0
35423,40887,4716,0,0,0,0,.00nan,0,0
35423,50483,4997,31,40,7,33,.825,3600000,0
35425,14278,1368,89,27,1,26,.963,3600000,0
35425,15578,4919,0,0,0,0,.00nan,0,0
35425,24794,4919,57,29,4,25,.862,3600000,0
35425,34652,1368,0,0,0,0,.00nan,0,0
35427,14278,1368,0,0,0,0,.00nan,0,0
35427,20179,4715,57,35,4,31,.886,3545000,0
35427,34652,1368,77,37,3,34,.919,3600000,0
35427,53629,4715,0,0,0,0,.00nan,0,0
35429,181,4714,48,24,4,20,.833,4200000,0
35429,3705,4714,0,0,0,0,.00nan,0,0
35429,17446,165,29,27,4,23,.852,4200000,0
35429,36309,165,0,0,0,0,.00nan,0,0
35431,15578,4919,64,21,2,19,.905,3600000,0
35431,24794,4919,0,0,0,0,.00nan,0,0
35431,34154,4997,75,23,1,22,.957,3600000,0
35431,50483,4997,0,0,0,0,.00nan,0,0
35433,7543,4839,63,21,2,19,.905,3600000,0
35433,32460,4998,65,23,2,21,.913,2483000,0
35433,35024,4839,0,0,0,0,.00nan,0,0
35433,52839,4998,24,13,4,9,.692,1117000,0
35435,1102,4716,0,0,0,0,.00nan,0,0
35435,5278,4246,72,40,5,35,.875,3600000,0
35435,34602,4246,0,0,0,0,.00nan,0,0
35435,40887,4716,75,16,1,15,.938,3600000,0
35436,2759,169,0,0,0,0,.00nan,0,0
35436,21097,174,61,28,2,26,.929,3900000,0
35436,22412,169,84,30,2,28,.933,3900000,0
35436,45310,174,0,0,0,0,.00nan,0,0
35437,2485,175,79,34,4,30,.882,3573000,0
35437,22573,170,71,28,2,26,.929,3600000,0
35437,34969,170,0,0,0,0,.00nan,0,0
35437,40324,175,0,0,0,0,.00nan,0,0
35438,21097,174,0,0,0,0,.00nan,0,0
35438,25307,172,47,31,5,26,.839,3869000,0
35438,34648,172,0,0,0,0,.00nan,0,0
35438,45310,174,69,50,5,45,.900,3900000,0
35439,5191,1527,0,0,0,0,.00nan,0,0
35439,32634,1527,66,23,2,21,.913,3541000,0
35439,35226,4883,100,34,0,34,1000,3600000,0
35439,35414,4883,0,0,0,0,.00nan,0,0
35440,162,171,74,38,4,34,.895,3600000,0
35440,24064,4247,0,0,0,0,.00nan,0,0
35440,35846,171,0,0,0,0,.00nan,0,0
35440,58654,4247,45,40,6,34,.850,3556000,0
35441,5281,167,57,24,3,21,.875,3524000,0
35441,20021,3916,0,0,0,0,.00nan,0,0
35441,22017,3916,100,35,1,34,.971,3600000,0
35441,58387,167,0,0,0,0,.00nan,0,0
35442,2485,175,0,0,0,0,.00nan,0,0
35442,22573,170,0,0,0,0,.00nan,0,0
35442,34969,170,55,24,3,21,.875,3554000,0
35442,40324,175,84,33,2,31,.939,3600000,0
35443,162,171,0,0,0,0,.00nan,0,0
35443,24064,4247,69,32,3,29,.906,3600000,0
35443,35846,171,64,24,2,22,.917,3600000,0
35443,58654,4247,0,0,0,0,.00nan,0,0
35444,5191,1527,33,21,4,17,.810,1045000,0
35444,32634,1527,20,21,6,15,.714,2555000,0
35444,35226,4883,57,21,2,19,.905,3600000,0
35444,35414,4883,0,0,0,0,.00nan,0,0
35445,2759,169,87,32,1,31,.969,3600000,0
35445,22412,169,0,0,0,0,.00nan,0,0
35445,25307,172,0,0,0,0,.00nan,0,0
35445,34648,172,46,30,5,25,.833,3600000,0
35446,5281,167,0,0,0,0,.00nan,0,0
35446,20021,3916,63,32,4,28,.875,3600000,0
35446,22017,3916,0,0,0,0,.00nan,0,0
35446,58387,167,92,31,1,30,.968,3600000,0
35745,2485,175,69,26,2,24,.923,3600000,0
35745,35226,4883,56,36,5,31,.861,3600000,0
35745,35414,4883,0,0,0,0,.00nan,0,0
35745,40324,175,0,0,0,0,.00nan,0,0
35747,21097,174,51,19,3,16,.842,3584000,0
35747,25307,172,91,38,2,36,.947,3600000,0
35747,34648,172,0,0,0,0,.00nan,0,0
35747,45310,174,0,0,0,0,.00nan,0,0
35749,22573,170,28,35,7,28,.800,3347000,0
35749,29670,4247,0,0,0,0,.00nan,0,0
35749,34969,170,53,3,0,3,1000,253000,0
35749,58654,4247,84,26,1,25,.962,3600000,0
35751,2759,169,73,45,5,40,.889,3849000,0
35751,5191,1527,47,23,4,19,.826,3849000,0
35751,22412,169,0,0,0,0,.00nan,0,0
35751,32634,1527,0,0,0,0,.00nan,0,0
35753,162,171,0,0,0,0,.00nan,0,0
35753,20021,3916,85,35,2,33,.943,3519000,0
35753,22017,3916,0,0,0,0,.00nan,0,0
35753,35846,171,82,28,1,27,.964,3600000,0
35755,22573,170,0,0,0,0,.00nan,0,0
35755,29670,4247,0,0,0,0,.00nan,0,0
35755,34969,170,34,19,4,15,.789,3600000,0
35755,58654,4247,46,30,5,25,.833,3600000,0
35757,162,171,90,18,0,18,1000,3600000,0
35757,35226,4883,76,27,2,25,.926,3569000,0
35757,35414,4883,0,0,0,0,.00nan,0,0
35757,35846,171,0,0,0,0,.00nan,0,0
35759,5281,167,75,28,1,27,.964,3600000,0
35759,20021,3916,68,45,5,40,.889,3600000,0
35759,22017,3916,0,0,0,0,.00nan,0,0
35759,58387,167,0,0,0,0,.00nan,0,0
35761,2485,175,0,0,0,0,.00nan,0,0
35761,21097,174,67,39,4,35,.897,3600000,0
35761,40324,175,71,23,1,22,.957,3600000,0
35761,45310,174,0,0,0,0,.00nan,0,0
35763,5191,1527,85,25,1,24,.960,3600000,0
35763,25307,172,0,0,0,0,.00nan,0,0
35763,32634,1527,0,0,0,0,.00nan,0,0
35763,34648,172,64,22,2,20,.909,3563000,0
35765,162,171,64,18,2,16,.889,3600000,0
35765,35226,4883,0,0,0,0,.00nan,0,0
35765,35414,4883,71,27,3,24,.889,3574000,0
35765,35846,171,0,0,0,0,.00nan,0,0
35767,5281,167,0,0,0,0,.00nan,0,0
35767,29670,4247,91,38,2,36,.947,3600000,0
35767,58387,167,44,29,5,24,.828,3600000,0
35767,58654,4247,0,0,0,0,.00nan,0,0
35769,5191,1527,0,0,0,0,.00nan,0,0
35769,25307,172,70,24,2,22,.917,3900000,0
35769,32634,1527,80,26,2,24,.923,3900000,0
35769,34648,172,0,0,0,0,.00nan,0,0
35771,2485,175,78,26,2,24,.923,3817000,0
35771,2759,169,0,0,0,0,.00nan,0,0
35771,22412,169,78,35,3,32,.914,3817000,0
35771,40324,175,0,0,0,0,.00nan,0,0
35773,20021,3916,0,0,0,0,.00nan,0,0
35773,22017,3916,65,34,3,31,.912,3587000,0
35773,22573,170,77,31,2,29,.935,3600000,0
35773,34969,170,0,0,0,0,.00nan,0,0
35775,5281,167,68,33,3,30,.909,3600000,0
35775,22573,170,49,30,5,25,.833,3600000,0
35775,34969,170,0,0,0,0,.00nan,0,0
35775,58387,167,0,0,0,0,.00nan,0,0
35777,162,171,0,0,0,0,.00nan,0,0
35777,5191,1527,0,0,0,0,.00nan,0,0
35777,32634,1527,68,17,1,16,.941,3600000,0
35777,35846,171,79,25,2,23,.920,3567000,0
35779,20021,3916,68,34,4,30,.882,3600000,0
35779,22017,3916,0,0,0,0,.00nan,0,0
35779,29670,4247,35,27,5,22,.815,3600000,0
35779,58654,4247,0,0,0,0,.00nan,0,0
35781,2485,175,0,0,0,0,.00nan,0,0
35781,2759,169,32,29,6,23,.793,2698000,0
35781,22412,169,56,5,0,5,1000,902000,0
35781,40324,175,99,22,0,22,1000,3600000,0
35783,21097,174,65,21,2,19,.905,3714000,0
35783,25307,172,70,32,3,29,.906,3714000,0
35783,34648,172,0,0,0,0,.00nan,0,0
35783,45310,174,0,0,0,0,.00nan,0,0
35785,25307,172,0,0,0,0,.00nan,0,0
35785,29670,4247,0,0,0,0,.00nan,0,0
35785,34648,172,68,28,2,26,.929,3900000,0
35785,58654,4247,77,32,2,30,.938,3900000,0
35787,5191,1527,80,30,1,29,.967,3600000,0
35787,22573,170,0,0,0,0,.00nan,0,0
35787,32634,1527,0,0,0,0,.00nan,0,0
35787,34969,170,69,24,2,22,.917,3566000,0
35789,162,171,51,44,6,38,.864,3600000,0
35789,5281,167,0,0,0,0,.00nan,0,0
35789,35846,171,0,0,0,0,.00nan,0,0
35789,58387,167,61,24,2,22,.917,3600000,0
35791,2759,169,0,0,0,0,.00nan,0,0
35791,22412,169,97,36,2,34,.944,3900000,0
35791,35226,4883,71,27,2,25,.926,3900000,0
35791,35414,4883,0,0,0,0,.00nan,0,0
35793,20021,3916,0,0,0,0,.00nan,0,0
35793,21097,174,0,0,0,0,.00nan,0,0
35793,22017,3916,93,39,2,37,.949,3600000,0
35793,45310,174,40,15,3,12,.800,3600000,0
35795,22573,170,0,0,0,0,.00nan,0,0
35795,29670,4247,27,36,7,29,.806,3600000,0
35795,34969,170,49,28,4,24,.857,3600000,0
35795,58654,4247,0,0,0,0,.00nan,0,0
35797,2759,169,91,34,3,31,.912,3900000,0
35797,21097,174,66,27,3,24,.889,3900000,0
35797,22412,169,0,0,0,0,.00nan,0,0
35797,45310,174,0,0,0,0,.00nan,0,0
35799,2485,175,0,0,0,0,.00nan,0,0
35799,5281,167,36,20,4,16,.800,964000,0
35799,40324,175,79,11,0,11,1000,3600000,0
35799,58387,167,33,18,4,14,.778,2636000,0
35801,5191,1527,0,0,0,0,.00nan,0,0
35801,20021,3916,50,28,4,24,.857,3552000,0
35801,22017,3916,0,0,0,0,.00nan,0,0
35801,32634,1527,92,42,3,39,.929,3600000,0
35803,162,171,52,19,3,16,.842,3600000,0
35803,25307,172,99,37,1,36,.973,3600000,0
35803,34648,172,0,0,0,0,.00nan,0,0
35803,35846,171,0,0,0,0,.00nan,0,0
35805,5281,167,83,28,2,26,.929,3600000,0
35805,35226,4883,0,0,0,0,.00nan,0,0
35805,35414,4883,100,23,0,23,1000,3600000,0
35805,58387,167,0,0,0,0,.00nan,0,0
35807,2759,169,0,0,0,0,.00nan,0,0
35807,21097,174,0,0,0,0,.00nan,0,0
35807,22412,169,85,33,1,32,.970,3900000,0
35807,45310,174,83,25,1,24,.960,3900000,0
35809,22573,170,56,23,3,20,.870,3626000,0
35809,25307,172,0,0,0,0,.00nan,0,0
35809,34648,172,72,30,2,28,.933,3601000,0
35809,34969,170,0,0,0,0,.00nan,0,0
35811,162,171,0,0,0,0,.00nan,0,0
35811,29670,4247,0,0,0,0,.00nan,0,0
35811,35846,171,27,12,4,8,.667,3524000,0
35811,58654,4247,80,33,2,31,.939,3600000,0
35813,2485,175,62,14,1,13,.929,2945000,0
35813,20021,3916,0,0,0,0,.00nan,0,0
35813,22017,3916,75,37,3,34,.919,3600000,0
35813,40324,175,29,9,3,6,.667,593000,0
35814,7034,889,80,45,4,41,.911,3900000,0
35814,18969,872,48,26,4,22,.846,3900000,0
35814,40900,889,0,0,0,0,.00nan,0,0
35814,62307,872,0,0,0,0,.00nan,0,0
35815,882,966,0,0,0,0,.00nan,0,0
35815,23726,1414,99,32,1,31,.969,3654000,0
35815,25483,1414,0,0,0,0,.00nan,0,0
35815,33507,966,76,28,2,26,.929,3654000,0
35816,1719,945,0,0,0,0,.00nan,0,0
35816,2201,945,63,28,3,25,.893,3571000,0
35816,45036,885,78,26,1,25,.962,3600000,0
35816,45059,885,0,0,0,0,.00nan,0,0
35817,5545,970,77,41,3,38,.927,3554000,0
35817,17419,880,70,29,2,27,.931,3600000,0
35817,33501,880,0,0,0,0,.00nan,0,0
35817,145759,970,0,0,0,0,.00nan,0,0
35818,15245,983,0,0,0,0,.00nan,0,0
35818,23733,983,75,31,2,29,.935,3900000,0
35818,25679,886,0,0,0,0,.00nan,0,0
35818,68497,886,74,30,2,28,.933,3900000,0
35819,6527,894,0,0,0,0,.00nan,0,0
35819,10809,890,66,29,2,27,.931,3900000,0
35819,19094,890,0,0,0,0,.00nan,0,0
35819,52559,894,86,40,2,38,.950,3900000,0
35820,12486,873,0,0,0,0,.00nan,0,0
35820,19014,996,99,43,1,42,.977,3900000,0
35820,25690,996,0,0,0,0,.00nan,0,0
35820,52476,873,63,21,1,20,.952,3900000,0
35821,6527,894,0,0,0,0,.00nan,0,0
35821,7034,889,59,33,4,29,.879,3574000,0
35821,40900,889,0,0,0,0,.00nan,0,0
35821,52559,894,66,30,3,27,.900,3600000,0
35822,10481,885,67,29,3,26,.897,3600000,0
35822,18969,872,37,26,5,21,.808,3587000,0
35822,45036,885,0,0,0,0,.00nan,0,0
35822,62307,872,0,0,0,0,.00nan,0,0
35823,882,966,0,0,0,0,.00nan,0,0
35823,17419,880,62,28,2,26,.929,3900000,0
35823,33501,880,0,0,0,0,.00nan,0,0
35823,33507,966,81,35,2,33,.943,3900000,0
35824,1719,945,0,0,0,0,.00nan,0,0
35824,2201,945,89,35,2,33,.943,3583000,0
35824,19014,996,0,0,0,0,.00nan,0,0
35824,25690,996,100,25,0,25,1000,3600000,0
35825,5545,970,82,36,2,34,.944,3664000,0
35825,23726,1414,0,0,0,0,.00nan,0,0
35825,25483,1414,71,33,3,30,.909,3664000,0
35825,145759,970,0,0,0,0,.00nan,0,0
35826,12486,873,0,0,0,0,.00nan,0,0
35826,25679,886,100,28,0,28,1000,3600000,0
35826,52476,873,54,20,2,18,.900,3537000,0
35826,68497,886,0,0,0,0,.00nan,0,0
35827,10809,890,64,12,1,11,.917,3600000,0
35827,15245,983,58,47,6,41,.872,3600000,0
35827,19094,890,0,0,0,0,.00nan,0,0
35827,23733,983,0,0,0,0,.00nan,0,0
35828,882,966,0,0,0,0,.00nan,0,0
35828,12486,873,0,0,0,0,.00nan,0,0
35828,33507,966,80,35,3,32,.914,3514000,0
35828,52476,873,88,32,1,31,.969,3600000,0
35829,1719,945,51,9,1,8,.889,360000,0
35829,2201,945,41,41,7,34,.829,3240000,0
35829,6527,894,0,0,0,0,.00nan,0,0
35829,52559,894,66,30,3,27,.900,3600000,0
35830,10809,890,45,19,3,16,.842,3600000,0
35830,19094,890,0,0,0,0,.00nan,0,0
35830,23726,1414,87,36,2,34,.944,3600000,0
35830,25483,1414,0,0,0,0,.00nan,0,0
35831,5545,970,47,36,6,30,.833,2536000,0
35831,10481,885,0,0,0,0,.00nan,0,0
35831,45036,885,48,27,4,23,.852,3600000,0
35831,145759,970,66,8,0,8,1000,1042000,0
35832,15245,983,78,50,5,45,.900,3533000,0
35832,18969,872,34,12,3,9,.750,3600000,0
35832,23733,983,0,0,0,0,.00nan,0,0
35832,62307,872,0,0,0,0,.00nan,0,0
35833,7034,889,100,34,0,34,1000,3600000,0
35833,25679,886,91,31,1,30,.968,3552000,0
35833,40900,889,0,0,0,0,.00nan,0,0
35833,68497,886,0,0,0,0,.00nan,0,0
35834,17419,880,24,27,6,21,.778,3600000,0
35834,19014,996,57,15,1,14,.933,1560000,0
35834,25690,996,23,26,6,20,.769,1999000,0
35834,33501,880,0,0,0,0,.00nan,0,0
35835,7034,889,76,27,2,25,.926,3600000,0
35835,19014,996,69,36,3,33,.917,3591000,0
35835,25690,996,0,0,0,0,.00nan,0,0
35835,40900,889,0,0,0,0,.00nan,0,0
35836,10809,890,51,34,5,29,.853,3600000,0
35836,19094,890,0,0,0,0,.00nan,0,0
35836,25679,886,57,29,4,25,.862,3600000,0
35836,68497,886,0,0,0,0,.00nan,0,0
35837,10481,885,57,33,4,29,.879,3600000,0
35837,18969,872,90,31,1,30,.968,3600000,0
35837,45036,885,0,0,0,0,.00nan,0,0
35837,62307,872,0,0,0,0,.00nan,0,0
35838,882,966,0,0,0,0,.00nan,0,0
35838,1719,945,0,0,0,0,.00nan,0,0
35838,2201,945,66,28,3,25,.893,3600000,0
35838,33507,966,96,26,0,26,1000,3600000,0
35839,5545,970,95,29,1,28,.966,3600000,0
35839,12486,873,0,0,0,0,.00nan,0,0
35839,52476,873,77,32,2,30,.938,3549000,0
35839,145759,970,0,0,0,0,.00nan,0,0
35840,15245,983,76,35,3,32,.914,3600000,0
35840,17419,880,48,32,4,28,.875,3600000,0
35840,23733,983,0,0,0,0,.00nan,0,0
35840,33501,880,0,0,0,0,.00nan,0,0
35841,6527,894,0,0,0,0,.00nan,0,0
35841,23726,1414,0,0,0,0,.00nan,0,0
35841,25483,1414,36,34,6,28,.824,3559000,0
35841,52559,894,48,31,5,26,.839,3600000,0
35842,7034,889,54,23,2,21,.913,3600000,0
35842,23726,1414,83,27,1,26,.963,3600000,0
35842,25483,1414,0,0,0,0,.00nan,0,0
35842,40900,889,0,0,0,0,.00nan,0,0
35843,15245,983,99,35,2,33,.943,3600000,0
35843,18969,872,0,0,0,0,.00nan,0,0
35843,23733,983,0,0,0,0,.00nan,0,0
35843,62307,872,68,27,3,24,.889,3559000,0
35844,5545,970,65,27,3,24,.889,3900000,0
35844,19014,996,57,28,3,25,.893,3900000,0
35844,25690,996,0,0,0,0,.00nan,0,0
35844,145759,970,0,0,0,0,.00nan,0,0
35845,882,966,0,0,0,0,.00nan,0,0
35845,33507,966,98,36,2,34,.944,3844000,0
35845,45059,886,66,24,3,21,.875,3844000,0
35845,68497,886,0,0,0,0,.00nan,0,0
35846,6527,894,0,0,0,0,.00nan,0,0
35846,10809,890,50,23,3,20,.870,3600000,0
35846,19094,890,0,0,0,0,.00nan,0,0
35846,52559,894,93,22,0,22,1000,3600000,0
35847,10481,885,0,0,0,0,.00nan,0,0
35847,17419,880,99,23,0,23,1000,3600000,0
35847,33501,880,0,0,0,0,.00nan,0,0
35847,45036,885,71,31,2,29,.935,3600000,0
35848,1719,945,0,0,0,0,.00nan,0,0
35848,2201,945,94,34,1,33,.971,3600000,0
35848,18969,872,87,38,2,36,.947,3600000,0
35848,62307,872,0,0,0,0,.00nan,0,0
35849,882,966,65,50,6,44,.880,3600000,0
35849,19014,996,0,0,0,0,.00nan,0,0
35849,25690,996,61,31,3,28,.903,3600000,0
35849,33507,966,0,0,0,0,.00nan,0,0
35850,15245,983,0,0,0,0,.00nan,0,0
35850,23726,1414,0,0,0,0,.00nan,0,0
35850,23733,983,91,35,1,34,.971,3600000,0
35850,25483,1414,62,32,3,29,.906,3569000,0
35851,10481,885,64,47,5,42,.894,3900000,0
35851,10809,890,27,18,5,13,.722,3900000,0
35851,19094,890,0,0,0,0,.00nan,0,0
35851,45036,885,0,0,0,0,.00nan,0,0
35852,5545,970,65,45,5,40,.889,3579000,0
35852,45059,886,62,24,3,21,.875,3600000,0
35852,68497,886,0,0,0,0,.00nan,0,0
35852,145759,970,0,0,0,0,.00nan,0,0
35853,6527,894,0,0,0,0,.00nan,0,0
35853,17419,880,80,30,2,28,.933,3600000,0
35853,33501,880,0,0,0,0,.00nan,0,0
35853,52559,894,50,20,3,17,.850,3578000,0
35854,1719,945,0,0,0,0,.00nan,0,0
35854,2201,945,86,34,1,33,.971,3600000,0
35854,12486,873,0,0,0,0,.00nan,0,0
35854,52476,873,45,35,6,29,.829,3600000,0
35855,10809,890,65,17,1,16,.941,3575000,0
35855,18969,872,95,22,0,22,1000,3600000,0
35855,19094,890,0,0,0,0,.00nan,0,0
35855,62307,872,0,0,0,0,.00nan,0,0
35856,6527,894,0,0,0,0,.00nan,0,0
35856,19014,996,61,25,3,22,.880,3600000,0
35856,25690,996,0,0,0,0,.00nan,0,0
35856,52559,894,52,28,4,24,.857,3548000,0
35857,10481,885,0,0,0,0,.00nan,0,0
35857,45036,885,88,50,2,48,.960,3538000,0
35857,45059,886,92,16,0,16,1000,3600000,0
35857,68497,886,0,0,0,0,.00nan,0,0
35858,5545,970,50,28,4,24,.857,3600000,0
35858,15245,983,100,41,1,40,.976,3600000,0
35858,23733,983,0,0,0,0,.00nan,0,0
35858,145759,970,0,0,0,0,.00nan,0,0
35859,882,966,0,0,0,0,.00nan,0,0
35859,17419,880,96,18,0,18,1000,3600000,0
35859,33501,880,0,0,0,0,.00nan,0,0
35859,33507,966,98,38,2,36,.947,3600000,0
35860,12486,873,0,0,0,0,.00nan,0,0
35860,15245,983,84,30,1,29,.967,3600000,0
35860,23733,983,0,0,0,0,.00nan,0,0
35860,52476,873,79,33,2,31,.939,3572000,0
35861,1719,945,0,0,0,0,.00nan,0,0
35861,2201,945,40,28,5,23,.821,3564000,0
35861,23726,1414,0,0,0,0,.00nan,0,0
35861,25483,1414,58,34,4,30,.882,3600000,0
35862,882,966,0,0,0,0,.00nan,0,0
35862,6527,894,0,0,0,0,.00nan,0,0
35862,33507,966,68,37,3,34,.919,3600000,0
35862,52559,894,40,31,5,26,.839,3600000,0
35863,10481,885,47,32,5,27,.844,3600000,0
35863,19014,996,62,23,2,21,.913,3600000,0
35863,25690,996,0,0,0,0,.00nan,0,0
35863,45036,885,0,0,0,0,.00nan,0,0
35864,17419,880,70,35,3,32,.914,3900000,0
35864,25679,886,0,0,0,0,.00nan,0,0
35864,33501,880,0,0,0,0,.00nan,0,0
35864,45059,886,54,20,3,17,.850,3900000,0
35865,5545,970,72,30,3,27,.900,3600000,0
35865,10809,890,33,18,4,14,.778,3534000,0
35865,19094,890,0,0,0,0,.00nan,0,0
35865,145759,970,0,0,0,0,.00nan,0,0
35866,7034,889,92,24,1,23,.958,3563000,0
35866,18969,872,93,21,0,21,1000,3600000,0
35866,40900,889,0,0,0,0,.00nan,0,0
35866,62307,872,0,0,0,0,.00nan,0,0
35867,1719,945,0,0,0,0,.00nan,0,0
35867,2201,945,81,28,1,27,.964,3600000,0
35867,49537,873,0,0,0,0,.00nan,0,0
35867,52476,873,78,31,2,29,.935,3560000,0
35868,1719,945,62,12,1,11,.917,1629000,0
35868,2201,945,42,41,6,35,.854,1971000,0
35868,25679,886,57,21,2,19,.905,3600000,0
35868,45059,886,0,0,0,0,.00nan,0,0
35869,882,966,0,0,0,0,.00nan,0,0
35869,33507,966,68,30,3,27,.900,3600000,0
35869,49537,873,0,0,0,0,.00nan,0,0
35869,52476,873,26,26,6,20,.769,3600000,0
35870,19014,996,77,28,2,26,.929,3600000,0
35870,23726,1414,36,29,5,24,.828,3600000,0
35870,25483,1414,0,0,0,0,.00nan,0,0
35870,25690,996,0,0,0,0,.00nan,0,0
35871,5545,970,99,39,1,38,.974,3632000,0
35871,7034,889,65,23,2,21,.913,3632000,0
35871,40900,889,0,0,0,0,.00nan,0,0
35871,145759,970,0,0,0,0,.00nan,0,0
35872,9886,885,0,0,0,0,.00nan,0,0
35872,10481,885,79,25,1,24,.960,3600000,0
35872,15245,983,76,25,2,23,.920,3546000,0
35872,23733,983,0,0,0,0,.00nan,0,0
35873,6527,894,53,35,4,31,.886,3530000,0
35873,10809,890,76,33,2,31,.939,3600000,0
35873,19094,890,0,0,0,0,.00nan,0,0
35873,52559,894,0,0,0,0,.00nan,0,0
35874,1818,872,0,0,0,0,.00nan,0,0
35874,17419,880,49,24,3,21,.875,3900000,0
35874,18969,872,100,54,3,51,.944,3900000,0
35874,33501,880,0,0,0,0,.00nan,0,0
35875,1719,945,0,0,0,0,.00nan,0,0
35875,2201,945,69,27,2,25,.926,3600000,0
35875,9886,885,0,0,0,0,.00nan,0,0
35875,10481,885,59,31,3,28,.903,3552000,0
35876,882,966,0,0,0,0,.00nan,0,0
35876,1818,872,0,0,0,0,.00nan,0,0
35876,18969,872,79,31,2,29,.935,3600000,0
35876,33507,966,64,28,3,25,.893,3569000,0
35877,19014,996,65,40,5,35,.875,3900000,0
35877,25690,996,0,0,0,0,.00nan,0,0
35877,49537,873,45,26,5,21,.808,3900000,0
35877,52476,873,0,0,0,0,.00nan,0,0
35878,23726,1414,0,0,0,0,.00nan,0,0
35878,25483,1414,68,37,4,33,.892,3600000,0
35878,25679,886,67,14,1,13,.929,3600000,0
35878,45059,886,0,0,0,0,.00nan,0,0
35879,15245,983,56,37,5,32,.865,3600000,0
35879,17419,880,64,23,2,21,.913,3600000,0
35879,23733,983,0,0,0,0,.00nan,0,0
35879,33501,880,0,0,0,0,.00nan,0,0
35880,7034,889,64,39,4,35,.897,3597000,0
35880,10809,890,60,26,3,23,.885,3600000,0
35880,19094,890,0,0,0,0,.00nan,0,0
35880,40900,889,0,0,0,0,.00nan,0,0
35881,882,966,59,16,2,14,.875,3600000,0
35881,10809,890,0,0,0,0,.00nan,0,0
35881,19094,890,69,35,3,32,.914,3551000,0
35881,33507,966,0,0,0,0,.00nan,0,0
36179,6527,894,0,0,0,0,.00nan,0,0
36179,12486,873,0,0,0,0,.00nan,0,0
36179,52476,873,100,35,0,35,1000,3600000,0
36179,52559,894,64,28,3,25,.893,3600000,0
36181,882,966,0,0,0,0,.00nan,0,0
36181,7034,889,89,40,2,38,.950,3600000,0
36181,33507,966,65,37,3,34,.919,3545000,0
36181,40900,889,0,0,0,0,.00nan,0,0
36183,1719,945,0,0,0,0,.00nan,0,0
36183,2201,945,71,27,2,25,.926,3600000,0
36183,18969,872,51,2,0,2,1000,463000,0
36183,62307,872,31,26,5,21,.808,3137000,0
36185,17419,880,98,39,1,38,.974,3577000,0
36185,25679,886,90,17,0,17,1000,3600000,0
36185,33501,880,0,0,0,0,.00nan,0,0
36185,68497,886,0,0,0,0,.00nan,0,0
36187,5545,970,53,37,5,32,.865,3600000,0
36187,10809,890,66,24,2,22,.917,3600000,0
36187,19094,890,0,0,0,0,.00nan,0,0
36187,145759,970,0,0,0,0,.00nan,0,0
36189,10481,885,56,38,4,34,.895,3600000,0
36189,23726,1414,94,38,1,37,.974,3600000,0
36189,25483,1414,0,0,0,0,.00nan,0,0
36189,45036,885,0,0,0,0,.00nan,0,0
36191,15245,983,62,29,3,26,.897,3900000,0
36191,19014,996,0,0,0,0,.00nan,0,0
36191,23733,983,0,0,0,0,.00nan,0,0
36191,25690,996,80,37,3,34,.919,3900000,0
36193,1719,945,0,0,0,0,.00nan,0,0
36193,2201,945,80,29,3,26,.897,3900000,0
36193,6527,894,58,26,3,23,.885,3900000,0
36193,52559,894,0,0,0,0,.00nan,0,0
36195,12486,873,0,0,0,0,.00nan,0,0
36195,25679,886,41,26,5,21,.808,3553000,0
36195,52476,873,75,36,3,33,.917,3600000,0
36195,68497,886,0,0,0,0,.00nan,0,0
36197,5545,970,0,0,0,0,.00nan,0,0
36197,10809,890,0,0,0,0,.00nan,0,0
36197,19094,890,94,19,0,19,1000,3600000,0
36197,145759,970,75,28,1,27,.964,3548000,0
36199,882,966,74,23,1,22,.957,3600000,0
36199,10481,885,0,0,0,0,.00nan,0,0
36199,33507,966,0,0,0,0,.00nan,0,0
36199,45036,885,83,42,3,39,.929,3577000,0
36201,17419,880,0,0,0,0,.00nan,0,0
36201,19014,996,55,29,3,26,.897,3588000,0
36201,25690,996,0,0,0,0,.00nan,0,0
36201,33501,880,99,37,1,36,.973,3600000,0
36203,18969,872,76,23,1,22,.957,3600000,0
36203,23726,1414,0,0,0,0,.00nan,0,0
36203,25483,1414,69,41,5,36,.878,3600000,0
36203,62307,872,0,0,0,0,.00nan,0,0
36205,7034,889,0,0,0,0,.00nan,0,0
36205,15245,983,0,0,0,0,.00nan,0,0
36205,23733,983,77,34,3,31,.912,3577000,0
36205,40900,889,77,28,1,27,.964,3600000,0
36207,15245,983,36,29,5,24,.828,3563000,0
36207,23733,983,0,0,0,0,.00nan,0,0
36207,25679,886,77,35,3,32,.914,3600000,0
36207,68497,886,0,0,0,0,.00nan,0,0
36209,1719,945,0,0,0,0,.00nan,0,0
36209,2201,945,100,32,1,31,.969,3600000,0
36209,17419,880,76,40,4,36,.900,3600000,0
36209,33501,880,0,0,0,0,.00nan,0,0
36211,5545,970,90,33,1,32,.970,3600000,0
36211,7034,889,83,29,2,27,.931,3546000,0
36211,40900,889,0,0,0,0,.00nan,0,0
36211,145759,970,0,0,0,0,.00nan,0,0
36213,882,966,0,0,0,0,.00nan,0,0
36213,23726,1414,24,5,3,2,.400,508000,0
36213,25483,1414,70,27,2,25,.926,3035000,0
36213,33507,966,55,28,4,24,.857,3600000,0
36215,10809,890,0,0,0,0,.00nan,0,0
36215,19014,996,0,0,0,0,.00nan,0,0
36215,19094,890,59,25,3,22,.880,3600000,0
36215,25690,996,66,38,4,34,.895,3554000,0
36217,6527,894,0,0,0,0,.00nan,0,0
36217,10481,885,0,0,0,0,.00nan,0,0
36217,45036,885,43,40,7,33,.825,3600000,0
36217,52559,894,74,24,2,22,.917,3600000,0
36219,12486,873,0,0,0,0,.00nan,0,0
36219,18969,872,62,27,3,24,.889,3900000,0
36219,52476,873,69,36,3,33,.917,3900000,0
36219,62307,872,0,0,0,0,.00nan,0,0
36221,7034,889,58,35,4,31,.886,3592000,0
36221,10809,890,59,24,3,21,.875,3600000,0
36221,19094,890,0,0,0,0,.00nan,0,0
36221,40900,889,0,0,0,0,.00nan,0,0
36223,882,966,0,0,0,0,.00nan,0,0
36223,15245,983,0,0,0,0,.00nan,0,0
36223,23733,983,78,41,3,38,.927,3600000,0
36223,33507,966,65,36,4,32,.889,3537000,0
36225,23726,1414,14,26,7,19,.731,2750000,0
36225,25483,1414,24,14,4,10,.714,850000,0
36225,25679,886,55,10,1,9,.900,3600000,0
36225,68497,886,0,0,0,0,.00nan,0,0
36227,17419,880,42,25,4,21,.840,3600000,0
36227,18969,872,0,0,0,0,.00nan,0,0
36227,33501,880,0,0,0,0,.00nan,0,0
36227,62307,872,98,32,1,31,.969,3600000,0
36229,10481,885,100,37,0,37,1000,3600000,0
36229,12486,873,0,0,0,0,.00nan,0,0
36229,45036,885,0,0,0,0,.00nan,0,0
36229,52476,873,47,21,3,18,.857,3600000,0
36231,1719,945,0,0,0,0,.00nan,0,0
36231,2201,945,52,39,5,34,.872,3600000,0
36231,19014,996,0,0,0,0,.00nan,0,0
36231,25690,996,66,16,1,15,.938,3600000,0
36233,5545,970,50,28,4,24,.857,3600000,0
36233,6527,894,0,0,0,0,.00nan,0,0
36233,52559,894,75,28,2,26,.929,3600000,0
36233,145759,970,0,0,0,0,.00nan,0,0
36235,7034,889,0,0,0,0,.00nan,0,0
36235,15245,983,32,37,7,30,.811,3600000,0
36235,23733,983,0,0,0,0,.00nan,0,0
36235,40900,889,96,31,1,30,.968,3600000,0
36237,882,966,74,32,2,30,.938,3600000,0
36237,10481,885,0,0,0,0,.00nan,0,0
36237,33507,966,0,0,0,0,.00nan,0,0
36237,45036,885,63,29,4,25,.862,3514000,0
36239,17419,880,0,0,0,0,.00nan,0,0
36239,18969,872,54,41,7,34,.829,3600000,0
36239,33501,880,84,31,2,29,.935,3600000,0
36239,62307,872,0,0,0,0,.00nan,0,0
36241,5545,970,57,12,1,11,.917,2160000,0
36241,6527,894,87,28,2,26,.929,3600000,0
36241,52559,894,0,0,0,0,.00nan,0,0
36241,145759,970,44,24,4,20,.833,1440000,0
36243,1719,945,90,38,3,35,.921,3692000,0
36243,2201,945,0,0,0,0,.00nan,0,0
36243,25679,886,0,0,0,0,.00nan,0,0
36243,68497,886,57,19,2,17,.895,3692000,0
36245,10809,890,0,0,0,0,.00nan,0,0
36245,19014,996,44,27,4,23,.852,3578000,0
36245,19094,890,81,29,2,27,.931,3600000,0
36245,25690,996,0,0,0,0,.00nan,0,0
36247,12486,873,45,30,5,25,.833,3600000,0
36247,23726,1414,0,0,0,0,.00nan,0,0
36247,25483,1414,80,28,2,26,.929,3600000,0
36247,52476,873,0,0,0,0,.00nan,0,0
36249,882,966,0,0,0,0,.00nan,0,0
36249,6527,894,0,0,0,0,.00nan,0,0
36249,33507,966,58,41,5,36,.878,3528000,0
36249,52559,894,65,32,3,29,.906,3600000,0
36251,10481,885,47,37,5,32,.865,3600000,0
36251,10809,890,69,26,2,24,.923,3600000,0
36251,19094,890,0,0,0,0,.00nan,0,0
36251,45036,885,0,0,0,0,.00nan,0,0
36253,5545,970,20,30,7,23,.767,3600000,0
36253,25679,886,74,36,3,33,.917,3600000,0
36253,68497,886,0,0,0,0,.00nan,0,0
36253,145759,970,0,0,0,0,.00nan,0,0
36255,7034,889,77,26,1,25,.962,3600000,0
36255,18969,872,0,0,0,0,.00nan,0,0
36255,40900,889,0,0,0,0,.00nan,0,0
36255,62307,872,64,19,2,17,.895,3591000,0
36257,1719,945,0,0,0,0,.00nan,0,0
36257,2201,945,58,22,3,19,.864,3518000,0
36257,15245,983,0,0,0,0,.00nan,0,0
36257,23733,983,94,39,1,38,.974,3600000,0
36259,17419,880,92,34,2,32,.941,3600000,0
36259,19014,996,0,0,0,0,.00nan,0,0
36259,25690,996,60,30,4,26,.867,3568000,0
36259,33501,880,0,0,0,0,.00nan,0,0
36261,12486,873,0,0,0,0,.00nan,0,0
36261,23726,1414,76,29,2,27,.931,3600000,0
36261,25483,1414,0,0,0,0,.00nan,0,0
36261,52476,873,61,36,4,32,.889,3581000,0
36263,17419,880,0,0,0,0,.00nan,0,0
36263,33501,880,88,22,0,22,1000,3600000,0
36263,45036,885,56,31,3,28,.903,3600000,0
36263,45059,885,0,0,0,0,.00nan,0,0
36265,882,966,51,31,5,26,.839,3600000,0
36265,25679,886,0,0,0,0,.00nan,0,0
36265,33507,966,0,0,0,0,.00nan,0,0
36265,68497,886,100,28,0,28,1000,3600000,0
36267,1719,945,0,0,0,0,.00nan,0,0
36267,2201,945,65,26,3,23,.885,3549000,0
36267,23726,1414,0,0,0,0,.00nan,0,0
36267,25483,1414,78,34,2,32,.941,3600000,0
36269,12486,873,64,16,1,15,.938,3600000,0
36269,15245,983,57,32,4,28,.875,3600000,0
36269,23733,983,0,0,0,0,.00nan,0,0
36269,52476,873,0,0,0,0,.00nan,0,0
36271,10809,890,0,0,0,0,.00nan,0,0
36271,19014,996,56,35,4,31,.886,3589000,0
36271,19094,890,93,35,2,33,.943,3600000,0
36271,25690,996,0,0,0,0,.00nan,0,0
36273,5545,970,0,0,0,0,.00nan,0,0
36273,7034,889,0,0,0,0,.00nan,0,0
36273,40900,889,51,31,5,26,.839,3595000,0
36273,145759,970,57,25,3,22,.880,3600000,0
36275,6527,894,71,32,3,29,.906,3573000,0
36275,18969,872,94,33,1,32,.970,3600000,0
36275,52559,894,0,0,0,0,.00nan,0,0
36275,62307,872,0,0,0,0,.00nan,0,0
36276,4277,758,100,36,1,35,.972,3600000,0
36276,30194,758,0,0,0,0,.00nan,0,0
36276,48472,1093,31,29,6,23,.793,3600000,0
36276,62252,1093,0,0,0,0,.00nan,0,0
36277,5713,775,63,20,1,19,.950,3562000,0
36277,54801,772,100,39,0,39,1000,3600000,0
36277,58436,772,0,0,0,0,.00nan,0,0
36277,67531,775,0,0,0,0,.00nan,0,0
36278,26069,2197,100,46,2,44,.957,3600000,0
36278,47785,769,48,31,5,26,.839,3600000,0
36278,48005,2197,0,0,0,0,.00nan,0,0
36278,66264,769,0,0,0,0,.00nan,0,0
36279,870,755,0,0,0,0,.00nan,0,0
36279,6901,773,0,0,0,0,.00nan,0,0
36279,47669,755,75,42,4,38,.905,3900000,0
36279,60604,773,41,17,4,13,.765,3900000,0
36280,4277,758,0,0,0,0,.00nan,0,0
36280,21705,764,68,40,4,36,.900,3600000,0
36280,26220,764,0,0,0,0,.00nan,0,0
36280,30194,758,87,21,1,20,.952,3600000,0
36281,17346,4924,0,0,0,0,.00nan,0,0
36281,30764,4924,92,28,1,27,.964,3600000,0
36281,41794,760,48,22,3,19,.864,3543000,0
36281,60482,760,0,0,0,0,.00nan,0,0
36282,132,4923,80,20,1,19,.950,3600000,0
36282,47897,759,0,0,0,0,.00nan,0,0
36282,48564,759,70,35,3,32,.914,3577000,0
36282,62226,4923,0,0,0,0,.00nan,0,0
36283,277,2545,0,0,0,0,.00nan,0,0
36283,611,2545,54,20,2,18,.900,3512000,0
36283,54801,772,100,28,0,28,1000,3600000,0
36283,58436,772,0,0,0,0,.00nan,0,0
36284,125,774,49,15,3,12,.800,3631000,0
36284,5713,775,49,28,4,24,.857,3631000,0
36284,67531,775,0,0,0,0,.00nan,0,0
36284,134205,774,0,0,0,0,.00nan,0,0
36285,17526,2199,50,21,3,18,.857,3600000,0
36285,21637,762,29,35,6,29,.829,2825000,0
36285,48097,2199,0,0,0,0,.00nan,0,0
36285,62285,762,40,2,1,1,.500,775000,0
36286,870,755,0,0,0,0,.00nan,0,0
36286,26069,2197,0,0,0,0,.00nan,0,0
36286,47669,755,43,22,4,18,.818,3550000,0
36286,48005,2197,81,33,2,31,.939,3600000,0
36287,6901,773,84,31,1,30,.968,3900000,0
36287,47785,769,77,18,1,17,.944,3900000,0
36287,60604,773,0,0,0,0,.00nan,0,0
36287,66264,769,0,0,0,0,.00nan,0,0
36288,21705,764,52,22,3,19,.864,3600000,0
36288,26220,764,0,0,0,0,.00nan,0,0
36288,48472,1093,54,31,4,27,.871,3569000,0
36288,62252,1093,0,0,0,0,.00nan,0,0
36289,557,746,0,0,0,0,.00nan,0,0
36289,4277,758,69,37,3,34,.919,3600000,0
36289,30194,758,0,0,0,0,.00nan,0,0
36289,60993,746,91,37,2,35,.946,3600000,0
36290,3208,766,0,0,0,0,.00nan,0,0
36290,31487,766,75,41,3,38,.927,3600000,0
36290,41794,760,97,20,0,20,1000,3600000,0
36290,60482,760,0,0,0,0,.00nan,0,0
36291,17346,4924,0,0,0,0,.00nan,0,0
36291,30764,4924,69,22,2,20,.909,3600000,0
36291,48187,1503,40,28,5,23,.821,3600000,0
36291,48332,1503,0,0,0,0,.00nan,0,0
36292,7112,768,0,0,0,0,.00nan,0,0
36292,17046,768,68,31,3,28,.903,3900000,0
36292,54801,772,72,35,3,32,.914,3900000,0
36292,58436,772,0,0,0,0,.00nan,0,0
36293,125,774,82,42,2,40,.952,3900000,0
36293,277,2545,85,35,2,33,.943,3900000,0
36293,611,2545,0,0,0,0,.00nan,0,0
36293,134205,774,0,0,0,0,.00nan,0,0
36294,17526,2199,68,29,2,27,.931,3600000,0
36294,26039,3913,39,21,4,17,.810,3566000,0
36294,29022,3913,0,0,0,0,.00nan,0,0
36294,48097,2199,0,0,0,0,.00nan,0,0
36295,26020,3721,0,0,0,0,.00nan,0,0
36295,26069,2197,65,17,1,16,.941,3600000,0
36295,48005,2197,0,0,0,0,.00nan,0,0
36295,48234,3721,64,32,4,28,.875,3600000,0
36296,4297,767,0,0,0,0,.00nan,0,0
36296,6901,773,52,29,4,25,.862,3600000,0
36296,48499,767,78,22,1,21,.955,3600000,0
36296,60604,773,0,0,0,0,.00nan,0,0
36297,870,755,0,0,0,0,.00nan,0,0
36297,40870,750,82,20,0,20,1000,3600000,0
36297,47669,755,98,41,1,40,.976,3569000,0
36297,66017,750,0,0,0,0,.00nan,0,0
36298,16186,911,0,0,0,0,.00nan,0,0
36298,47785,769,77,26,2,24,.923,3600000,0
36298,65098,911,23,18,5,13,.722,3600000,0
36298,66264,769,0,0,0,0,.00nan,0,0
36299,5713,775,91,37,1,36,.973,3600000,0
36299,21637,762,65,36,3,33,.917,3567000,0
36299,62285,762,0,0,0,0,.00nan,0,0
36299,67531,775,0,0,0,0,.00nan,0,0
36300,557,746,0,0,0,0,.00nan,0,0
36300,48472,1093,61,15,1,14,.933,1065000,0
36300,60993,746,38,12,3,9,.750,3600000,0
36300,62252,1093,38,36,6,30,.833,2535000,0
36301,132,4923,0,0,0,0,.00nan,0,0
36301,21705,764,0,0,0,0,.00nan,0,0
36301,26220,764,76,41,3,38,.927,3518000,0
36301,62226,4923,64,16,1,15,.938,3600000,0
36302,3208,766,0,0,0,0,.00nan,0,0
36302,31487,766,100,39,2,37,.949,3900000,0
36302,48187,1503,0,0,0,0,.00nan,0,0
36302,48332,1503,61,26,2,24,.923,3900000,0
36303,125,774,55,14,2,12,.857,3529000,0
36303,7112,768,0,0,0,0,.00nan,0,0
36303,17046,768,100,31,0,31,1000,3600000,0
36303,134205,774,0,0,0,0,.00nan,0,0
36304,4297,767,0,0,0,0,.00nan,0,0
36304,26069,2197,0,0,0,0,.00nan,0,0
36304,48005,2197,87,27,1,26,.963,3600000,0
36304,48499,767,47,24,3,21,.875,3560000,0
36305,6901,773,0,0,0,0,.00nan,0,0
36305,26020,3721,74,23,1,22,.957,3600000,0
36305,48234,3721,0,0,0,0,.00nan,0,0
36305,60604,773,33,22,4,18,.818,3600000,0
36306,40870,750,81,21,1,20,.952,3600000,0
36306,47785,769,28,7,3,4,.571,383000,0
36306,66017,750,0,0,0,0,.00nan,0,0
36306,66264,769,97,50,3,47,.940,3217000,0
36307,870,755,76,37,3,34,.919,3600000,0
36307,16186,911,0,0,0,0,.00nan,0,0
36307,47669,755,0,0,0,0,.00nan,0,0
36307,65098,911,90,22,0,22,1000,3600000,0
36308,277,2545,78,28,1,27,.964,3600000,0
36308,611,2545,0,0,0,0,.00nan,0,0
36308,21637,762,0,0,0,0,.00nan,0,0
36308,62285,762,82,40,2,38,.950,3585000,0
36309,17526,2199,66,17,1,16,.941,3600000,0
36309,48097,2199,0,0,0,0,.00nan,0,0
36309,54801,772,81,45,3,42,.933,3526000,0
36309,58436,772,0,0,0,0,.00nan,0,0
36310,3208,766,0,0,0,0,.00nan,0,0
36310,17346,4924,0,0,0,0,.00nan,0,0
36310,30764,4924,93,42,2,40,.952,3600000,0
36310,31487,766,68,33,3,30,.909,3573000,0
36311,5713,775,68,29,3,26,.897,3600000,0
36311,26039,3913,0,0,0,0,.00nan,0,0
36311,29022,3913,64,22,1,21,.955,3600000,0
36311,67531,775,0,0,0,0,.00nan,0,0
36312,132,4923,85,40,3,37,.925,3900000,0
36312,557,746,0,0,0,0,.00nan,0,0
36312,60993,746,58,28,3,25,.893,3900000,0
36312,62226,4923,0,0,0,0,.00nan,0,0
36313,41794,760,71,35,3,32,.914,3561000,0
36313,48187,1503,0,0,0,0,.00nan,0,0
36313,48332,1503,62,22,2,20,.909,3600000,0
36313,60482,760,0,0,0,0,.00nan,0,0
36314,21705,764,83,25,1,24,.960,3600000,0
36314,26220,764,0,0,0,0,.00nan,0,0
36314,47897,759,0,0,0,0,.00nan,0,0
36314,48564,759,75,26,2,24,.923,3565000,0
36315,4297,767,0,0,0,0,.00nan,0,0
36315,40870,750,70,25,1,24,.960,3600000,0
36315,48499,767,64,39,4,35,.897,3600000,0
36315,66017,750,0,0,0,0,.00nan,0,0
36316,16186,911,0,0,0,0,.00nan,0,0
36316,26020,3721,0,0,0,0,.00nan,0,0
36316,48234,3721,91,23,0,23,1000,3600000,0
36316,65098,911,60,34,4,30,.882,3600000,0
36317,125,774,60,24,3,21,.875,3566000,0
36317,17526,2199,73,24,1,23,.958,3600000,0
36317,48097,2199,0,0,0,0,.00nan,0,0
36317,134205,774,0,0,0,0,.00nan,0,0
36318,7112,768,0,0,0,0,.00nan,0,0
36318,17046,768,72,19,1,18,.947,3600000,0
36318,21637,762,74,29,2,27,.931,3570000,0
36318,62285,762,0,0,0,0,.00nan,0,0
36319,277,2545,0,0,0,0,.00nan,0,0
36319,611,2545,65,33,3,30,.909,3900000,0
36319,26039,3913,47,21,3,18,.857,3900000,0
36319,29022,3913,0,0,0,0,.00nan,0,0
36320,557,746,78,23,1,22,.957,3600000,0
36320,47897,759,0,0,0,0,.00nan,0,0
36320,48564,759,77,33,3,30,.909,3581000,0
36320,60993,746,0,0,0,0,.00nan,0,0
36321,26020,3721,0,0,0,0,.00nan,0,0
36321,40870,750,43,30,5,25,.833,3590000,0
36321,48234,3721,87,32,3,29,.906,3600000,0
36321,66017,750,0,0,0,0,.00nan,0,0
36322,4297,767,39,1,1,0,.000,320000,0
36322,16186,911,85,41,2,39,.951,3600000,0
36322,48499,767,22,22,6,16,.727,3280000,0
36322,65098,911,0,0,0,0,.00nan,0,0
36323,7112,768,72,29,2,27,.931,3600000,0
36323,17046,768,0,0,0,0,.00nan,0,0
36323,26039,3913,58,32,4,28,.875,3600000,0
36323,29022,3913,0,0,0,0,.00nan,0,0
36324,4277,758,92,22,0,22,1000,3600000,0
36324,30194,758,0,0,0,0,.00nan,0,0
36324,47785,769,0,0,0,0,.00nan,0,0
36324,66264,769,70,33,3,30,.909,3600000,0
36325,870,755,0,0,0,0,.00nan,0,0
36325,47669,755,54,21,3,18,.857,3600000,0
36325,48472,1093,51,34,5,29,.853,3533000,0
36325,62252,1093,0,0,0,0,.00nan,0,0
36326,26069,2197,66,31,3,28,.903,3900000,0
36326,41794,760,60,24,3,21,.875,3900000,0
36326,48005,2197,0,0,0,0,.00nan,0,0
36326,60482,760,0,0,0,0,.00nan,0,0
36327,6901,773,0,0,0,0,.00nan,0,0
36327,48187,1503,99,39,1,38,.974,3600000,0
36327,48332,1503,0,0,0,0,.00nan,0,0
36327,60604,773,66,29,3,26,.897,3600000,0
36328,21705,764,71,20,2,18,.900,3600000,0
36328,26220,764,0,0,0,0,.00nan,0,0
36328,54801,772,55,22,3,19,.864,3600000,0
36328,58436,772,0,0,0,0,.00nan,0,0
36329,870,755,0,0,0,0,.00nan,0,0
36329,4277,758,81,33,2,31,.939,3600000,0
36329,30194,758,0,0,0,0,.00nan,0,0
36329,47669,755,41,17,3,14,.824,3581000,0
36330,47785,769,70,28,2,26,.929,3600000,0
36330,48472,1093,34,39,8,31,.795,3600000,0
36330,62252,1093,0,0,0,0,.00nan,0,0
36330,66264,769,0,0,0,0,.00nan,0,0
36331,277,2545,76,21,1,20,.952,3600000,0
36331,611,2545,0,0,0,0,.00nan,0,0
36331,21637,762,97,38,2,36,.947,3600000,0
36331,62285,762,0,0,0,0,.00nan,0,0
36332,6901,773,0,0,0,0,.00nan,0,0
36332,41794,760,69,21,1,20,.952,3600000,0
36332,60482,760,0,0,0,0,.00nan,0,0
36332,60604,773,47,23,3,20,.870,3518000,0
36333,26069,2197,91,49,3,46,.939,3600000,0
36333,48005,2197,0,0,0,0,.00nan,0,0
36333,48187,1503,0,0,0,0,.00nan,0,0
36333,48332,1503,56,33,4,29,.879,3600000,0
36334,5713,775,94,27,2,25,.926,3720000,0
36334,17526,2199,81,30,1,29,.967,3720000,0
36334,48097,2199,0,0,0,0,.00nan,0,0
36334,67531,775,0,0,0,0,.00nan,0,0
36335,4297,767,0,0,0,0,.00nan,0,0
36335,48472,1093,0,0,0,0,.00nan,0,0
36335,48499,767,64,20,2,18,.900,3575000,0
36335,62252,1093,100,31,0,31,1000,3600000,0
36336,4277,758,0,0,0,0,.00nan,0,0
36336,26020,3721,0,0,0,0,.00nan,0,0
36336,30194,758,63,22,2,20,.909,3540000,0
36336,48234,3721,100,32,0,32,1000,3600000,0
36337,132,4923,0,0,0,0,.00nan,0,0
36337,47785,769,95,31,1,30,.968,3900000,0
36337,62226,4923,94,31,1,30,.968,3900000,0
36337,66264,769,0,0,0,0,.00nan,0,0
36338,870,755,0,0,0,0,.00nan,0,0
36338,47669,755,78,23,1,22,.957,3600000,0
36338,47897,759,0,0,0,0,.00nan,0,0
36338,48564,759,55,35,4,31,.886,3600000,0
36339,557,746,0,0,0,0,.00nan,0,0
36339,54801,772,72,29,2,27,.931,3600000,0
36339,58436,772,0,0,0,0,.00nan,0,0
36339,60993,746,43,21,4,17,.810,3548000,0
36340,125,774,95,35,2,33,.943,3587000,0
36340,21705,764,100,31,0,31,1000,3600000,0
36340,26220,764,0,0,0,0,.00nan,0,0
36340,134205,774,0,0,0,0,.00nan,0,0
36341,7112,768,0,0,0,0,.00nan,0,0
36341,17046,768,58,26,3,23,.885,3545000,0
36341,17526,2199,82,31,2,29,.935,3600000,0
36341,48097,2199,0,0,0,0,.00nan,0,0
36342,16186,911,0,0,0,0,.00nan,0,0
36342,41794,760,80,36,2,34,.944,3600000,0
36342,60482,760,0,0,0,0,.00nan,0,0
36342,65098,911,72,34,3,31,.912,3542000,0
36343,6901,773,0,0,0,0,.00nan,0,0
36343,17346,4924,0,0,0,0,.00nan,0,0
36343,30764,4924,53,22,3,19,.864,3600000,0
36343,60604,773,100,35,0,35,1000,3600000,0
36344,3208,766,0,0,0,0,.00nan,0,0
36344,26069,2197,0,0,0,0,.00nan,0,0
36344,31487,766,81,21,1,20,.952,3600000,0
36344,48005,2197,78,38,3,35,.921,3549000,0
36345,40870,750,0,0,0,0,.00nan,0,0
36345,48187,1503,0,0,0,0,.00nan,0,0
36345,48332,1503,100,45,2,43,.956,3600000,0
36345,66017,750,45,20,3,17,.850,3600000,0
36346,4277,758,51,30,4,26,.867,3600000,0
36346,4297,767,0,0,0,0,.00nan,0,0
36346,30194,758,0,0,0,0,.00nan,0,0
36346,48499,767,100,28,0,28,1000,3600000,0
36347,26020,3721,0,0,0,0,.00nan,0,0
36347,48234,3721,79,29,2,27,.931,3590000,0
36347,48472,1093,0,0,0,0,.00nan,0,0
36347,62252,1093,89,27,1,26,.963,3600000,0
36348,47785,769,45,26,5,21,.808,3600000,0
36348,47897,759,0,0,0,0,.00nan,0,0
36348,48564,759,21,23,6,17,.739,3599000,0
36348,66264,769,0,0,0,0,.00nan,0,0
36349,132,4923,45,27,4,23,.852,3900000,0
36349,870,755,76,46,4,42,.913,3900000,0
36349,47669,755,0,0,0,0,.00nan,0,0
36349,62226,4923,0,0,0,0,.00nan,0,0
36350,125,774,64,33,4,29,.879,3600000,0
36350,557,746,0,0,0,0,.00nan,0,0
36350,60993,746,93,19,0,19,1000,3600000,0
36350,134205,774,0,0,0,0,.00nan,0,0
36351,21637,762,48,33,5,28,.848,3600000,0
36351,21705,764,72,26,2,24,.923,3600000,0
36351,26220,764,0,0,0,0,.00nan,0,0
36351,62285,762,0,0,0,0,.00nan,0,0
36352,277,2545,69,34,3,31,.912,3600000,0
36352,611,2545,0,0,0,0,.00nan,0,0
36352,17526,2199,81,16,0,16,1000,3600000,0
36352,48292,2199,0,0,0,0,.00nan,0,0
36353,5713,775,72,39,3,36,.923,3578000,0
36353,7112,768,0,0,0,0,.00nan,0,0
36353,17046,768,72,24,2,22,.917,3600000,0
36353,67531,775,0,0,0,0,.00nan,0,0
36354,40870,750,50,20,3,17,.850,3557000,0
36354,41794,760,99,38,2,36,.947,3600000,0
36354,60482,760,0,0,0,0,.00nan,0,0
36354,66017,750,0,0,0,0,.00nan,0,0
36355,17346,4924,0,0,0,0,.00nan,0,0
36355,26069,2197,76,31,2,29,.935,3600000,0
36355,30764,4924,58,22,3,19,.864,3542000,0
36355,48005,2197,0,0,0,0,.00nan,0,0
36356,3208,766,0,0,0,0,.00nan,0,0
36356,6901,773,0,0,0,0,.00nan,0,0
36356,31487,766,99,22,0,22,1000,3600000,0
36356,60604,773,63,28,2,26,.929,3536000,0
36357,16186,911,0,0,0,0,.00nan,0,0
36357,48187,1503,61,26,3,23,.885,3900000,0
36357,48332,1503,0,0,0,0,.00nan,0,0
36357,65098,911,93,50,3,47,.940,3900000,0
36358,4297,767,0,0,0,0,.00nan,0,0
36358,47897,759,0,0,0,0,.00nan,0,0
36358,48499,767,78,23,1,22,.957,3600000,0
36358,48564,759,77,33,2,31,.939,3600000,0
36359,132,4923,0,0,0,0,.00nan,0,0
36359,48234,3721,100,22,0,22,1000,3600000,0
36359,62226,4923,48,29,4,25,.862,3600000,0
36359,66495,3721,0,0,0,0,.00nan,0,0
36360,557,746,0,0,0,0,.00nan,0,0
36360,21637,762,91,19,0,19,1000,3600000,0
36360,60993,746,47,35,5,30,.857,3600000,0
36360,62285,762,0,0,0,0,.00nan,0,0
36361,21705,764,99,38,1,37,.974,3600000,0
36361,26039,3913,75,31,2,29,.935,3600000,0
36361,26220,764,0,0,0,0,.00nan,0,0
36361,29022,3913,0,0,0,0,.00nan,0,0
36362,16186,911,0,0,0,0,.00nan,0,0
36362,17346,4924,52,2,0,2,1000,317000,0
36362,30764,4924,51,44,7,37,.841,3283000,0
36362,65098,911,59,16,2,14,.875,3600000,0
36363,277,2545,58,30,3,27,.900,3600000,0
36363,611,2545,0,0,0,0,.00nan,0,0
36363,5713,775,57,32,4,28,.875,3584000,0
36363,67531,775,0,0,0,0,.00nan,0,0
36364,3208,766,0,0,0,0,.00nan,0,0
36364,31487,766,81,16,0,16,1000,3600000,0
36364,40870,750,0,0,0,0,.00nan,0,0
36364,66017,750,87,31,2,29,.935,3520000,0
36365,132,4923,81,45,4,41,.911,3900000,0
36365,4297,767,0,0,0,0,.00nan,0,0
36365,48499,767,54,29,4,25,.862,3900000,0
36365,62226,4923,0,0,0,0,.00nan,0,0
36366,47897,759,0,0,0,0,.00nan,0,0
36366,48234,3721,68,21,1,20,.952,3900000,0
36366,48564,759,79,30,1,29,.967,3900000,0
36366,66495,3721,0,0,0,0,.00nan,0,0
36367,557,746,0,0,0,0,.00nan,0,0
36367,26039,3913,66,26,2,24,.923,3579000,0
36367,29022,3913,0,0,0,0,.00nan,0,0
36367,60993,746,93,22,0,22,1000,3600000,0
36368,47785,769,76,22,2,20,.909,3600000,0
36368,54801,772,0,0,0,0,.00nan,0,0
36368,58436,772,84,41,3,38,.927,3583000,0
36368,66264,769,0,0,0,0,.00nan,0,0
36369,125,774,92,22,0,22,1000,3600000,0
36369,870,755,0,0,0,0,.00nan,0,0
36369,47669,755,88,48,3,45,.938,3600000,0
36369,134205,774,0,0,0,0,.00nan,0,0
36370,17346,4924,82,29,1,28,.966,3577000,0
36370,30764,4924,0,0,0,0,.00nan,0,0
36370,40870,750,81,14,0,14,1000,3600000,0
36370,66017,750,0,0,0,0,.00nan,0,0
36371,3208,766,0,0,0,0,.00nan,0,0
36371,16186,911,0,0,0,0,.00nan,0,0
36371,31487,766,69,38,4,34,.895,3574000,0
36371,65098,911,57,24,3,21,.875,3600000,0
36372,48187,1503,0,0,0,0,.00nan,0,0
36372,48332,1503,41,18,3,15,.833,3600000,0
36372,48472,1093,0,0,0,0,.00nan,0,0
36372,62252,1093,100,37,0,37,1000,3600000,0
36373,4277,758,65,25,3,22,.880,3600000,0
36373,30194,758,0,0,0,0,.00nan,0,0
36373,41794,760,96,22,0,22,1000,3600000,0
36373,60482,760,0,0,0,0,.00nan,0,0
36374,870,755,64,24,3,21,.875,3524000,0
36374,47669,755,0,0,0,0,.00nan,0,0
36374,54801,772,75,24,1,23,.958,3600000,0
36374,58436,772,0,0,0,0,.00nan,0,0
36375,125,774,67,17,1,16,.941,3600000,0
36375,47785,769,61,34,4,30,.882,3600000,0
36375,66264,769,0,0,0,0,.00nan,0,0
36375,134205,774,0,0,0,0,.00nan,0,0
36376,277,2545,0,0,0,0,.00nan,0,0
36376,611,2545,87,31,2,29,.935,3579000,0
36376,7112,768,0,0,0,0,.00nan,0,0
36376,17046,768,79,21,1,20,.952,3600000,0
36377,17526,2199,78,22,1,21,.955,3600000,0
36377,21705,764,58,39,5,34,.872,3600000,0
36377,26220,764,0,0,0,0,.00nan,0,0
36377,48292,2199,0,0,0,0,.00nan,0,0
36378,41794,760,90,27,2,25,.926,3900000,0
36378,48472,1093,0,0,0,0,.00nan,0,0
36378,60482,760,0,0,0,0,.00nan,0,0
36378,62252,1093,65,31,2,29,.935,3900000,0
36379,4277,758,93,24,0,24,1000,3600000,0
36379,30194,758,0,0,0,0,.00nan,0,0
36379,48187,1503,66,22,2,20,.909,2413000,0
36379,48332,1503,42,21,4,17,.810,1187000,0
36380,48234,3721,71,16,1,15,.938,3600000,0
36380,54801,772,60,36,4,32,.889,3600000,0
36380,58436,772,0,0,0,0,.00nan,0,0
36380,66495,3721,0,0,0,0,.00nan,0,0
36381,125,774,0,0,0,0,.00nan,0,0
36381,4297,767,0,0,0,0,.00nan,0,0
36381,48499,767,28,22,5,17,.773,3600000,0
36381,134205,774,95,36,1,35,.972,3600000,0
36382,16186,911,0,0,0,0,.00nan,0,0
36382,26069,2197,0,0,0,0,.00nan,0,0
36382,48005,2197,58,24,3,21,.875,3600000,0
36382,65098,911,46,26,4,22,.846,3600000,0
36383,557,746,0,0,0,0,.00nan,0,0
36383,17526,2199,38,24,5,19,.792,3600000,0
36383,48292,2199,0,0,0,0,.00nan,0,0
36383,60993,746,69,24,1,23,.958,3600000,0
36384,5713,775,62,31,4,27,.871,3546000,0
36384,21705,764,78,33,3,30,.909,3600000,0
36384,26220,764,0,0,0,0,.00nan,0,0
36384,67531,775,0,0,0,0,.00nan,0,0
36385,21637,762,89,33,1,32,.970,3600000,0
36385,47785,769,59,42,5,37,.881,3600000,0
36385,62285,762,0,0,0,0,.00nan,0,0
36385,66264,769,0,0,0,0,.00nan,0,0
36386,870,755,0,0,0,0,.00nan,0,0
36386,26039,3913,0,0,0,0,.00nan,0,0
36386,29022,3913,53,16,2,14,.875,3600000,0
36386,47669,755,69,43,3,40,.930,3576000,0
36387,3208,766,0,0,0,0,.00nan,0,0
36387,31487,766,77,40,3,37,.925,3600000,0
36387,48472,1093,0,0,0,0,.00nan,0,0
36387,62252,1093,42,26,4,22,.846,3584000,0
36388,4277,758,61,19,2,17,.895,3900000,0
36388,17346,4924,0,0,0,0,.00nan,0,0
36388,30194,758,0,0,0,0,.00nan,0,0
36388,30764,4924,70,35,2,33,.943,3900000,0
36389,132,4923,97,18,0,18,1000,3600000,0
36389,41794,760,68,39,4,35,.897,3600000,0
36389,60482,760,0,0,0,0,.00nan,0,0
36389,62226,4923,0,0,0,0,.00nan,0,0
36390,47897,759,66,39,5,34,.872,3627000,0
36390,48187,1503,0,0,0,0,.00nan,0,0
36390,48332,1503,37,22,4,18,.818,3627000,0
36390,48564,759,0,0,0,0,.00nan,0,0
36391,4297,767,0,0,0,0,.00nan,0,0
36391,48499,767,39,25,5,20,.800,3600000,0
36391,54801,772,100,28,0,28,1000,3600000,0
36391,58436,772,0,0,0,0,.00nan,0,0
36392,125,774,100,38,0,38,1000,3600000,0
36392,48234,3721,85,38,3,35,.921,3600000,0
36392,66495,3721,0,0,0,0,.00nan,0,0
36392,134205,774,0,0,0,0,.00nan,0,0
36393,557,746,0,0,0,0,.00nan,0,0
36393,5713,775,95,30,1,29,.967,3600000,0
36393,60993,746,54,38,5,33,.868,3600000,0
36393,67531,775,0,0,0,0,.00nan,0,0
36394,26069,2197,100,34,0,34,1000,3600000,0
36394,40870,750,73,22,1,21,.955,3543000,0
36394,48005,2197,0,0,0,0,.00nan,0,0
36394,66017,750,0,0,0,0,.00nan,0,0
36395,277,2545,80,24,1,23,.958,3600000,0
36395,611,2545,0,0,0,0,.00nan,0,0
36395,21705,764,35,20,4,16,.800,3600000,0
36395,26220,764,0,0,0,0,.00nan,0,0
36396,6901,773,73,30,2,28,.933,3600000,0
36396,16186,911,76,37,3,34,.919,3570000,0
36396,60604,773,0,0,0,0,.00nan,0,0
36396,65098,911,0,0,0,0,.00nan,0,0
36397,870,755,72,31,2,29,.935,3589000,0
36397,21637,762,68,18,1,17,.944,3600000,0
36397,47669,755,0,0,0,0,.00nan,0,0
36397,62285,762,0,0,0,0,.00nan,0,0
36398,26039,3913,97,20,0,20,1000,3600000,0
36398,29022,3913,0,0,0,0,.00nan,0,0
36398,47785,769,47,22,3,19,.864,3600000,0
36398,66264,769,0,0,0,0,.00nan,0,0
36399,17346,4924,0,0,0,0,.00nan,0,0
36399,30764,4924,84,44,3,41,.932,3600000,0
36399,48472,1093,100,29,0,29,1000,3600000,0
36399,62252,1093,0,0,0,0,.00nan,0,0
36400,3208,766,0,0,0,0,.00nan,0,0
36400,4277,758,60,24,3,21,.875,3600000,0
36400,30194,758,0,0,0,0,.00nan,0,0
36400,31487,766,100,37,0,37,1000,3600000,0
36401,132,4923,60,29,3,26,.897,3900000,0
36401,48187,1503,0,0,0,0,.00nan,0,0
36401,48332,1503,71,32,3,29,.906,3900000,0
36401,62226,4923,0,0,0,0,.00nan,0,0
36402,41794,760,75,31,2,29,.935,3600000,0
36402,47897,759,0,0,0,0,.00nan,0,0
36402,48564,759,92,32,1,31,.969,3600000,0
36402,60482,760,0,0,0,0,.00nan,0,0
36403,6901,773,85,44,3,41,.932,3593000,0
36403,40870,750,64,19,2,17,.895,3600000,0
36403,60604,773,0,0,0,0,.00nan,0,0
36403,66017,750,0,0,0,0,.00nan,0,0
36404,277,2545,44,32,5,27,.844,3528000,0
36404,557,746,57,24,3,21,.875,3600000,0
36404,611,2545,0,0,0,0,.00nan,0,0
36404,60993,746,0,0,0,0,.00nan,0,0
36405,7112,768,0,0,0,0,.00nan,0,0
36405,17046,768,69,25,1,24,.960,3600000,0
36405,21705,764,26,6,3,3,.500,436000,0
36405,26220,764,66,29,3,26,.897,3164000,0
36406,4297,767,0,0,0,0,.00nan,0,0
36406,26039,3913,64,27,3,24,.889,3566000,0
36406,29022,3913,0,0,0,0,.00nan,0,0
36406,48499,767,71,24,2,22,.917,3600000,0
36407,21637,762,87,17,0,17,1000,3600000,0
36407,48234,3721,97,47,2,45,.957,3600000,0
36407,62285,762,0,0,0,0,.00nan,0,0
36407,66495,3721,0,0,0,0,.00nan,0,0
36408,132,4923,0,0,0,0,.00nan,0,0
36408,17346,4924,0,0,0,0,.00nan,0,0
36408,30764,4924,84,30,1,29,.967,3600000,0
36408,62226,4923,75,36,3,33,.917,3571000,0
36409,3208,766,0,0,0,0,.00nan,0,0
36409,31487,766,65,25,2,23,.920,3600000,0
36409,47897,759,0,0,0,0,.00nan,0,0
36409,48564,759,28,37,7,30,.811,3600000,0
36410,7073,911,0,0,0,0,.00nan,0,0
36410,40870,750,83,28,2,26,.929,3600000,0
36410,65098,911,44,37,6,31,.838,3600000,0
36410,66017,750,0,0,0,0,.00nan,0,0
36411,557,746,0,0,0,0,.00nan,0,0
36411,7112,768,0,0,0,0,.00nan,0,0
36411,17046,768,70,29,3,26,.897,3900000,0
36411,60993,746,66,35,3,32,.914,3900000,0
36412,4297,767,0,0,0,0,.00nan,0,0
36412,21637,762,64,29,3,26,.897,3600000,0
36412,48499,767,48,29,4,25,.862,3600000,0
36412,62285,762,0,0,0,0,.00nan,0,0
36413,26039,3913,0,0,0,0,.00nan,0,0
36413,29022,3913,100,35,1,34,.971,3900000,0
36413,48234,3721,82,23,1,22,.957,3900000,0
36413,66495,3721,0,0,0,0,.00nan,0,0
36414,132,4923,51,28,4,24,.857,3557000,0
36414,3208,766,0,0,0,0,.00nan,0,0
36414,31487,766,71,26,2,24,.923,3600000,0
36414,62226,4923,0,0,0,0,.00nan,0,0
36415,17346,4924,0,0,0,0,.00nan,0,0
36415,30764,4924,65,33,3,30,.909,3584000,0
36415,47897,759,0,0,0,0,.00nan,0,0
36415,48564,759,78,31,2,29,.935,3600000,0
36416,870,755,0,0,0,0,.00nan,0,0
36416,17526,2199,67,27,2,25,.926,3600000,0
36416,47669,755,55,41,5,36,.878,3573000,0
36416,48292,2199,0,0,0,0,.00nan,0,0
36417,5713,775,67,35,3,32,.914,3600000,0
36417,47785,769,88,34,2,32,.941,3600000,0
36417,66264,769,0,0,0,0,.00nan,0,0
36417,67531,775,0,0,0,0,.00nan,0,0
36418,41794,760,67,31,3,28,.903,3565000,0
36418,54801,772,61,21,2,19,.905,3600000,0
36418,58436,772,0,0,0,0,.00nan,0,0
36418,60482,760,0,0,0,0,.00nan,0,0
36419,125,774,28,29,6,23,.793,3575000,0
36419,48187,1503,54,29,4,25,.862,3600000,0
36419,48332,1503,0,0,0,0,.00nan,0,0
36419,134205,774,0,0,0,0,.00nan,0,0
36420,4277,758,60,26,4,22,.846,3640000,0
36420,26069,2197,46,19,3,16,.842,3640000,0
36420,30194,758,0,0,0,0,.00nan,0,0
36420,48005,2197,0,0,0,0,.00nan,0,0
36421,6901,773,0,0,0,0,.00nan,0,0
36421,48472,1093,73,31,3,28,.903,3900000,0
36421,60604,773,51,21,3,18,.857,3900000,0
36421,62252,1093,0,0,0,0,.00nan,0,0
36422,17526,2199,54,25,3,22,.880,3869000,0
36422,47785,769,54,28,4,24,.857,3869000,0
36422,48292,2199,0,0,0,0,.00nan,0,0
36422,66264,769,0,0,0,0,.00nan,0,0
36423,870,755,0,0,0,0,.00nan,0,0
36423,5713,775,72,23,2,21,.913,3900000,0
36423,47669,755,71,34,2,32,.941,3900000,0
36423,67531,775,0,0,0,0,.00nan,0,0
36424,125,774,72,44,4,40,.909,3552000,0
36424,41794,760,49,22,3,19,.864,3600000,0
36424,60482,760,0,0,0,0,.00nan,0,0
36424,134205,774,0,0,0,0,.00nan,0,0
36425,48187,1503,0,0,0,0,.00nan,0,0
36425,48332,1503,57,27,3,24,.889,3580000,0
36425,54801,772,81,27,1,26,.963,3600000,0
36425,58436,772,0,0,0,0,.00nan,0,0
36426,4277,758,67,36,4,32,.889,3600000,0
36426,6901,773,66,24,2,22,.917,3600000,0
36426,30194,758,0,0,0,0,.00nan,0,0
36426,60604,773,0,0,0,0,.00nan,0,0
36427,26069,2197,0,0,0,0,.00nan,0,0
36427,48005,2197,62,35,4,31,.886,3600000,0
36427,48472,1093,0,0,0,0,.00nan,0,0
36427,62252,1093,79,24,1,23,.958,3600000,0
36428,4297,767,76,20,1,19,.950,3600000,0
36428,17526,2199,63,24,2,22,.917,3546000,0
36428,48292,2199,0,0,0,0,.00nan,0,0
36428,48499,767,0,0,0,0,.00nan,0,0
36429,5713,775,61,35,3,32,.914,3600000,0
36429,48234,3721,35,27,4,23,.852,3558000,0
36429,66495,3721,0,0,0,0,.00nan,0,0
36429,67531,775,0,0,0,0,.00nan,0,0
36430,277,2545,85,26,1,25,.962,3600000,0
36430,611,2545,0,0,0,0,.00nan,0,0
36430,47785,769,66,27,2,25,.926,3544000,0
36430,66264,769,0,0,0,0,.00nan,0,0
36431,870,755,47,39,5,34,.872,3515000,0
36431,7112,768,0,0,0,0,.00nan,0,0
36431,17046,768,83,36,3,33,.917,3600000,0
36431,47669,755,0,0,0,0,.00nan,0,0
36432,21637,762,71,37,4,33,.892,3711000,0
36432,41794,760,80,27,3,24,.889,3711000,0
36432,60482,760,0,0,0,0,.00nan,0,0
36432,62285,762,0,0,0,0,.00nan,0,0
36433,125,774,58,32,4,28,.875,3655000,0
36433,17346,4924,0,0,0,0,.00nan,0,0
36433,30764,4924,59,26,3,23,.885,3655000,0
36433,134205,774,0,0,0,0,.00nan,0,0
36434,3208,766,0,0,0,0,.00nan,0,0
36434,31487,766,83,32,2,30,.938,3600000,0
36434,54801,772,56,29,4,25,.862,3565000,0
36434,58436,772,0,0,0,0,.00nan,0,0
36435,26039,3913,0,0,0,0,.00nan,0,0
36435,29022,3913,75,22,2,20,.909,3600000,0
36435,48187,1503,57,37,4,33,.892,3515000,0
36435,48332,1503,0,0,0,0,.00nan,0,0
36436,132,4923,41,23,4,19,.826,3550000,0
36436,26069,2197,0,0,0,0,.00nan,0,0
36436,48005,2197,99,46,3,43,.935,3600000,0
36436,62226,4923,0,0,0,0,.00nan,0,0
36437,6901,773,0,0,0,0,.00nan,0,0
36437,47897,759,0,0,0,0,.00nan,0,0
36437,48564,759,44,25,4,21,.840,3600000,0
36437,60604,773,40,27,6,21,.778,3522000,0
36438,40870,750,48,16,2,14,.875,3600000,0
36438,48472,1093,61,36,4,32,.889,3524000,0
36438,62252,1093,0,0,0,0,.00nan,0,0
36438,66017,750,0,0,0,0,.00nan,0,0
36439,4277,758,53,32,4,28,.875,3600000,0
36439,7073,911,29,8,3,5,.625,511000,0
36439,30194,758,0,0,0,0,.00nan,0,0
36439,65098,911,50,39,6,33,.846,3089000,0
36440,557,746,43,38,6,32,.842,3754000,0
36440,21705,764,47,35,5,30,.857,3754000,0
36440,26220,764,0,0,0,0,.00nan,0,0
36440,60993,746,0,0,0,0,.00nan,0,0
36441,4297,767,0,0,0,0,.00nan,0,0
36441,5713,775,79,39,3,36,.923,3560000,0
36441,48499,767,66,24,2,22,.917,3600000,0
36441,67531,775,0,0,0,0,.00nan,0,0
36442,17526,2199,68,38,4,34,.895,3600000,0
36442,48234,3721,0,0,0,0,.00nan,0,0
36442,48292,2199,0,0,0,0,.00nan,0,0
36442,66495,3721,75,29,1,28,.966,3600000,0
36443,7112,768,0,0,0,0,.00nan,0,0
36443,17046,768,55,25,3,22,.880,3600000,0
36443,47785,769,100,28,0,28,1000,3600000,0
36443,66264,769,0,0,0,0,.00nan,0,0
36444,277,2545,88,28,1,27,.964,3600000,0
36444,611,2545,0,0,0,0,.00nan,0,0
36444,870,755,0,0,0,0,.00nan,0,0
36444,47669,755,100,55,0,55,1000,3600000,0
36445,26039,3913,0,0,0,0,.00nan,0,0
36445,29022,3913,88,16,0,16,1000,3600000,0
36445,41794,760,57,28,3,25,.893,3600000,0
36445,60482,760,0,0,0,0,.00nan,0,0
36446,17346,4924,0,0,0,0,.00nan,0,0
36446,30764,4924,72,24,1,23,.958,3600000,0
36446,54801,772,60,22,2,20,.909,3591000,0
36446,58436,772,0,0,0,0,.00nan,0,0
36447,125,774,70,30,3,27,.900,3600000,0
36447,3208,766,0,0,0,0,.00nan,0,0
36447,31487,766,41,30,5,25,.833,3543000,0
36447,134205,774,0,0,0,0,.00nan,0,0
36448,21637,762,65,31,3,28,.903,3516000,0
36448,48187,1503,0,0,0,0,.00nan,0,0
36448,48332,1503,57,13,1,12,.923,3600000,0
36448,62285,762,0,0,0,0,.00nan,0,0
36449,26069,2197,0,0,0,0,.00nan,0,0
36449,47897,759,0,0,0,0,.00nan,0,0
36449,48005,2197,51,28,4,24,.857,3560000,0
36449,48564,759,78,36,3,33,.917,3600000,0
36450,132,4923,0,0,0,0,.00nan,0,0
36450,6901,773,66,28,3,25,.893,3594000,0
36450,60604,773,0,0,0,0,.00nan,0,0
36450,62226,4923,89,34,2,32,.941,3600000,0
36451,4277,758,57,22,2,20,.909,3583000,0
36451,30194,758,0,0,0,0,.00nan,0,0
36451,40870,750,97,32,1,31,.969,3600000,0
36451,66017,750,0,0,0,0,.00nan,0,0
36452,7073,911,0,0,0,0,.00nan,0,0
36452,48472,1093,0,0,0,0,.00nan,0,0
36452,62252,1093,78,22,1,21,.955,3600000,0
36452,65098,911,57,34,4,30,.882,3600000,0
36453,4297,767,0,0,0,0,.00nan,0,0
36453,7112,768,0,0,0,0,.00nan,0,0
36453,17046,768,67,24,1,23,.958,3600000,0
36453,48499,767,98,46,2,44,.957,3553000,0
36454,5041,4924,0,0,0,0,.00nan,0,0
36454,26039,3913,0,0,0,0,.00nan,0,0
36454,29022,3913,60,20,2,18,.900,3600000,0
36454,30764,4924,39,29,4,25,.862,3597000,0
36455,277,2545,75,31,1,30,.968,3900000,0
36455,611,2545,0,0,0,0,.00nan,0,0
36455,48234,3721,87,26,1,25,.962,3900000,0
36455,66495,3721,0,0,0,0,.00nan,0,0
36456,3208,766,75,28,1,27,.964,2512000,0
36456,21637,762,95,36,2,34,.944,3600000,0
36456,31487,766,24,12,4,8,.667,1088000,0
36456,62285,762,0,0,0,0,.00nan,0,0
36457,40870,750,68,17,1,16,.941,3600000,0
36457,47897,759,0,0,0,0,.00nan,0,0
36457,48564,759,83,55,4,51,.927,3600000,0
36457,66017,750,0,0,0,0,.00nan,0,0
36458,132,4923,58,29,3,26,.897,3552000,0
36458,7073,911,81,31,2,29,.935,3600000,0
36458,62226,4923,0,0,0,0,.00nan,0,0
36458,65098,911,0,0,0,0,.00nan,0,0
36459,277,2545,77,32,3,29,.906,3900000,0
36459,611,2545,0,0,0,0,.00nan,0,0
36459,4297,767,0,0,0,0,.00nan,0,0
36459,48499,767,67,26,3,23,.885,3900000,0
36460,7112,768,100,23,0,23,1000,3600000,0
36460,17046,768,0,0,0,0,.00nan,0,0
36460,48234,3721,88,51,3,48,.941,3600000,0
36460,66495,3721,0,0,0,0,.00nan,0,0
36461,5041,4924,0,0,0,0,.00nan,0,0
36461,21637,762,75,28,2,26,.929,3600000,0
36461,30764,4924,48,20,3,17,.850,3593000,0
36461,62285,762,0,0,0,0,.00nan,0,0
36462,3208,766,0,0,0,0,.00nan,0,0
36462,26039,3913,38,9,2,7,.778,2553000,0
36462,29022,3913,19,8,4,4,.500,990000,0
36462,31487,766,59,39,5,34,.872,3600000,0
36463,26069,2197,0,0,0,0,.00nan,0,0
36463,48005,2197,80,33,2,31,.939,3900000,0
36463,54801,772,99,34,2,32,.941,3900000,0
36463,58436,772,0,0,0,0,.00nan,0,0
36464,125,774,76,49,4,45,.918,3600000,0
36464,6901,773,0,0,0,0,.00nan,0,0
36464,60604,773,97,22,0,22,1000,3600000,0
36464,134205,774,0,0,0,0,.00nan,0,0
36465,132,4923,0,0,0,0,.00nan,0,0
36465,40870,750,46,41,6,35,.854,3600000,0
36465,62226,4923,66,15,1,14,.933,3600000,0
36465,66017,750,0,0,0,0,.00nan,0,0
36466,7073,911,0,0,0,0,.00nan,0,0
36466,47897,759,0,0,0,0,.00nan,0,0
36466,48564,759,64,31,3,28,.903,3600000,0
36466,65098,911,66,23,2,21,.913,3600000,0
36467,17526,2199,46,29,4,25,.862,3600000,0
36467,48187,1503,0,0,0,0,.00nan,0,0
36467,48292,2199,0,0,0,0,.00nan,0,0
36467,48332,1503,95,32,1,31,.969,3600000,0
36468,5713,775,53,23,3,20,.870,3516000,0
36468,41794,760,76,25,1,24,.960,3600000,0
36468,60482,760,0,0,0,0,.00nan,0,0
36468,67531,775,0,0,0,0,.00nan,0,0
36469,557,746,0,0,0,0,.00nan,0,0
36469,870,755,0,0,0,0,.00nan,0,0
36469,47669,755,55,37,4,33,.892,3600000,0
36469,60993,746,77,21,1,20,.952,3600000,0
36470,21705,764,69,19,1,18,.947,3600000,0
36470,26220,764,0,0,0,0,.00nan,0,0
36470,47785,769,53,28,3,25,.893,3527000,0
36470,66264,769,0,0,0,0,.00nan,0,0
36471,6901,773,0,0,0,0,.00nan,0,0
36471,54801,772,55,34,4,30,.882,3600000,0
36471,58436,772,0,0,0,0,.00nan,0,0
36471,60604,773,70,24,1,23,.958,3600000,0
36472,125,774,89,22,0,22,1000,3600000,0
36472,26069,2197,0,0,0,0,.00nan,0,0
36472,48005,2197,76,26,2,24,.923,3575000,0
36472,134205,774,0,0,0,0,.00nan,0,0
36473,17526,2199,0,0,0,0,.00nan,0,0
36473,41794,760,67,33,4,29,.879,3900000,0
36473,48292,2199,48,23,4,19,.826,3900000,0
36473,60482,760,0,0,0,0,.00nan,0,0
36474,5713,775,0,0,0,0,.00nan,0,0
36474,48187,1503,0,0,0,0,.00nan,0,0
36474,48332,1503,71,37,3,34,.919,3600000,0
36474,67531,775,64,22,2,20,.909,3600000,0
36475,870,755,58,29,3,26,.897,3523000,0
36475,21705,764,83,32,2,30,.938,3600000,0
36475,26220,764,0,0,0,0,.00nan,0,0
36475,47669,755,0,0,0,0,.00nan,0,0
36476,557,746,0,0,0,0,.00nan,0,0
36476,47785,769,67,27,2,25,.926,3626000,0
36476,60993,746,72,35,3,32,.914,3626000,0
36476,66264,769,0,0,0,0,.00nan,0,0
36477,7073,911,0,0,0,0,.00nan,0,0
36477,54801,772,87,48,2,46,.958,3661000,0
36477,58436,772,0,0,0,0,.00nan,0,0
36477,65098,911,71,21,1,20,.952,3661000,0
36478,125,774,77,31,2,29,.935,3569000,0
36478,40870,750,96,18,0,18,1000,3600000,0
36478,66017,750,0,0,0,0,.00nan,0,0
36478,134205,774,0,0,0,0,.00nan,0,0
36479,277,2545,51,33,4,29,.879,3600000,0
36479,611,2545,0,0,0,0,.00nan,0,0
36479,48187,1503,0,0,0,0,.00nan,0,0
36479,48332,1503,80,23,1,22,.957,3600000,0
36480,3208,766,0,0,0,0,.00nan,0,0
36480,17526,2199,34,18,4,14,.778,3528000,0
36480,31487,766,94,36,2,34,.944,3600000,0
36480,48292,2199,0,0,0,0,.00nan,0,0
36481,7112,768,71,41,3,38,.927,3900000,0
36481,17046,768,0,0,0,0,.00nan,0,0
36481,41794,760,60,28,3,25,.893,3900000,0
36481,60482,760,0,0,0,0,.00nan,0,0
36482,5713,775,66,25,2,23,.920,3600000,0
36482,17346,4924,0,0,0,0,.00nan,0,0
36482,30764,4924,99,42,1,41,.976,3600000,0
36482,67531,775,0,0,0,0,.00nan,0,0
36483,21637,762,56,25,4,21,.840,3710000,0
36483,26069,2197,0,0,0,0,.00nan,0,0
36483,48005,2197,73,32,3,29,.906,3710000,0
36483,62285,762,0,0,0,0,.00nan,0,0
36484,6901,773,85,29,1,28,.966,3600000,0
36484,26039,3913,0,0,0,0,.00nan,0,0
36484,29022,3913,72,29,2,27,.931,3600000,0
36484,60604,773,0,0,0,0,.00nan,0,0
36485,47897,759,0,0,0,0,.00nan,0,0
36485,48472,1093,0,0,0,0,.00nan,0,0
36485,48564,759,49,17,3,14,.824,3533000,0
36485,62252,1093,75,23,1,22,.957,3600000,0
36486,132,4923,0,0,0,0,.00nan,0,0
36486,4277,758,44,34,5,29,.853,3548000,0
36486,30194,758,0,0,0,0,.00nan,0,0
36486,62226,4923,46,21,3,18,.857,3600000,0
36487,557,746,79,36,2,34,.944,3600000,0
36487,4297,767,0,0,0,0,.00nan,0,0
36487,48499,767,53,33,4,29,.879,3560000,0
36487,60993,746,0,0,0,0,.00nan,0,0
36488,21705,764,0,0,0,0,.00nan,0,0
36488,26220,764,95,35,1,34,.971,3555000,0
36488,48234,3721,100,36,0,36,1000,3600000,0
36488,66495,3721,0,0,0,0,.00nan,0,0
36927,47785,769,57,17,2,15,.882,3682000,0
36927,47897,759,0,0,0,0,.00nan,0,0
36927,48564,759,76,38,3,35,.921,3682000,0
36927,66264,769,0,0,0,0,.00nan,0,0
36929,277,2545,82,29,2,27,.931,3600000,0
36929,611,2545,0,0,0,0,.00nan,0,0
36929,5713,775,75,41,3,38,.927,3588000,0
36929,67531,775,0,0,0,0,.00nan,0,0
36931,48187,1503,79,10,0,10,1000,3600000,0
36931,48332,1503,0,0,0,0,.00nan,0,0
36931,54801,772,61,21,2,19,.905,3600000,0
36931,58436,772,0,0,0,0,.00nan,0,0
36933,125,774,62,22,2,20,.909,3600000,0
36933,6901,773,75,33,3,30,.909,3544000,0
36933,60604,773,0,0,0,0,.00nan,0,0
36933,134205,774,0,0,0,0,.00nan,0,0
36935,4297,767,0,0,0,0,.00nan,0,0
36935,17346,4924,0,0,0,0,.00nan,0,0
36935,30764,4924,71,42,4,38,.905,3600000,0
36935,48499,767,72,27,2,25,.926,3600000,0
36937,26069,2197,0,0,0,0,.00nan,0,0
36937,41794,760,37,32,6,26,.813,3600000,0
36937,48005,2197,72,21,1,20,.952,3600000,0
36937,60482,760,0,0,0,0,.00nan,0,0
36939,7112,768,0,0,0,0,.00nan,0,0
36939,16186,911,24,28,6,22,.786,3600000,0
36939,17046,768,72,37,3,34,.919,3600000,0
36939,65098,911,0,0,0,0,.00nan,0,0
36941,17526,2199,66,31,3,28,.903,3900000,0
36941,48097,2199,0,0,0,0,.00nan,0,0
36941,61989,4923,70,33,3,30,.909,3900000,0
36941,62226,4923,0,0,0,0,.00nan,0,0
36943,557,746,0,0,0,0,.00nan,0,0
36943,21705,764,59,35,5,30,.857,3600000,0
36943,26220,764,0,0,0,0,.00nan,0,0
36943,60993,746,47,26,4,22,.846,3600000,0
36945,26020,3721,0,0,0,0,.00nan,0,0
36945,48234,3721,51,23,3,20,.870,3600000,0
36945,48472,1093,36,33,6,27,.818,3578000,0
36945,62252,1093,0,0,0,0,.00nan,0,0
36947,3208,766,0,0,0,0,.00nan,0,0
36947,26039,3913,60,28,3,25,.893,3600000,0
36947,29022,3913,0,0,0,0,.00nan,0,0
36947,31487,766,86,28,1,27,.964,3600000,0
36949,4277,758,81,30,1,29,.967,3600000,0
36949,21637,762,72,27,2,25,.926,3599000,0
36949,30194,758,0,0,0,0,.00nan,0,0
36949,62285,762,0,0,0,0,.00nan,0,0
36951,870,755,0,0,0,0,.00nan,0,0
36951,40870,750,62,18,1,17,.944,3565000,0
36951,47669,755,100,34,0,34,1000,3600000,0
36951,66017,750,0,0,0,0,.00nan,0,0
36953,16186,911,0,0,0,0,.00nan,0,0
36953,17346,4924,80,23,1,22,.957,3900000,0
36953,30764,4924,0,0,0,0,.00nan,0,0
36953,65098,911,100,35,1,34,.971,3900000,0
36955,557,746,47,21,3,18,.857,3600000,0
36955,26039,3913,0,0,0,0,.00nan,0,0
36955,29022,3913,38,26,4,22,.846,3600000,0
36955,60993,746,0,0,0,0,.00nan,0,0
36957,870,755,0,0,0,0,.00nan,0,0
36957,47669,755,56,28,3,25,.893,3600000,0
36957,48472,1093,0,0,0,0,.00nan,0,0
36957,62252,1093,88,35,2,33,.943,3600000,0
36959,5713,775,0,0,0,0,.00nan,0,0
36959,47785,769,0,0,0,0,.00nan,0,0
36959,66264,769,92,26,1,25,.962,3600000,0
36959,67531,775,67,32,3,29,.906,3576000,0
36961,26020,3721,98,35,1,34,.971,3600000,0
36961,48187,1503,0,0,0,0,.00nan,0,0
36961,48234,3721,0,0,0,0,.00nan,0,0
36961,48332,1503,26,22,6,16,.727,3600000,0
36963,132,4923,0,0,0,0,.00nan,0,0
36963,17526,2199,0,0,0,0,.00nan,0,0
36963,48097,2199,55,18,2,16,.889,3600000,0
36963,62226,4923,52,28,3,25,.893,3581000,0
36965,277,2545,0,0,0,0,.00nan,0,0
36965,611,2545,77,37,3,34,.919,3716000,0
36965,40870,750,0,0,0,0,.00nan,0,0
36965,66017,750,73,35,4,31,.886,3716000,0
36967,125,774,0,0,0,0,.00nan,0,0
36967,41794,760,61,7,0,7,1000,1185000,0
36967,60482,760,53,24,4,20,.833,2338000,0
36967,134205,774,70,28,2,26,.929,3600000,0
36969,3208,766,78,32,1,31,.969,3600000,0
36969,21637,762,0,0,0,0,.00nan,0,0
36969,31487,766,0,0,0,0,.00nan,0,0
36969,62285,762,66,31,2,29,.935,3581000,0
36971,4277,758,0,0,0,0,.00nan,0,0
36971,4297,767,72,32,2,30,.938,3600000,0
36971,30194,758,63,28,3,25,.893,3578000,0
36971,48499,767,0,0,0,0,.00nan,0,0
36973,6901,773,0,0,0,0,.00nan,0,0
36973,7112,768,57,37,5,32,.865,3600000,0
36973,17046,768,0,0,0,0,.00nan,0,0
36973,60604,773,96,29,1,28,.966,3600000,0
36975,47897,759,53,25,4,21,.840,3600000,0
36975,48564,759,0,0,0,0,.00nan,0,0
36975,54801,772,0,0,0,0,.00nan,0,0
36975,58436,772,100,31,0,31,1000,3600000,0
36977,21705,764,82,27,2,25,.926,3600000,0
36977,26069,2197,82,40,3,37,.925,3581000,0
36977,26220,764,0,0,0,0,.00nan,0,0
36977,48005,2197,0,0,0,0,.00nan,0,0
36979,17526,2199,66,24,2,22,.917,3600000,0
36979,47785,769,65,33,4,29,.879,3518000,0
36979,48097,2199,0,0,0,0,.00nan,0,0
36979,66264,769,0,0,0,0,.00nan,0,0
36981,132,4923,63,31,3,28,.903,3587000,0
36981,41794,760,51,14,2,12,.857,3600000,0
36981,60482,760,0,0,0,0,.00nan,0,0
36981,62226,4923,0,0,0,0,.00nan,0,0
36983,21637,762,71,20,1,19,.950,3600000,0
36983,26069,2197,0,0,0,0,.00nan,0,0
36983,48005,2197,60,23,3,20,.870,3561000,0
36983,62285,762,0,0,0,0,.00nan,0,0
36985,125,774,0,0,0,0,.00nan,0,0
36985,277,2545,43,23,4,19,.826,3752000,0
36985,611,2545,0,0,0,0,.00nan,0,0
36985,134205,774,52,37,5,32,.865,3752000,0
36987,7112,768,0,0,0,0,.00nan,0,0
36987,17046,768,52,24,2,22,.917,3888000,0
36987,26020,3721,0,0,0,0,.00nan,0,0
36987,48234,3721,72,25,1,24,.960,3888000,0
36989,21705,764,0,0,0,0,.00nan,0,0
36989,26220,764,68,16,1,15,.938,3600000,0
36989,48472,1093,33,17,4,13,.765,1075000,0
36989,62252,1093,36,19,4,15,.789,2525000,0
36991,4277,758,78,29,2,27,.931,3600000,0
36991,26039,3913,0,0,0,0,.00nan,0,0
36991,29022,3913,53,28,3,25,.893,3600000,0
36991,30194,758,0,0,0,0,.00nan,0,0
36993,16186,911,0,0,0,0,.00nan,0,0
36993,17346,4924,0,0,0,0,.00nan,0,0
36993,30764,4924,100,43,2,41,.953,3900000,0
36993,65098,911,93,42,2,40,.952,3900000,0
36995,870,755,0,0,0,0,.00nan,0,0
36995,3208,766,0,0,0,0,.00nan,0,0
36995,31487,766,85,18,0,18,1000,3600000,0
36995,47669,755,61,38,4,34,.895,3600000,0
36997,4297,767,0,0,0,0,.00nan,0,0
36997,47897,759,0,0,0,0,.00nan,0,0
36997,48499,767,71,25,2,23,.920,3600000,0
36997,48564,759,71,32,3,29,.906,3553000,0
36999,40870,750,100,19,0,19,1000,3600000,0
36999,48187,1503,0,0,0,0,.00nan,0,0
36999,48332,1503,86,37,2,35,.946,3569000,0
36999,66017,750,0,0,0,0,.00nan,0,0
37001,557,746,81,27,2,25,.926,3574000,0
37001,54801,772,0,0,0,0,.00nan,0,0
37001,58436,772,73,22,1,21,.955,3600000,0
37001,60993,746,0,0,0,0,.00nan,0,0
37003,5713,775,61,31,3,28,.903,3879000,0
37003,6901,773,77,34,3,31,.912,3900000,0
37003,60604,773,0,0,0,0,.00nan,0,0
37003,67531,775,0,0,0,0,.00nan,0,0
37005,4297,767,59,37,4,33,.892,3900000,0
37005,6901,773,0,0,0,0,.00nan,0,0
37005,48499,767,0,0,0,0,.00nan,0,0
37005,60604,773,52,25,4,21,.840,3900000,0
37007,21705,764,61,21,2,19,.905,3600000,0
37007,26069,2197,91,26,1,25,.962,3600000,0
37007,26220,764,0,0,0,0,.00nan,0,0
37007,48005,2197,0,0,0,0,.00nan,0,0
37009,3208,766,0,0,0,0,.00nan,0,0
37009,17346,4924,81,38,3,35,.921,3600000,0
37009,30764,4924,0,0,0,0,.00nan,0,0
37009,31487,766,90,31,2,29,.935,3600000,0
37011,277,2545,0,0,0,0,.00nan,0,0
37011,611,2545,95,24,0,24,1000,3600000,0
37011,870,755,58,42,5,37,.881,3600000,0
37011,47669,755,0,0,0,0,.00nan,0,0
37013,125,774,49,19,3,16,.842,3600000,0
37013,41794,760,0,0,0,0,.00nan,0,0
37013,60482,760,52,37,5,32,.865,3576000,0
37013,134205,774,0,0,0,0,.00nan,0,0
37015,17526,2199,0,0,0,0,.00nan,0,0
37015,48097,2199,69,23,2,21,.913,3600000,0
37015,54801,772,70,50,5,45,.900,3600000,0
37015,58436,772,0,0,0,0,.00nan,0,0
37017,132,4923,0,0,0,0,.00nan,0,0
37017,4277,758,0,0,0,0,.00nan,0,0
37017,30194,758,90,31,1,30,.968,3600000,0
37017,62226,4923,84,31,2,29,.935,3543000,0
37019,26039,3913,55,28,3,25,.893,3600000,0
37019,29022,3913,0,0,0,0,.00nan,0,0
37019,47897,759,28,23,5,18,.783,3513000,0
37019,48564,759,0,0,0,0,.00nan,0,0
37021,47785,769,0,0,0,0,.00nan,0,0
37021,48187,1503,70,16,1,15,.938,3600000,0
37021,48332,1503,0,0,0,0,.00nan,0,0
37021,66264,769,82,31,2,29,.935,3600000,0
37023,7112,768,79,27,3,24,.889,3900000,0
37023,17046,768,0,0,0,0,.00nan,0,0
37023,40870,750,62,22,3,19,.864,3900000,0
37023,66017,750,0,0,0,0,.00nan,0,0
37025,16186,911,49,26,3,23,.885,3565000,0
37025,21637,762,0,0,0,0,.00nan,0,0
37025,62285,762,74,29,2,27,.931,3600000,0
37025,65098,911,0,0,0,0,.00nan,0,0
37027,557,746,0,0,0,0,.00nan,0,0
37027,48472,1093,72,26,2,24,.923,3900000,0
37027,60993,746,84,36,2,34,.944,3900000,0
37027,62252,1093,0,0,0,0,.00nan,0,0
37029,5713,775,0,0,0,0,.00nan,0,0
37029,26020,3721,82,25,1,24,.960,3600000,0
37029,48234,3721,0,0,0,0,.00nan,0,0
37029,67531,775,55,30,3,27,.900,3547000,0
37031,277,2545,0,0,0,0,.00nan,0,0
37031,557,746,0,0,0,0,.00nan,0,0
37031,611,2545,30,27,6,21,.778,3600000,0
37031,60993,746,54,24,3,21,.875,3600000,0
37033,40870,750,0,0,0,0,.00nan,0,0
37033,48472,1093,0,0,0,0,.00nan,0,0
37033,62252,1093,49,32,4,28,.875,3600000,0
37033,66017,750,100,30,0,30,1000,3600000,0
37035,17346,4924,0,0,0,0,.00nan,0,0
37035,26039,3913,96,43,2,41,.953,3600000,0
37035,29022,3913,0,0,0,0,.00nan,0,0
37035,30764,4924,66,35,3,32,.914,3546000,0
37037,125,774,72,29,3,26,.897,3600000,0
37037,21705,764,0,0,0,0,.00nan,0,0
37037,26220,764,51,28,4,24,.857,3600000,0
37037,134205,774,0,0,0,0,.00nan,0,0
37039,5713,775,65,31,4,27,.871,3552000,0
37039,41794,760,69,29,3,26,.897,3600000,0
37039,60482,760,0,0,0,0,.00nan,0,0
37039,67531,775,0,0,0,0,.00nan,0,0
37041,26020,3721,0,0,0,0,.00nan,0,0
37041,26069,2197,0,0,0,0,.00nan,0,0
37041,48005,2197,97,29,0,29,1000,3900000,0
37041,48234,3721,88,14,0,14,1000,3900000,0
37043,870,755,85,35,2,33,.943,3600000,0
37043,16186,911,0,0,0,0,.00nan,0,0
37043,47669,755,0,0,0,0,.00nan,0,0
37043,65098,911,86,43,3,40,.930,3543000,0
37045,4277,758,83,32,1,31,.969,3900000,0
37045,30194,758,0,0,0,0,.00nan,0,0
37045,48187,1503,0,0,0,0,.00nan,0,0
37045,48332,1503,94,32,1,31,.969,3900000,0
37047,132,4923,96,34,1,33,.971,3600000,0
37047,6901,773,72,24,2,22,.917,3580000,0
37047,60604,773,0,0,0,0,.00nan,0,0
37047,62226,4923,0,0,0,0,.00nan,0,0
37049,17526,2199,93,15,0,15,1000,3600000,0
37049,21637,762,67,23,2,21,.913,3587000,0
37049,48097,2199,0,0,0,0,.00nan,0,0
37049,62285,762,0,0,0,0,.00nan,0,0
37051,3208,766,0,0,0,0,.00nan,0,0
37051,7112,768,0,0,0,0,.00nan,0,0
37051,17046,768,100,27,0,27,1000,3600000,0
37051,31487,766,60,28,4,24,.857,3600000,0
37053,4297,767,0,0,0,0,.00nan,0,0
37053,48499,767,100,30,0,30,1000,3600000,0
37053,54801,772,55,26,3,23,.885,3600000,0
37053,58436,772,0,0,0,0,.00nan,0,0
37055,47785,769,61,20,2,18,.900,3708000,0
37055,47897,759,0,0,0,0,.00nan,0,0
37055,48564,759,94,41,3,38,.927,3708000,0
37055,66264,769,0,0,0,0,.00nan,0,0
37057,4297,767,0,0,0,0,.00nan,0,0
37057,5713,775,0,0,0,0,.00nan,0,0
37057,48499,767,65,34,3,31,.912,3900000,0
37057,67531,775,65,24,3,21,.875,3900000,0
37059,48472,1093,25,31,6,25,.806,2743000,0
37059,54801,772,0,0,0,0,.00nan,0,0
37059,58436,772,68,24,2,22,.917,3600000,0
37059,62252,1093,50,9,1,8,.889,857000,0
37061,870,755,0,0,0,0,.00nan,0,0
37061,41794,760,0,0,0,0,.00nan,0,0
37061,47669,755,70,37,3,34,.919,3600000,0
37061,60482,760,75,30,2,28,.933,3600000,0
37063,6901,773,0,0,0,0,.00nan,0,0
37063,21705,764,70,28,2,26,.929,3600000,0
37063,26220,764,0,0,0,0,.00nan,0,0
37063,60604,773,55,31,4,27,.871,3513000,0
37065,125,774,0,0,0,0,.00nan,0,0
37065,17526,2199,65,27,2,25,.926,3600000,0
37065,48097,2199,0,0,0,0,.00nan,0,0
37065,134205,774,61,37,5,32,.865,3600000,0
37067,26020,3721,0,0,0,0,.00nan,0,0
37067,40870,750,0,0,0,0,.00nan,0,0
37067,48234,3721,100,40,1,39,.975,3900000,0
37067,66017,750,79,23,1,22,.957,3900000,0
37069,132,4923,0,0,0,0,.00nan,0,0
37069,26069,2197,0,0,0,0,.00nan,0,0
37069,48005,2197,100,27,0,27,1000,3600000,0
37069,62226,4923,70,35,3,32,.914,3600000,0
37071,557,746,100,32,0,32,1000,3600000,0
37071,21637,762,0,0,0,0,.00nan,0,0
37071,60993,746,0,0,0,0,.00nan,0,0
37071,62285,762,49,25,4,21,.840,3600000,0
37073,17346,4924,61,29,3,26,.897,3569000,0
37073,30764,4924,0,0,0,0,.00nan,0,0
37073,47897,759,77,30,2,28,.933,3600000,0
37073,48564,759,0,0,0,0,.00nan,0,0
37075,3208,766,71,33,3,30,.909,3572000,0
37075,4277,758,0,0,0,0,.00nan,0,0
37075,30194,758,92,27,1,26,.963,3600000,0
37075,31487,766,0,0,0,0,.00nan,0,0
37077,7112,768,0,0,0,0,.00nan,0,0
37077,16186,911,97,26,0,26,1000,3600000,0
37077,17046,768,32,26,5,21,.808,3600000,0
37077,65098,911,0,0,0,0,.00nan,0,0
37079,277,2545,48,25,4,21,.840,3575000,0
37079,611,2545,0,0,0,0,.00nan,0,0
37079,26039,3913,0,0,0,0,.00nan,0,0
37079,29022,3913,74,42,3,39,.929,3600000,0
37081,47785,769,0,0,0,0,.00nan,0,0
37081,48187,1503,79,33,2,31,.939,3600000,0
37081,48332,1503,0,0,0,0,.00nan,0,0
37081,66264,769,60,27,3,24,.889,3574000,0
37083,41794,760,44,29,5,24,.828,3600000,0
37083,47785,769,100,31,0,31,1000,3600000,0
37083,60482,760,0,0,0,0,.00nan,0,0
37083,66264,769,0,0,0,0,.00nan,0,0
37085,21637,762,41,34,5,29,.853,3600000,0
37085,54801,772,39,23,4,19,.826,3600000,0
37085,58436,772,0,0,0,0,.00nan,0,0
37085,62285,762,0,0,0,0,.00nan,0,0
37087,4277,758,90,29,2,27,.931,3900000,0
37087,26020,3721,86,30,2,28,.933,3900000,0
37087,30194,758,0,0,0,0,.00nan,0,0
37087,48234,3721,0,0,0,0,.00nan,0,0
37089,26039,3913,90,38,2,36,.947,3600000,0
37089,26069,2197,53,10,1,9,.900,1105000,0
37089,29022,3913,0,0,0,0,.00nan,0,0
37089,48005,2197,19,25,6,19,.760,2495000,0
37091,277,2545,0,0,0,0,.00nan,0,0
37091,611,2545,71,23,1,22,.957,3900000,0
37091,48472,1093,0,0,0,0,.00nan,0,0
37091,62252,1093,95,31,1,30,.968,3900000,0
37093,870,755,0,0,0,0,.00nan,0,0
37093,40870,750,55,11,1,10,.909,3600000,0
37093,47669,755,75,41,3,38,.927,3563000,0
37093,66017,750,0,0,0,0,.00nan,0,0
37095,17346,4924,0,0,0,0,.00nan,0,0
37095,17526,2199,71,31,3,28,.903,3568000,0
37095,30764,4924,65,21,1,20,.952,3600000,0
37095,48097,2199,0,0,0,0,.00nan,0,0
37097,21705,764,78,33,2,31,.939,3600000,0
37097,26220,764,0,0,0,0,.00nan,0,0
37097,48187,1503,0,0,0,0,.00nan,0,0
37097,48332,1503,55,25,3,22,.880,3600000,0
37099,7112,768,0,0,0,0,.00nan,0,0
37099,17046,768,97,21,1,20,.952,3900000,0
37099,47897,759,0,0,0,0,.00nan,0,0
37099,48564,759,97,37,1,36,.973,3900000,0
37101,4297,767,0,0,0,0,.00nan,0,0
37101,5713,775,75,27,3,24,.889,3654000,0
37101,48499,767,70,41,4,37,.902,3654000,0
37101,67531,775,0,0,0,0,.00nan,0,0
37103,125,774,48,25,4,21,.840,3600000,0
37103,6901,773,27,25,6,19,.760,2349000,0
37103,60604,773,44,6,1,5,.833,1251000,0
37103,134205,774,0,0,0,0,.00nan,0,0
37105,557,746,76,40,4,36,.900,3600000,0
37105,3208,766,0,0,0,0,.00nan,0,0
37105,31487,766,71,22,1,21,.955,3600000,0
37105,60993,746,0,0,0,0,.00nan,0,0
37107,132,4923,52,33,5,28,.848,3545000,0
37107,16186,911,63,33,4,29,.879,3600000,0
37107,62226,4923,0,0,0,0,.00nan,0,0
37107,65098,911,0,0,0,0,.00nan,0,0
37108,4467,585,61,32,4,28,.875,3600000,0
37108,26660,585,0,0,0,0,.00nan,0,0
37108,47751,580,95,34,1,33,.971,3600000,0
37108,52468,580,0,0,0,0,.00nan,0,0
37109,7442,1931,0,0,0,0,.00nan,0,0
37109,11446,2187,0,0,0,0,.00nan,0,0
37109,12590,2187,87,30,1,29,.967,3600000,0
37109,15325,1931,76,41,4,37,.902,3600000,0
37110,9495,563,0,0,0,0,.00nan,0,0
37110,26132,563,76,34,3,31,.912,3600000,0
37110,34500,586,35,33,6,27,.818,3132000,0
37110,54631,586,42,7,2,5,.714,468000,0
37111,4756,582,61,40,6,34,.850,3536000,0
37111,5717,582,0,0,0,0,.00nan,0,0
37111,26544,1927,75,44,4,40,.909,3600000,0
37111,55109,1927,0,0,0,0,.00nan,0,0
37112,10577,1922,69,22,1,21,.955,2406000,0
37112,20692,1925,0,0,0,0,.00nan,0,0
37112,49317,1922,25,19,5,14,.737,1194000,0
37112,54593,1925,61,25,3,22,.880,3600000,0
37113,6154,584,29,24,5,19,.792,3600000,0
37113,20653,1928,0,0,0,0,.00nan,0,0
37113,31011,1928,100,41,2,39,.951,3600000,0
37113,32108,584,0,0,0,0,.00nan,0,0
37114,10577,1922,0,0,0,0,.00nan,0,0
37114,20653,1928,49,20,3,17,.850,3582000,0
37114,31011,1928,0,0,0,0,.00nan,0,0
37114,49317,1922,99,46,2,44,.957,3600000,0
37115,4756,582,0,0,0,0,.00nan,0,0
37115,5717,582,95,21,0,21,1000,3600000,0
37115,11446,2187,86,40,1,39,.975,3587000,0
37115,12590,2187,0,0,0,0,.00nan,0,0
37116,4467,585,44,23,4,19,.826,3567000,0
37116,20692,1925,83,33,2,31,.939,3600000,0
37116,26660,585,0,0,0,0,.00nan,0,0
37116,54593,1925,0,0,0,0,.00nan,0,0
37117,6154,584,0,0,0,0,.00nan,0,0
37117,26544,1927,96,28,1,27,.964,3600000,0
37117,32108,584,58,20,2,18,.900,3569000,0
37117,55109,1927,0,0,0,0,.00nan,0,0
37118,7442,1931,74,32,3,29,.906,3756000,0
37118,9495,563,100,46,2,44,.957,3756000,0
37118,15325,1931,0,0,0,0,.00nan,0,0
37118,26132,563,0,0,0,0,.00nan,0,0
37119,21077,1934,56,21,2,19,.905,3600000,0
37119,47751,580,41,47,7,40,.851,3600000,0
37119,52468,580,0,0,0,0,.00nan,0,0
37119,54625,1934,0,0,0,0,.00nan,0,0
37120,21077,1934,53,34,5,29,.853,3520000,0
37120,34500,586,0,0,0,0,.00nan,0,0
37120,54625,1934,0,0,0,0,.00nan,0,0
37120,54631,586,78,44,3,41,.932,3600000,0
37121,10577,1922,83,33,2,31,.939,3600000,0
37121,26544,1927,69,37,3,34,.919,3557000,0
37121,49317,1922,0,0,0,0,.00nan,0,0
37121,55109,1927,0,0,0,0,.00nan,0,0
37122,20653,1928,0,0,0,0,.00nan,0,0
37122,21077,1934,66,27,3,24,.889,3600000,0
37122,31011,1928,55,34,5,29,.853,3600000,0
37122,54625,1934,0,0,0,0,.00nan,0,0
37123,9495,563,37,23,5,18,.783,3590000,0
37123,20653,1928,80,41,3,38,.927,3600000,0
37123,26132,563,0,0,0,0,.00nan,0,0
37123,31011,1928,0,0,0,0,.00nan,0,0
37124,7442,1931,0,0,0,0,.00nan,0,0
37124,15325,1931,66,51,4,47,.922,3900000,0
37124,26544,1927,43,30,4,26,.867,3900000,0
37124,55109,1927,0,0,0,0,.00nan,0,0
37125,4756,582,0,0,0,0,.00nan,0,0
37125,5717,582,47,39,6,33,.846,3600000,0
37125,6154,584,0,0,0,0,.00nan,0,0
37125,32108,584,65,23,2,21,.913,3600000,0
37126,4467,585,81,29,2,27,.931,3600000,0
37126,10577,1922,0,0,0,0,.00nan,0,0
37126,26660,585,0,0,0,0,.00nan,0,0
37126,49317,1922,70,27,3,24,.889,3545000,0
37127,30982,1918,100,31,1,30,.968,3600000,0
37127,32476,1925,0,0,0,0,.00nan,0,0
37127,52467,1918,0,0,0,0,.00nan,0,0
37127,54593,1925,49,31,4,27,.871,3600000,0
37128,9495,563,0,0,0,0,.00nan,0,0
37128,11446,2187,77,27,2,25,.926,3568000,0
37128,12590,2187,0,0,0,0,.00nan,0,0
37128,26132,563,95,24,0,24,1000,3600000,0
37129,20653,1928,0,0,0,0,.00nan,0,0
37129,31011,1928,64,36,4,32,.889,3600000,0
37129,34500,586,87,28,1,27,.964,3600000,0
37129,54631,586,0,0,0,0,.00nan,0,0
37130,6154,584,72,30,2,28,.933,3600000,0
37130,32108,584,0,0,0,0,.00nan,0,0
37130,47751,580,40,23,4,19,.826,3516000,0
37130,52468,580,0,0,0,0,.00nan,0,0
37131,4467,585,0,0,0,0,.00nan,0,0
37131,7442,1931,48,28,4,24,.857,2396000,0
37131,15325,1931,46,12,2,10,.833,1148000,0
37131,26660,585,48,36,5,31,.861,3600000,0
37132,30982,1918,65,34,3,31,.912,3600000,0
37132,32476,1925,53,39,5,34,.872,3600000,0
37132,52467,1918,0,0,0,0,.00nan,0,0
37132,54593,1925,0,0,0,0,.00nan,0,0
37133,4467,585,80,28,2,26,.929,3519000,0
37133,21077,1934,100,29,0,29,1000,3600000,0
37133,26660,585,0,0,0,0,.00nan,0,0
37133,54625,1934,0,0,0,0,.00nan,0,0
37134,6154,584,0,0,0,0,.00nan,0,0
37134,30982,1918,61,28,3,25,.893,3814000,0
37134,32108,584,38,18,4,14,.778,3814000,0
37134,52467,1918,0,0,0,0,.00nan,0,0
37135,26544,1927,48,28,6,22,.786,3557000,0
37135,47751,580,62,35,5,30,.857,3600000,0
37135,52468,580,0,0,0,0,.00nan,0,0
37135,55109,1927,0,0,0,0,.00nan,0,0
37136,6154,584,58,32,4,28,.875,3552000,0
37136,30982,1918,0,0,0,0,.00nan,0,0
37136,32108,584,0,0,0,0,.00nan,0,0
37136,52467,1918,73,25,2,23,.920,3600000,0
37137,4756,582,0,0,0,0,.00nan,0,0
37137,5717,582,66,42,5,37,.881,3600000,0
37137,20653,1928,0,0,0,0,.00nan,0,0
37137,31011,1928,79,24,1,23,.958,3600000,0
37138,11446,2187,0,0,0,0,.00nan,0,0
37138,12590,2187,87,28,1,27,.964,3600000,0
37138,34500,586,75,32,2,30,.938,3548000,0
37138,54631,586,0,0,0,0,.00nan,0,0
37139,4756,582,78,24,1,23,.958,3600000,0
37139,5717,582,0,0,0,0,.00nan,0,0
37139,9495,563,0,0,0,0,.00nan,0,0
37139,26132,563,54,22,2,20,.909,3600000,0
37140,21077,1934,64,23,2,21,.913,3600000,0
37140,26544,1927,56,28,3,25,.893,3600000,0
37140,54625,1934,0,0,0,0,.00nan,0,0
37140,55109,1927,0,0,0,0,.00nan,0,0
37141,30982,1918,70,26,2,24,.923,3600000,0
37141,32476,1925,68,11,0,11,1000,1502000,0
37141,52467,1918,0,0,0,0,.00nan,0,0
37141,54593,1925,28,15,4,11,.733,2085000,0
37142,7442,1931,0,0,0,0,.00nan,0,0
37142,10577,1922,29,19,4,15,.789,3598000,0
37142,15325,1931,72,29,2,27,.931,3600000,0
37142,49317,1922,0,0,0,0,.00nan,0,0
37143,10577,1922,0,0,0,0,.00nan,0,0
37143,11446,2187,51,24,4,20,.833,3600000,0
37143,12590,2187,0,0,0,0,.00nan,0,0
37143,49317,1922,91,35,1,34,.971,3600000,0
37144,9495,563,76,32,2,30,.938,3549000,0
37144,26132,563,0,0,0,0,.00nan,0,0
37144,26544,1927,0,0,0,0,.00nan,0,0
37144,55109,1927,58,12,1,11,.917,3600000,0
37145,7442,1931,68,34,3,31,.912,3600000,0
37145,15325,1931,0,0,0,0,.00nan,0,0
37145,34500,586,0,0,0,0,.00nan,0,0
37145,54631,586,50,30,4,26,.867,3554000,0
37146,6154,584,0,0,0,0,.00nan,0,0
37146,32108,584,45,31,5,26,.839,3600000,0
37146,47751,580,76,26,2,24,.923,3600000,0
37146,52468,580,0,0,0,0,.00nan,0,0
37147,30982,1918,0,0,0,0,.00nan,0,0
37147,32476,1925,0,0,0,0,.00nan,0,0
37147,52467,1918,65,23,2,21,.913,3600000,0
37147,54593,1925,40,29,5,24,.828,3600000,0
37148,4467,585,46,32,5,27,.844,3600000,0
37148,20653,1928,0,0,0,0,.00nan,0,0
37148,26660,585,0,0,0,0,.00nan,0,0
37148,31011,1928,53,27,4,23,.852,3600000,0
37149,10577,1922,30,35,6,29,.829,3169000,0
37149,30982,1918,90,47,3,44,.936,3600000,0
37149,49317,1922,43,4,1,3,.750,431000,0
37149,52467,1918,0,0,0,0,.00nan,0,0
37150,4467,585,69,44,5,39,.886,3600000,0
37150,6154,584,41,25,4,21,.840,3600000,0
37150,26660,585,0,0,0,0,.00nan,0,0
37150,32108,584,0,0,0,0,.00nan,0,0
37151,10577,1922,0,0,0,0,.00nan,0,0
37151,30982,1918,0,0,0,0,.00nan,0,0
37151,49317,1922,74,39,4,35,.897,3600000,0
37151,52467,1918,69,29,3,26,.897,3600000,0
37152,6154,584,96,34,1,33,.971,3600000,0
37152,9495,563,63,39,4,35,.897,3600000,0
37152,26132,563,0,0,0,0,.00nan,0,0
37152,32108,584,0,0,0,0,.00nan,0,0
37153,20653,1928,0,0,0,0,.00nan,0,0
37153,31011,1928,56,18,2,16,.889,3600000,0
37153,32476,1925,0,0,0,0,.00nan,0,0
37153,54593,1925,77,44,4,40,.909,3580000,0
37154,11446,2187,90,23,0,23,1000,3600000,0
37154,16186,2187,0,0,0,0,.00nan,0,0
37154,47751,580,74,27,1,26,.963,3599000,0
37154,52468,580,0,0,0,0,.00nan,0,0
37155,4756,582,0,0,0,0,.00nan,0,0
37155,5717,582,76,41,4,37,.902,3847000,0
37155,21077,1934,42,28,5,23,.821,3854000,0
37155,54625,1934,0,0,0,0,.00nan,0,0
37156,4467,585,0,0,0,0,.00nan,0,0
37156,26660,585,54,22,3,19,.864,3600000,0
37156,34500,586,0,0,0,0,.00nan,0,0
37156,54631,586,61,41,5,36,.878,3516000,0
37157,26544,1927,82,26,1,25,.962,3600000,0
37157,32476,1925,28,29,6,23,.793,3222000,0
37157,54593,1925,54,5,0,5,1000,378000,0
37157,55109,1927,0,0,0,0,.00nan,0,0
37158,6154,584,0,0,0,0,.00nan,0,0
37158,7442,1931,48,7,1,6,.857,922000,0
37158,15325,1931,25,24,6,18,.750,2678000,0
37158,32108,584,52,17,2,15,.882,3600000,0
37159,26544,1927,0,0,0,0,.00nan,0,0
37159,34500,586,70,29,3,26,.897,3600000,0
37159,54631,586,0,0,0,0,.00nan,0,0
37159,55109,1927,55,35,4,31,.886,3589000,0
37160,9495,563,0,0,0,0,.00nan,0,0
37160,21077,1934,0,0,0,0,.00nan,0,0
37160,26132,563,34,37,7,30,.811,3600000,0
37160,54625,1934,56,16,2,14,.875,3600000,0
37161,7442,1931,44,26,4,22,.846,3600000,0
37161,15325,1931,0,0,0,0,.00nan,0,0
37161,47751,580,47,39,6,33,.846,3600000,0
37161,52468,580,0,0,0,0,.00nan,0,0
37162,4756,582,95,18,0,18,1000,3600000,0
37162,5717,582,0,0,0,0,.00nan,0,0
37162,10577,1922,75,30,2,28,.933,3555000,0
37162,49317,1922,0,0,0,0,.00nan,0,0
37163,11446,2187,23,4,3,1,.250,380000,0
37163,16186,2187,57,22,3,19,.864,3220000,0
37163,32476,1925,0,0,0,0,.00nan,0,0
37163,54593,1925,97,28,0,28,1000,3600000,0
37164,6154,584,0,0,0,0,.00nan,0,0
37164,20653,1928,0,0,0,0,.00nan,0,0
37164,31011,1928,63,43,5,38,.884,3600000,0
37164,32108,584,67,28,2,26,.929,3600000,0
37165,10577,1922,72,35,3,32,.914,3900000,0
37165,26544,1927,50,23,3,20,.870,3900000,0
37165,49317,1922,0,0,0,0,.00nan,0,0
37165,55109,1927,0,0,0,0,.00nan,0,0
37166,4467,585,0,0,0,0,.00nan,0,0
37166,9495,563,1,20,7,13,.650,2218000,0
37166,26132,563,41,10,2,8,.800,1382000,0
37166,26660,585,100,26,0,26,1000,3600000,0
37167,26020,580,0,0,0,0,.00nan,0,0
37167,34500,586,76,35,3,32,.914,3600000,0
37167,47751,580,100,26,0,26,1000,3600000,0
37167,54631,586,0,0,0,0,.00nan,0,0
37168,21077,1934,64,21,2,19,.905,3600000,0
37168,32476,1925,0,0,0,0,.00nan,0,0
37168,54593,1925,60,38,4,34,.895,3590000,0
37168,54625,1934,0,0,0,0,.00nan,0,0
37169,7442,1931,0,0,0,0,.00nan,0,0
37169,15325,1931,77,30,2,28,.933,3539000,0
37169,20653,1928,0,0,0,0,.00nan,0,0
37169,31011,1928,100,34,0,34,1000,3600000,0
37170,11446,2187,86,31,1,30,.968,3900000,0
37170,16186,2187,0,0,0,0,.00nan,0,0
37170,30982,1918,79,30,1,29,.967,3900000,0
37170,52467,1918,0,0,0,0,.00nan,0,0
37171,7442,1931,62,26,3,23,.885,3900000,0
37171,10577,1922,0,0,0,0,.00nan,0,0
37171,15325,1931,0,0,0,0,.00nan,0,0
37171,49317,1922,55,25,3,22,.880,3900000,0
37172,4467,585,0,0,0,0,.00nan,0,0
37172,26660,585,50,37,6,31,.838,3900000,0
37172,34500,586,82,27,2,25,.926,2970000,0
37172,54631,586,22,11,4,7,.636,930000,0
37173,6154,584,41,2,1,1,.500,451000,0
37173,26544,1927,88,50,4,46,.920,3600000,0
37173,32108,584,16,20,6,14,.700,3149000,0
37173,55109,1927,0,0,0,0,.00nan,0,0
37174,4756,582,76,32,2,30,.938,3600000,0
37174,5717,582,0,0,0,0,.00nan,0,0
37174,26020,580,0,0,0,0,.00nan,0,0
37174,47751,580,68,39,3,36,.923,3551000,0
37175,11446,2187,0,0,0,0,.00nan,0,0
37175,16186,2187,86,38,3,35,.921,3600000,0
37175,30982,1918,0,0,0,0,.00nan,0,0
37175,52467,1918,50,29,5,24,.828,3538000,0
37473,10577,1922,0,0,0,0,.00nan,0,0
37473,11446,2187,34,15,4,11,.733,590000,0
37473,12590,2187,57,33,3,30,.909,3010000,0
37473,49317,1922,48,28,4,24,.857,3600000,0
37475,4756,582,55,54,7,47,.870,3600000,0
37475,5717,582,0,0,0,0,.00nan,0,0
37475,34500,586,78,23,1,22,.957,3600000,0
37475,54631,586,0,0,0,0,.00nan,0,0
37477,21077,1934,63,30,3,27,.900,3547000,0
37477,47751,580,83,39,2,37,.949,3600000,0
37477,52468,580,0,0,0,0,.00nan,0,0
37477,54625,1934,0,0,0,0,.00nan,0,0
37479,6154,584,0,0,0,0,.00nan,0,0
37479,30982,1918,80,36,3,33,.917,3521000,0
37479,38071,584,87,30,1,29,.967,3600000,0
37479,52467,1918,0,0,0,0,.00nan,0,0
37481,4467,585,39,31,5,26,.839,3565000,0
37481,9495,563,0,0,0,0,.00nan,0,0
37481,26132,563,39,21,4,17,.810,3600000,0
37481,26660,585,0,0,0,0,.00nan,0,0
37483,6903,1931,56,2,0,2,1000,510000,0
37483,15325,1931,70,29,2,27,.931,3390000,0
37483,20653,1928,0,0,0,0,.00nan,0,0
37483,31011,1928,71,26,2,24,.923,3900000,0
37485,20692,1925,0,0,0,0,.00nan,0,0
37485,26544,1927,84,36,2,34,.944,3600000,0
37485,32476,1925,46,27,4,23,.852,3600000,0
37485,55109,1927,0,0,0,0,.00nan,0,0
37487,4756,582,0,0,0,0,.00nan,0,0
37487,5717,582,51,25,3,22,.880,3548000,0
37487,20653,1928,0,0,0,0,.00nan,0,0
37487,31011,1928,73,30,2,28,.933,3600000,0
37489,20692,1925,0,0,0,0,.00nan,0,0
37489,32476,1925,54,26,3,23,.885,3600000,0
37489,47751,580,44,36,5,31,.861,3600000,0
37489,52468,580,0,0,0,0,.00nan,0,0
37491,30982,1918,43,30,5,25,.833,3600000,0
37491,34500,586,0,0,0,0,.00nan,0,0
37491,52467,1918,0,0,0,0,.00nan,0,0
37491,54631,586,99,47,2,45,.957,3600000,0
37493,7442,1931,0,0,0,0,.00nan,0,0
37493,10577,1922,61,34,4,30,.882,3600000,0
37493,15325,1931,27,20,5,15,.750,3595000,0
37493,49317,1922,0,0,0,0,.00nan,0,0
37495,9495,563,90,22,0,22,1000,3600000,0
37495,26132,563,0,0,0,0,.00nan,0,0
37495,26544,1927,64,28,3,25,.893,3600000,0
37495,55109,1927,0,0,0,0,.00nan,0,0
37497,4467,585,52,30,4,26,.867,3514000,0
37497,11446,2187,63,22,2,20,.909,3600000,0
37497,12590,2187,0,0,0,0,.00nan,0,0
37497,26660,585,0,0,0,0,.00nan,0,0
37499,6154,584,0,0,0,0,.00nan,0,0
37499,21077,1934,65,16,1,15,.938,3600000,0
37499,38071,584,91,53,4,49,.925,3600000,0
37499,54625,1934,0,0,0,0,.00nan,0,0
37501,20653,1928,62,19,2,17,.895,3600000,0
37501,26544,1927,0,0,0,0,.00nan,0,0
37501,31011,1928,0,0,0,0,.00nan,0,0
37501,55109,1927,71,45,4,41,.911,3587000,0
37503,4756,582,83,39,2,37,.949,3600000,0
37503,5717,582,0,0,0,0,.00nan,0,0
37503,6154,584,100,27,0,27,1000,3600000,0
37503,38071,584,0,0,0,0,.00nan,0,0
37505,4467,585,0,0,0,0,.00nan,0,0
37505,11446,2187,0,0,0,0,.00nan,0,0
37505,12590,2187,89,36,2,34,.944,3600000,0
37505,26660,585,50,22,3,19,.864,3570000,0
37507,30982,1918,75,27,2,25,.926,3600000,0
37507,47751,580,0,0,0,0,.00nan,0,0
37507,52467,1918,0,0,0,0,.00nan,0,0
37507,52468,580,66,35,3,32,.914,3600000,0
37509,10577,1922,54,19,2,17,.895,2577000,0
37509,20692,1925,80,30,1,29,.967,3600000,0
37509,32476,1925,0,0,0,0,.00nan,0,0
37509,49317,1922,24,13,4,9,.692,1023000,0
37511,7442,1931,98,50,3,47,.940,3541000,0
37511,15325,1931,0,0,0,0,.00nan,0,0
37511,21077,1934,0,0,0,0,.00nan,0,0
37511,54625,1934,91,32,1,31,.969,3600000,0
37513,9495,563,0,0,0,0,.00nan,0,0
37513,26132,563,50,34,5,29,.853,3546000,0
37513,34500,586,63,30,4,26,.867,3600000,0
37513,54631,586,0,0,0,0,.00nan,0,0
37515,4756,582,0,0,0,0,.00nan,0,0
37515,5717,582,64,34,4,30,.882,3600000,0
37515,9495,563,21,12,4,8,.667,1085000,0
37515,26132,563,77,32,2,30,.938,2440000,0
37517,6154,584,91,31,1,30,.968,3600000,0
37517,10577,1922,0,0,0,0,.00nan,0,0
37517,38071,584,0,0,0,0,.00nan,0,0
37517,49317,1922,66,43,4,39,.907,3600000,0
37519,20653,1928,0,0,0,0,.00nan,0,0
37519,30982,1918,28,15,4,11,.733,963000,0
37519,31011,1928,89,38,2,36,.947,3600000,0
37519,52467,1918,58,26,3,23,.885,2637000,0
37521,4467,585,64,37,4,33,.892,3554000,0
37521,20692,1925,0,0,0,0,.00nan,0,0
37521,26660,585,0,0,0,0,.00nan,0,0
37521,32476,1925,84,37,3,34,.919,3600000,0
37523,7442,1931,0,0,0,0,.00nan,0,0
37523,11446,2187,51,32,4,28,.875,3600000,0
37523,12590,2187,0,0,0,0,.00nan,0,0
37523,15325,1931,61,29,3,26,.897,3600000,0
37525,21077,1934,48,25,4,21,.840,3600000,0
37525,47751,580,62,55,7,48,.873,3600000,0
37525,52468,580,0,0,0,0,.00nan,0,0
37525,54625,1934,0,0,0,0,.00nan,0,0
37527,26544,1927,81,40,3,37,.925,3900000,0
37527,34500,586,86,31,3,28,.903,3900000,0
37527,54631,586,0,0,0,0,.00nan,0,0
37527,55109,1927,0,0,0,0,.00nan,0,0
37529,10577,1922,85,35,1,34,.971,3900000,0
37529,20653,1928,73,27,1,26,.963,3900000,0
37529,31011,1928,0,0,0,0,.00nan,0,0
37529,49317,1922,0,0,0,0,.00nan,0,0
37531,9495,563,41,30,5,25,.833,3600000,0
37531,26132,563,0,0,0,0,.00nan,0,0
37531,30982,1918,92,24,1,23,.958,3600000,0
37531,52467,1918,0,0,0,0,.00nan,0,0
37533,4756,582,92,45,3,42,.933,3554000,0
37533,5717,582,0,0,0,0,.00nan,0,0
37533,20692,1925,61,22,2,20,.909,3600000,0
37533,32476,1925,0,0,0,0,.00nan,0,0
37535,34500,586,54,1,0,1,1000,301000,0
37535,47751,580,0,0,0,0,.00nan,0,0
37535,52468,580,79,36,2,34,.944,3600000,0
37535,54631,586,25,26,6,20,.769,3299000,0
37537,4467,585,0,0,0,0,.00nan,0,0
37537,6154,584,0,0,0,0,.00nan,0,0
37537,26660,585,53,38,5,33,.868,3600000,0
37537,38071,584,77,23,1,22,.957,3600000,0
37539,7442,1931,93,25,0,25,1000,3600000,0
37539,15325,1931,0,0,0,0,.00nan,0,0
37539,21077,1934,0,0,0,0,.00nan,0,0
37539,54625,1934,79,31,2,29,.935,3532000,0
37541,11446,2187,0,0,0,0,.00nan,0,0
37541,12590,2187,76,47,5,42,.894,3600000,0
37541,26544,1927,0,0,0,0,.00nan,0,0
37541,55109,1927,79,20,1,19,.950,3600000,0
37543,10577,1922,64,30,3,27,.900,2682000,0
37543,30982,1918,56,31,4,27,.871,3600000,0
37543,49317,1922,24,10,4,6,.600,918000,0
37543,52467,1918,0,0,0,0,.00nan,0,0
37545,7442,1931,0,0,0,0,.00nan,0,0
37545,15325,1931,86,40,2,38,.950,3569000,0
37545,20692,1925,0,0,0,0,.00nan,0,0
37545,32476,1925,66,15,1,14,.933,3600000,0
37547,11446,2187,65,36,3,33,.917,3900000,0
37547,12590,2187,0,0,0,0,.00nan,0,0
37547,20653,1928,0,0,0,0,.00nan,0,0
37547,31011,1928,58,21,3,18,.857,3900000,0
37549,4467,585,70,24,1,23,.958,3600000,0
37549,26660,585,0,0,0,0,.00nan,0,0
37549,34500,586,79,33,2,31,.939,3545000,0
37549,54631,586,0,0,0,0,.00nan,0,0
37551,6154,584,0,0,0,0,.00nan,0,0
37551,26544,1927,56,25,3,22,.880,3563000,0
37551,32108,584,99,34,2,32,.941,3600000,0
37551,55109,1927,0,0,0,0,.00nan,0,0
37553,4756,582,79,28,2,26,.929,3900000,0
37553,5717,582,0,0,0,0,.00nan,0,0
37553,9495,563,0,0,0,0,.00nan,0,0
37553,26132,563,81,26,2,24,.923,3900000,0
37555,21077,1934,30,23,5,18,.783,3600000,0
37555,47751,580,100,41,1,40,.976,3600000,0
37555,52468,580,0,0,0,0,.00nan,0,0
37555,54625,1934,0,0,0,0,.00nan,0,0
37557,34500,586,72,30,2,28,.933,3600000,0
37557,47751,580,0,0,0,0,.00nan,0,0
37557,52468,580,58,36,4,32,.889,3543000,0
37557,54631,586,0,0,0,0,.00nan,0,0
37559,10577,1922,0,0,0,0,.00nan,0,0
37559,30982,1918,0,0,0,0,.00nan,0,0
37559,49317,1922,50,34,5,29,.853,3600000,0
37559,52467,1918,67,24,2,22,.917,3600000,0
37561,7442,1931,90,29,1,28,.966,3600000,0
37561,15325,1931,0,0,0,0,.00nan,0,0
37561,20692,1925,67,26,2,24,.923,3557000,0
37561,32476,1925,0,0,0,0,.00nan,0,0
37563,4467,585,0,0,0,0,.00nan,0,0
37563,9495,563,58,35,4,31,.886,3600000,0
37563,26132,563,0,0,0,0,.00nan,0,0
37563,26660,585,83,33,2,31,.939,3600000,0
37565,4756,582,0,0,0,0,.00nan,0,0
37565,5717,582,69,36,3,33,.917,3779000,0
37565,11446,2187,0,0,0,0,.00nan,0,0
37565,12590,2187,66,25,2,23,.920,3779000,0
37567,21077,1934,0,0,0,0,.00nan,0,0
37567,26544,1927,63,9,0,9,1000,575000,0
37567,54625,1934,65,25,2,23,.920,3600000,0
37567,55109,1927,44,40,6,34,.850,3025000,0
37569,6154,584,51,23,4,19,.826,3600000,0
37569,20653,1928,89,30,1,29,.967,3600000,0
37569,31011,1928,0,0,0,0,.00nan,0,0
37569,32108,584,0,0,0,0,.00nan,0,0
37570,7446,647,60,17,2,15,.882,3600000,0
37570,14946,647,0,0,0,0,.00nan,0,0
37570,32042,1818,45,26,4,22,.846,3522000,0
37570,32797,1818,0,0,0,0,.00nan,0,0
37571,11083,639,0,0,0,0,.00nan,0,0
37571,18310,644,0,0,0,0,.00nan,0,0
37571,21418,644,74,22,1,21,.955,3600000,0
37571,60309,639,71,29,2,27,.931,3545000,0
37572,8761,637,0,0,0,0,.00nan,0,0
37572,9702,637,82,36,2,34,.944,3600000,0
37572,11973,648,0,0,0,0,.00nan,0,0
37572,41387,648,38,27,5,22,.815,3600000,0
37573,17580,640,79,24,1,23,.958,3600000,0
37573,21492,1847,97,48,2,46,.958,3600000,0
37573,41133,1847,0,0,0,0,.00nan,0,0
37573,143946,640,0,0,0,0,.00nan,0,0
37574,1635,1814,42,11,3,8,.727,3596000,0
37574,11829,1827,0,0,0,0,.00nan,0,0
37574,15048,1827,96,42,1,41,.976,3600000,0
37574,41062,1814,0,0,0,0,.00nan,0,0
37575,9591,1813,70,31,3,28,.903,3924000,0
37575,17012,645,0,0,0,0,.00nan,0,0
37575,41337,645,68,40,4,36,.900,3924000,0
37575,53815,1813,0,0,0,0,.00nan,0,0
37576,13490,650,97,25,0,25,1000,3600000,0
37576,16915,650,0,0,0,0,.00nan,0,0
37576,19101,3717,64,28,3,25,.893,3600000,0
37576,49081,3717,0,0,0,0,.00nan,0,0
37577,7446,647,0,0,0,0,.00nan,0,0
37577,11829,1827,48,6,1,5,.833,1201000,0
37577,14946,647,69,20,1,19,.950,3600000,0
37577,15048,1827,21,23,6,17,.739,2399000,0
37578,17580,640,0,0,0,0,.00nan,0,0
37578,18310,644,0,0,0,0,.00nan,0,0
37578,21418,644,70,21,1,20,.952,3600000,0
37578,143946,640,80,38,3,35,.921,3600000,0
37579,1635,1814,0,0,0,0,.00nan,0,0
37579,21492,1847,0,0,0,0,.00nan,0,0
37579,41062,1814,61,16,1,15,.938,3600000,0
37579,41133,1847,40,39,6,33,.846,3600000,0
37580,9591,1813,57,30,4,26,.867,3600000,0
37580,13490,650,81,12,0,12,1000,3600000,0
37580,16915,650,0,0,0,0,.00nan,0,0
37580,53815,1813,0,0,0,0,.00nan,0,0
37581,19101,3717,78,33,3,30,.909,4007000,0
37581,32042,1818,88,40,4,36,.900,3974000,0
37581,32797,1818,0,0,0,0,.00nan,0,0
37581,49081,3717,0,0,0,0,.00nan,0,0
37582,8761,637,80,42,3,39,.929,3543000,0
37582,9702,637,0,0,0,0,.00nan,0,0
37582,11083,639,79,28,2,26,.929,3600000,0
37582,60309,639,0,0,0,0,.00nan,0,0
37583,1635,1814,57,18,2,16,.889,3600000,0
37583,32042,1818,66,31,3,28,.903,3600000,0
37583,32797,1818,0,0,0,0,.00nan,0,0
37583,41062,1814,0,0,0,0,.00nan,0,0
37584,9591,1813,76,29,2,27,.931,3600000,0
37584,18310,644,0,0,0,0,.00nan,0,0
37584,21418,644,55,24,3,21,.875,3600000,0
37584,53815,1813,0,0,0,0,.00nan,0,0
37585,8761,637,48,27,4,23,.852,3600000,0
37585,9702,637,0,0,0,0,.00nan,0,0
37585,19101,3717,73,22,1,21,.955,3600000,0
37585,49081,3717,0,0,0,0,.00nan,0,0
37586,11973,648,0,0,0,0,.00nan,0,0
37586,21492,1847,23,24,6,18,.750,3517000,0
37586,41133,1847,0,0,0,0,.00nan,0,0
37586,41387,648,78,40,4,36,.900,3600000,0
37587,11829,1827,0,0,0,0,.00nan,0,0
37587,15048,1827,86,37,2,35,.946,3709000,0
37587,17580,640,67,34,3,31,.912,3709000,0
37587,143946,640,0,0,0,0,.00nan,0,0
37588,11083,639,55,41,6,35,.854,3542000,0
37588,17012,645,0,0,0,0,.00nan,0,0
37588,41337,645,52,35,5,30,.857,3600000,0
37588,60309,639,0,0,0,0,.00nan,0,0
37589,7446,647,63,38,4,34,.895,3600000,0
37589,13490,650,91,21,0,21,1000,3600000,0
37589,14946,647,0,0,0,0,.00nan,0,0
37589,16915,650,0,0,0,0,.00nan,0,0
37590,7446,647,94,34,1,33,.971,3600000,0
37590,14946,647,0,0,0,0,.00nan,0,0
37590,18310,644,0,0,0,0,.00nan,0,0
37590,21418,644,59,30,3,27,.900,3513000,0
37591,17580,640,0,0,0,0,.00nan,0,0
37591,32042,1818,68,22,2,20,.909,3600000,0
37591,32797,1818,0,0,0,0,.00nan,0,0
37591,143946,640,52,23,3,20,.870,3597000,0
37592,1635,1814,0,0,0,0,.00nan,0,0
37592,17012,645,0,0,0,0,.00nan,0,0
37592,41062,1814,69,22,2,20,.909,3600000,0
37592,41337,645,64,35,4,31,.886,3566000,0
37593,9591,1813,61,34,3,31,.912,3600000,0
37593,9702,637,53,28,4,24,.857,3562000,0
37593,17505,637,0,0,0,0,.00nan,0,0
37593,53815,1813,0,0,0,0,.00nan,0,0
37594,19101,3717,73,33,3,30,.909,3600000,0
37594,21492,1847,62,35,4,31,.886,3568000,0
37594,41133,1847,0,0,0,0,.00nan,0,0
37594,49081,3717,0,0,0,0,.00nan,0,0
37595,11083,639,0,0,0,0,.00nan,0,0
37595,13490,650,84,35,2,33,.943,3659000,0
37595,16915,650,0,0,0,0,.00nan,0,0
37595,60309,639,96,33,1,32,.970,3659000,0
37596,18310,644,0,0,0,0,.00nan,0,0
37596,21418,644,64,18,2,16,.889,3600000,0
37596,32042,1818,59,35,4,31,.886,3541000,0
37596,32797,1818,0,0,0,0,.00nan,0,0
37597,7446,647,65,25,2,23,.920,3600000,0
37597,11973,648,0,0,0,0,.00nan,0,0
37597,14946,647,0,0,0,0,.00nan,0,0
37597,41387,648,36,34,6,28,.824,3600000,0
37598,9702,637,59,30,3,27,.900,3600000,0
37598,17505,637,0,0,0,0,.00nan,0,0
37598,17580,640,59,37,4,33,.892,3559000,0
37598,143946,640,0,0,0,0,.00nan,0,0
37599,9591,1813,64,37,3,34,.919,3600000,0
37599,21492,1847,78,22,1,21,.955,3600000,0
37599,41133,1847,0,0,0,0,.00nan,0,0
37599,53815,1813,0,0,0,0,.00nan,0,0
37600,11083,639,0,0,0,0,.00nan,0,0
37600,19101,3717,70,47,4,43,.915,4437000,0
37600,49081,3717,0,0,0,0,.00nan,0,0
37600,60309,639,47,26,3,23,.885,4437000,0
37601,11829,1827,0,0,0,0,.00nan,0,0
37601,15048,1827,48,36,5,31,.861,3561000,0
37601,17012,645,52,27,4,23,.852,3600000,0
37601,41337,645,0,0,0,0,.00nan,0,0
37602,1635,1814,27,27,6,21,.778,3212000,0
37602,13490,650,0,0,0,0,.00nan,0,0
37602,16915,650,55,23,3,20,.870,3600000,0
37602,41062,1814,54,3,0,3,1000,388000,0
37603,17012,645,0,0,0,0,.00nan,0,0
37603,18310,644,89,36,2,34,.944,3937000,0
37603,21418,644,0,0,0,0,.00nan,0,0
37603,41337,645,82,27,1,26,.963,3937000,0
37604,13490,650,49,22,3,19,.864,3600000,0
37604,16915,650,0,0,0,0,.00nan,0,0
37604,17580,640,0,0,0,0,.00nan,0,0
37604,143946,640,51,37,6,31,.838,3600000,0
37605,1635,1814,55,17,2,15,.882,3600000,0
37605,19101,3717,26,13,4,9,.692,841000,0
37605,41062,1814,0,0,0,0,.00nan,0,0
37605,49081,3717,48,27,4,23,.852,2759000,0
37606,7446,647,0,0,0,0,.00nan,0,0
37606,9591,1813,71,29,3,26,.897,3545000,0
37606,14946,647,52,15,2,13,.867,3600000,0
37606,53815,1813,0,0,0,0,.00nan,0,0
37607,9702,637,58,20,2,18,.900,3806000,0
37607,11829,1827,0,0,0,0,.00nan,0,0
37607,15048,1827,94,39,3,36,.923,3806000,0
37607,17505,637,0,0,0,0,.00nan,0,0
37608,11083,639,60,21,2,19,.905,3600000,0
37608,21492,1847,0,0,0,0,.00nan,0,0
37608,41133,1847,59,29,4,25,.862,3571000,0
37608,60309,639,0,0,0,0,.00nan,0,0
37609,19101,3717,100,25,0,25,1000,3600000,0
37609,32042,1818,49,35,5,30,.857,3600000,0
37609,32797,1818,0,0,0,0,.00nan,0,0
37609,49081,3717,0,0,0,0,.00nan,0,0
37610,17580,640,67,31,3,28,.903,3513000,0
37610,18310,644,0,0,0,0,.00nan,0,0
37610,21418,644,72,22,1,21,.955,3600000,0
37610,143946,640,0,0,0,0,.00nan,0,0
37611,8761,637,0,0,0,0,.00nan,0,0
37611,9702,637,47,29,4,25,.862,3600000,0
37611,11083,639,70,20,1,19,.950,3600000,0
37611,60309,639,0,0,0,0,.00nan,0,0
37612,1635,1814,0,0,0,0,.00nan,0,0
37612,21492,1847,99,39,1,38,.974,3600000,0
37612,41062,1814,43,20,4,16,.800,3600000,0
37612,41133,1847,0,0,0,0,.00nan,0,0
37613,7446,647,0,0,0,0,.00nan,0,0
37613,11829,1827,0,0,0,0,.00nan,0,0
37613,14946,647,70,34,3,31,.912,3600000,0
37613,15048,1827,54,30,4,26,.867,3583000,0
37614,11973,648,0,0,0,0,.00nan,0,0
37614,17012,645,0,0,0,0,.00nan,0,0
37614,41337,645,87,17,0,17,1000,3600000,0
37614,41387,648,56,30,4,26,.867,3600000,0
37615,9591,1813,70,32,2,30,.938,3600000,0
37615,13490,650,98,37,1,36,.973,3600000,0
37615,16915,650,0,0,0,0,.00nan,0,0
37615,53815,1813,0,0,0,0,.00nan,0,0
37616,11829,1827,61,21,2,19,.905,3600000,0
37616,15048,1827,0,0,0,0,.00nan,0,0
37616,32042,1818,35,30,6,24,.800,3600000,0
37616,32797,1818,0,0,0,0,.00nan,0,0
37617,7446,647,54,31,4,27,.871,3600000,0
37617,8761,637,0,0,0,0,.00nan,0,0
37617,9702,637,55,17,2,15,.882,3600000,0
37617,14946,647,0,0,0,0,.00nan,0,0
37618,11083,639,60,36,4,32,.889,3600000,0
37618,17580,640,68,20,1,19,.950,3600000,0
37618,60309,639,0,0,0,0,.00nan,0,0
37618,143946,640,0,0,0,0,.00nan,0,0
37619,1635,1814,54,31,4,27,.871,3600000,0
37619,11973,648,14,21,6,15,.714,2581000,0
37619,41062,1814,0,0,0,0,.00nan,0,0
37619,41387,648,37,6,2,4,.667,1019000,0
37620,18310,644,53,29,4,25,.862,3600000,0
37620,21418,644,0,0,0,0,.00nan,0,0
37620,21492,1847,88,19,0,19,1000,3600000,0
37620,41133,1847,0,0,0,0,.00nan,0,0
37621,9591,1813,50,33,4,29,.879,4772000,0
37621,19101,3717,93,59,3,56,.949,4772000,0
37621,49081,3717,0,0,0,0,.00nan,0,0
37621,53815,1813,0,0,0,0,.00nan,0,0
37622,13490,650,74,34,4,30,.882,3759000,0
37622,16915,650,0,0,0,0,.00nan,0,0
37622,17012,645,0,0,0,0,.00nan,0,0
37622,41337,645,78,50,5,45,.900,3759000,0
37623,13490,650,54,19,3,16,.842,3600000,0
37623,16915,650,0,0,0,0,.00nan,0,0
37623,18310,644,0,0,0,0,.00nan,0,0
37623,21418,644,65,37,4,33,.892,3548000,0
37624,8761,637,49,22,3,19,.864,3600000,0
37624,9702,637,0,0,0,0,.00nan,0,0
37624,32042,1818,12,27,7,20,.741,3600000,0
37624,32797,1818,0,0,0,0,.00nan,0,0
37625,9591,1813,0,0,0,0,.00nan,0,0
37625,17580,640,93,21,0,21,1000,3600000,0
37625,53815,1813,82,28,1,27,.964,3561000,0
37625,143946,640,0,0,0,0,.00nan,0,0
37626,11829,1827,69,29,3,26,.897,3600000,0
37626,15048,1827,0,0,0,0,.00nan,0,0
37626,21492,1847,11,18,6,12,.667,2945000,0
37626,41133,1847,65,10,0,10,1000,655000,0
37627,7446,647,46,25,4,21,.840,3600000,0
37627,14946,647,0,0,0,0,.00nan,0,0
37627,17012,645,0,0,0,0,.00nan,0,0
37627,41337,645,91,33,1,32,.970,3600000,0
37628,1635,1814,0,0,0,0,.00nan,0,0
37628,11083,639,100,43,1,42,.977,3687000,0
37628,41062,1814,77,26,2,24,.923,3687000,0
37628,60309,639,0,0,0,0,.00nan,0,0
37629,21492,1847,45,28,5,23,.821,3600000,0
37629,32042,1818,0,0,0,0,.00nan,0,0
37629,32797,1818,100,22,0,22,1000,3600000,0
37629,41133,1847,0,0,0,0,.00nan,0,0
37630,7446,647,74,32,2,30,.938,3545000,0
37630,11083,639,77,23,1,22,.957,3600000,0
37630,14946,647,0,0,0,0,.00nan,0,0
37630,60309,639,0,0,0,0,.00nan,0,0
37631,8761,637,54,29,4,25,.862,4385000,0
37631,9702,637,0,0,0,0,.00nan,0,0
37631,17012,645,0,0,0,0,.00nan,0,0
37631,41337,645,57,28,3,25,.893,4385000,0
37632,1635,1814,46,30,4,26,.867,5051000,0
37632,18310,644,0,0,0,0,.00nan,0,0
37632,21418,644,64,27,3,24,.889,5070000,0
37632,41062,1814,0,0,0,0,.00nan,0,0
37633,17580,640,43,24,4,20,.833,3600000,0
37633,19101,3717,100,28,0,28,1000,3600000,0
37633,49081,3717,0,0,0,0,.00nan,0,0
37633,143946,640,0,0,0,0,.00nan,0,0
37634,11829,1827,79,26,2,24,.923,3600000,0
37634,13490,650,0,0,0,0,.00nan,0,0
37634,15048,1827,0,0,0,0,.00nan,0,0
37634,16915,650,48,22,3,19,.864,3600000,0
37635,8761,637,0,0,0,0,.00nan,0,0
37635,9702,637,30,29,6,23,.793,4761000,0
37635,18310,644,31,39,7,32,.821,4761000,0
37635,21418,644,0,0,0,0,.00nan,0,0
37636,7446,647,0,0,0,0,.00nan,0,0
37636,14946,647,84,36,2,34,.944,3600000,0
37636,17580,640,26,31,6,25,.806,2858000,0
37636,143946,640,46,5,1,4,.800,742000,0
37637,1635,1814,0,0,0,0,.00nan,0,0
37637,9591,1813,53,32,4,28,.875,3558000,0
37637,41062,1814,60,31,3,28,.903,3600000,0
37637,53815,1813,0,0,0,0,.00nan,0,0
37638,13490,650,0,0,0,0,.00nan,0,0
37638,16915,650,70,27,2,25,.926,3600000,0
37638,21492,1847,0,0,0,0,.00nan,0,0
37638,41133,1847,60,29,3,26,.897,3546000,0
37639,11829,1827,0,0,0,0,.00nan,0,0
37639,15048,1827,65,39,4,35,.897,3600000,0
37639,19101,3717,67,23,1,22,.957,3600000,0
37639,49081,3717,0,0,0,0,.00nan,0,0
37640,17012,645,87,27,1,26,.963,2706000,0
37640,32042,1818,0,0,0,0,.00nan,0,0
37640,32797,1818,82,25,2,23,.920,3600000,0
37640,41337,645,16,8,4,4,.500,894000,0
37641,11083,639,59,29,3,26,.897,3558000,0
37641,11973,648,0,0,0,0,.00nan,0,0
37641,41387,648,78,25,2,23,.920,3600000,0
37641,60309,639,0,0,0,0,.00nan,0,0
37642,1635,1814,0,0,0,0,.00nan,0,0
37642,7446,647,80,49,5,44,.898,3558000,0
37642,14946,647,0,0,0,0,.00nan,0,0
37642,41062,1814,61,27,3,24,.889,3600000,0
37643,9591,1813,81,30,2,28,.933,3600000,0
37643,11083,639,38,21,4,17,.810,3534000,0
37643,53815,1813,0,0,0,0,.00nan,0,0
37643,60309,639,0,0,0,0,.00nan,0,0
37644,8761,637,0,0,0,0,.00nan,0,0
37644,9702,637,55,28,4,24,.857,3600000,0
37644,21492,1847,100,32,0,32,1000,3600000,0
37644,41133,1847,0,0,0,0,.00nan,0,0
37645,11829,1827,82,46,3,43,.935,3568000,0
37645,15048,1827,0,0,0,0,.00nan,0,0
37645,18310,644,0,0,0,0,.00nan,0,0
37645,21418,644,81,23,1,22,.957,3600000,0
37646,17012,645,0,0,0,0,.00nan,0,0
37646,19101,3717,50,15,2,13,.867,3541000,0
37646,41337,645,75,24,1,23,.958,3600000,0
37646,49081,3717,0,0,0,0,.00nan,0,0
37647,11973,648,54,4,0,4,1000,311000,0
37647,17580,640,56,32,4,28,.875,3600000,0
37647,41387,648,22,24,7,17,.708,3289000,0
37647,143946,640,0,0,0,0,.00nan,0,0
37648,13490,650,89,18,0,18,1000,3600000,0
37648,16915,650,0,0,0,0,.00nan,0,0
37648,32042,1818,69,26,2,24,.923,3513000,0
37648,32797,1818,0,0,0,0,.00nan,0,0
37649,9591,1813,88,30,1,29,.967,3600000,0
37649,32042,1818,71,30,2,28,.933,3581000,0
37649,32797,1818,0,0,0,0,.00nan,0,0
37649,53815,1813,0,0,0,0,.00nan,0,0
37650,11973,648,0,0,0,0,.00nan,0,0
37650,18310,644,0,0,0,0,.00nan,0,0
37650,21418,644,82,38,2,36,.947,5129000,0
37650,41387,648,94,41,1,40,.976,5129000,0
37651,7446,647,76,22,1,21,.955,3600000,0
37651,14946,647,0,0,0,0,.00nan,0,0
37651,19101,3717,57,34,4,30,.882,3600000,0
37651,49081,3717,0,0,0,0,.00nan,0,0
37652,1635,1814,0,0,0,0,.00nan,0,0
37652,17580,640,0,0,0,0,.00nan,0,0
37652,41062,1814,49,31,5,26,.839,3600000,0
37652,143946,640,68,36,3,33,.917,3600000,0
37653,8761,637,0,0,0,0,.00nan,0,0
37653,9702,637,68,24,1,23,.958,3575000,0
37653,13490,650,100,30,0,30,1000,3600000,0
37653,16915,650,0,0,0,0,.00nan,0,0
37654,17012,645,0,0,0,0,.00nan,0,0
37654,21492,1847,82,33,2,31,.939,3600000,0
37654,41133,1847,0,0,0,0,.00nan,0,0
37654,41337,645,53,29,4,25,.862,3591000,0
37655,11083,639,47,30,5,25,.833,3600000,0
37655,11829,1827,95,38,2,36,.947,3600000,0
37655,15048,1827,0,0,0,0,.00nan,0,0
37655,60309,639,0,0,0,0,.00nan,0,0
37656,11973,648,57,24,3,21,.875,3988000,0
37656,17012,645,0,0,0,0,.00nan,0,0
37656,41337,645,68,40,4,36,.900,3988000,0
37656,41387,648,0,0,0,0,.00nan,0,0
37935,11973,648,0,0,0,0,.00nan,0,0
37935,19101,3717,44,37,6,31,.838,3600000,0
37935,41387,648,76,36,3,33,.917,3600000,0
37935,49081,3717,0,0,0,0,.00nan,0,0
37937,8761,637,60,16,2,14,.875,3600000,0
37937,9702,637,0,0,0,0,.00nan,0,0
37937,21492,1847,65,36,4,32,.889,3573000,0
37937,41133,1847,0,0,0,0,.00nan,0,0
37939,13490,650,0,0,0,0,.00nan,0,0
37939,16915,650,68,28,2,26,.929,3600000,0
37939,17580,640,56,37,4,33,.892,3600000,0
37939,143946,640,0,0,0,0,.00nan,0,0
37941,1635,1814,0,0,0,0,.00nan,0,0
37941,18310,644,0,0,0,0,.00nan,0,0
37941,21418,644,78,40,3,37,.925,3559000,0
37941,41062,1814,65,15,1,14,.933,3600000,0
37943,11829,1827,73,31,2,29,.935,3961000,0
37943,15048,1827,0,0,0,0,.00nan,0,0
37943,32042,1818,77,30,3,27,.900,3961000,0
37943,58466,1818,0,0,0,0,.00nan,0,0
37945,11083,639,0,0,0,0,.00nan,0,0
37945,17012,645,53,3,0,3,1000,344000,0
37945,41337,645,37,31,6,25,.806,3256000,0
37945,60309,639,67,19,2,17,.895,3600000,0
37947,7446,647,62,39,5,34,.872,3600000,0
37947,9591,1813,100,22,0,22,1000,3600000,0
37947,14946,647,0,0,0,0,.00nan,0,0
37947,53815,1813,0,0,0,0,.00nan,0,0
37949,1635,1814,90,28,1,27,.964,3600000,0
37949,13490,650,89,42,2,40,.952,3558000,0
37949,16915,650,0,0,0,0,.00nan,0,0
37949,41062,1814,0,0,0,0,.00nan,0,0
37951,17580,640,0,0,0,0,.00nan,0,0
37951,21492,1847,0,0,0,0,.00nan,0,0
37951,41133,1847,52,28,3,25,.893,3575000,0
37951,143946,640,97,36,1,35,.972,3600000,0
37953,7446,647,0,0,0,0,.00nan,0,0
37953,11829,1827,0,0,0,0,.00nan,0,0
37953,14946,647,72,38,4,34,.895,4047000,0
37953,15048,1827,63,29,3,26,.897,4047000,0
37955,11973,648,43,16,3,13,.813,3542000,0
37955,19101,3717,89,35,2,33,.943,3600000,0
37955,41387,648,0,0,0,0,.00nan,0,0
37955,49081,3717,0,0,0,0,.00nan,0,0
37957,11083,639,68,23,2,21,.913,3600000,0
37957,17012,645,52,29,4,25,.862,3568000,0
37957,41337,645,0,0,0,0,.00nan,0,0
37957,60309,639,0,0,0,0,.00nan,0,0
37959,18310,644,61,28,3,25,.893,3564000,0
37959,21418,644,0,0,0,0,.00nan,0,0
37959,32042,1818,0,0,0,0,.00nan,0,0
37959,58466,1818,64,23,2,21,.913,3600000,0
37961,8761,637,0,0,0,0,.00nan,0,0
37961,9591,1813,73,37,3,34,.919,3580000,0
37961,9702,637,69,15,1,14,.933,3600000,0
37961,53815,1813,0,0,0,0,.00nan,0,0
37963,9591,1813,0,0,0,0,.00nan,0,0
37963,18310,644,94,22,0,22,1000,3600000,0
37963,21418,644,0,0,0,0,.00nan,0,0
37963,53815,1813,63,35,4,31,.886,3600000,0
37965,11829,1827,0,0,0,0,.00nan,0,0
37965,15048,1827,90,19,0,19,1000,3600000,0
37965,21492,1847,50,36,5,31,.861,3600000,0
37965,41133,1847,0,0,0,0,.00nan,0,0
37967,13490,650,0,0,0,0,.00nan,0,0
37967,16915,650,79,22,1,21,.955,3600000,0
37967,32042,1818,94,41,2,39,.951,3588000,0
37967,32797,1818,0,0,0,0,.00nan,0,0
37969,1635,1814,0,0,0,0,.00nan,0,0
37969,8761,637,0,0,0,0,.00nan,0,0
37969,9702,637,68,26,2,24,.923,3600000,0
37969,41062,1814,64,30,4,26,.867,3575000,0
37971,7446,647,0,0,0,0,.00nan,0,0
37971,14946,647,77,46,4,42,.913,3600000,0
37971,17012,645,0,0,0,0,.00nan,0,0
37971,41337,645,77,24,1,23,.958,3600000,0
37973,11083,639,47,20,3,17,.850,3678000,0
37973,19101,3717,80,47,4,43,.915,3678000,0
37973,49081,3717,0,0,0,0,.00nan,0,0
37973,60309,639,0,0,0,0,.00nan,0,0
37975,11973,648,0,0,0,0,.00nan,0,0
37975,17580,640,66,34,4,30,.882,3600000,0
37975,41387,648,100,38,1,37,.974,3600000,0
37975,143946,640,0,0,0,0,.00nan,0,0
37977,7446,647,21,11,4,7,.636,1070000,0
37977,14946,647,72,29,2,27,.931,2530000,0
37977,19101,3717,0,0,0,0,.00nan,0,0
37977,49081,3717,97,27,0,27,1000,3600000,0
37979,8761,637,54,21,3,18,.857,3600000,0
37979,9591,1813,72,42,4,38,.905,3552000,0
37979,9702,637,0,0,0,0,.00nan,0,0
37979,53815,1813,0,0,0,0,.00nan,0,0
37981,17012,645,0,0,0,0,.00nan,0,0
37981,32042,1818,0,0,0,0,.00nan,0,0
37981,32797,1818,62,28,2,26,.929,3545000,0
37981,41337,645,81,26,1,25,.962,3600000,0
37983,11829,1827,0,0,0,0,.00nan,0,0
37983,15048,1827,95,48,3,45,.938,3554000,0
37983,18310,644,0,0,0,0,.00nan,0,0
37983,21418,644,46,12,2,10,.833,3600000,0
37985,13490,650,64,17,1,16,.941,3600000,0
37985,16915,650,0,0,0,0,.00nan,0,0
37985,21492,1847,0,0,0,0,.00nan,0,0
37985,41133,1847,94,42,2,40,.952,3600000,0
37987,11083,639,0,0,0,0,.00nan,0,0
37987,11973,648,17,9,4,5,.556,884000,0
37987,41387,648,67,20,1,19,.950,2712000,0
37987,60309,639,57,25,3,22,.880,3600000,0
37989,1635,1814,67,24,2,22,.917,3537000,0
37989,17580,640,0,0,0,0,.00nan,0,0
37989,41062,1814,0,0,0,0,.00nan,0,0
37989,143946,640,100,43,0,43,1000,3600000,0
37991,8761,637,0,0,0,0,.00nan,0,0
37991,9591,1813,0,0,0,0,.00nan,0,0
37991,9702,637,83,27,1,26,.963,3600000,0
37991,53815,1813,67,33,3,30,.909,3599000,0
37993,11083,639,0,0,0,0,.00nan,0,0
37993,13490,650,0,0,0,0,.00nan,0,0
37993,16915,650,70,28,2,26,.929,3553000,0
37993,60309,639,76,25,1,24,.960,3600000,0
37995,7446,647,54,21,2,19,.905,3596000,0
37995,11829,1827,80,26,1,25,.962,3600000,0
37995,14946,647,0,0,0,0,.00nan,0,0
37995,15048,1827,0,0,0,0,.00nan,0,0
37997,17580,640,0,0,0,0,.00nan,0,0
37997,18310,644,55,28,3,25,.893,3546000,0
37997,21418,644,0,0,0,0,.00nan,0,0
37997,143946,640,93,39,2,37,.949,3600000,0
37999,19101,3717,0,0,0,0,.00nan,0,0
37999,21492,1847,74,24,1,23,.958,3600000,0
37999,41133,1847,0,0,0,0,.00nan,0,0
37999,49081,3717,50,28,4,24,.857,3600000,0
38001,1635,1814,0,0,0,0,.00nan,0,0
38001,11973,648,0,0,0,0,.00nan,0,0
38001,41062,1814,82,31,2,29,.935,3600000,0
38001,41387,648,57,36,4,32,.889,3523000,0
38003,17012,645,0,0,0,0,.00nan,0,0
38003,32042,1818,50,29,4,25,.862,3583000,0
38003,32797,1818,0,0,0,0,.00nan,0,0
38003,41337,645,39,17,3,14,.824,3600000,0
38005,7446,647,0,0,0,0,.00nan,0,0
38005,14946,647,61,21,2,19,.905,3600000,0
38005,32042,1818,60,38,5,33,.868,3600000,0
38005,32797,1818,0,0,0,0,.00nan,0,0
38007,11973,648,64,31,4,27,.871,3582000,0
38007,19101,3717,76,31,2,29,.935,3600000,0
38007,41387,648,0,0,0,0,.00nan,0,0
38007,49081,3717,0,0,0,0,.00nan,0,0
38009,9591,1813,66,26,2,24,.923,3600000,0
38009,17012,645,0,0,0,0,.00nan,0,0
38009,41337,645,64,35,4,31,.886,3530000,0
38009,53815,1813,0,0,0,0,.00nan,0,0
38011,11083,639,46,28,5,23,.821,3600000,0
38011,21492,1847,74,30,2,28,.933,3600000,0
38011,41133,1847,0,0,0,0,.00nan,0,0
38011,60309,639,0,0,0,0,.00nan,0,0
38013,1635,1814,61,23,3,20,.870,3600000,0
38013,18310,644,0,0,0,0,.00nan,0,0
38013,21418,644,45,30,4,26,.867,3545000,0
38013,41062,1814,0,0,0,0,.00nan,0,0
38015,8761,637,75,24,1,23,.958,3600000,0
38015,9702,637,0,0,0,0,.00nan,0,0
38015,17580,640,57,31,4,27,.871,3600000,0
38015,143946,640,0,0,0,0,.00nan,0,0
38017,11829,1827,0,0,0,0,.00nan,0,0
38017,13490,650,60,14,1,13,.929,3600000,0
38017,15048,1827,96,44,2,42,.955,3600000,0
38017,16915,650,0,0,0,0,.00nan,0,0
38019,7446,647,71,35,4,31,.886,3536000,0
38019,11829,1827,65,21,2,19,.905,3600000,0
38019,14946,647,0,0,0,0,.00nan,0,0
38019,15048,1827,0,0,0,0,.00nan,0,0
38021,11083,639,0,0,0,0,.00nan,0,0
38021,32042,1818,0,0,0,0,.00nan,0,0
38021,32797,1818,73,25,1,24,.960,3552000,0
38021,60309,639,100,32,0,32,1000,3600000,0
38023,18310,644,69,25,2,23,.920,3600000,0
38023,19101,3717,0,0,0,0,.00nan,0,0
38023,21418,644,0,0,0,0,.00nan,0,0
38023,49081,3717,31,28,5,23,.821,3600000,0
38025,9591,1813,0,0,0,0,.00nan,0,0
38025,17012,645,0,0,0,0,.00nan,0,0
38025,41337,645,94,31,1,30,.968,3600000,0
38025,53815,1813,57,22,2,20,.909,3586000,0
38027,1635,1814,0,0,0,0,.00nan,0,0
38027,21492,1847,0,0,0,0,.00nan,0,0
38027,41062,1814,80,38,4,34,.895,3999000,0
38027,41133,1847,49,35,5,30,.857,3999000,0
38029,8761,637,0,0,0,0,.00nan,0,0
38029,9702,637,93,20,0,20,1000,3600000,0
38029,11973,648,0,0,0,0,.00nan,0,0
38029,41387,648,66,31,3,28,.903,3600000,0
38031,13490,650,0,0,0,0,.00nan,0,0
38031,16915,650,82,33,1,32,.970,3600000,0
38031,17580,640,0,0,0,0,.00nan,0,0
38031,143946,640,66,25,2,23,.920,3600000,0
38032,10355,846,0,0,0,0,.00nan,0,0
38032,11561,841,99,29,0,29,1000,3600000,0
38032,16413,846,77,27,1,26,.963,3600000,0
38032,45918,841,0,0,0,0,.00nan,0,0
38033,5824,847,0,0,0,0,.00nan,0,0
38033,6095,849,32,26,5,21,.808,3600000,0
38033,46051,849,0,0,0,0,.00nan,0,0
38033,53346,847,80,26,1,25,.962,3600000,0
38034,5162,2488,0,0,0,0,.00nan,0,0
38034,11762,2493,90,40,2,38,.950,3743000,0
38034,15510,2493,0,0,0,0,.00nan,0,0
38034,32158,2488,53,20,3,17,.850,3743000,0
38035,1319,843,85,34,2,32,.941,3600000,0
38035,6571,842,0,0,0,0,.00nan,0,0
38035,30703,842,68,34,3,31,.912,3600000,0
38035,44500,843,0,0,0,0,.00nan,0,0
38036,8523,845,0,0,0,0,.00nan,0,0
38036,16629,2517,0,0,0,0,.00nan,0,0
38036,32604,845,68,50,5,45,.900,3600000,0
38036,45924,2517,60,15,1,14,.933,3600000,0
38037,6095,849,0,0,0,0,.00nan,0,0
38037,6571,842,63,30,3,27,.900,3900000,0
38037,30703,842,0,0,0,0,.00nan,0,0
38037,46051,849,72,34,3,31,.912,3900000,0
38038,5824,847,71,35,3,32,.914,3564000,0
38038,8523,845,73,28,2,26,.929,3600000,0
38038,32604,845,0,0,0,0,.00nan,0,0
38038,53346,847,0,0,0,0,.00nan,0,0
38039,1319,843,0,0,0,0,.00nan,0,0
38039,11561,841,73,23,2,21,.913,3900000,0
38039,44500,843,92,37,2,35,.946,3900000,0
38039,45918,841,0,0,0,0,.00nan,0,0
38040,5162,2488,74,29,2,27,.931,3556000,0
38040,10355,846,66,18,1,17,.944,3600000,0
38040,16413,846,0,0,0,0,.00nan,0,0
38040,32158,2488,0,0,0,0,.00nan,0,0
38041,11762,2493,70,20,1,19,.950,3600000,0
38041,15510,2493,0,0,0,0,.00nan,0,0
38041,16629,2517,61,28,3,25,.893,3514000,0
38041,45924,2517,0,0,0,0,.00nan,0,0
38042,6095,849,40,25,5,20,.800,2211000,0
38042,11561,841,0,0,0,0,.00nan,0,0
38042,45918,841,63,25,2,23,.920,3600000,0
38042,46051,849,81,22,0,22,1000,1389000,0
38043,8523,845,0,0,0,0,.00nan,0,0
38043,11762,2493,65,40,4,36,.900,3596000,0
38043,15510,2493,0,0,0,0,.00nan,0,0
38043,32604,845,84,40,3,37,.925,3600000,0
38044,5824,847,0,0,0,0,.00nan,0,0
38044,6571,842,0,0,0,0,.00nan,0,0
38044,30703,842,68,33,3,30,.909,3600000,0
38044,53346,847,60,45,4,41,.911,3600000,0
38045,1319,843,91,32,1,31,.969,3600000,0
38045,5162,2488,0,0,0,0,.00nan,0,0
38045,32158,2488,68,31,3,28,.903,3530000,0
38045,44500,843,0,0,0,0,.00nan,0,0
38046,10355,846,78,37,2,35,.946,3547000,0
38046,16413,846,0,0,0,0,.00nan,0,0
38046,16629,2517,0,0,0,0,.00nan,0,0
38046,45924,2517,74,21,1,20,.952,3600000,0
38047,6095,849,84,36,2,34,.944,3600000,0
38047,8523,845,0,0,0,0,.00nan,0,0
38047,32604,845,43,26,4,22,.846,3548000,0
38047,46051,849,0,0,0,0,.00nan,0,0
38048,1319,843,0,0,0,0,.00nan,0,0
38048,16629,2517,0,0,0,0,.00nan,0,0
38048,44500,843,31,30,5,25,.833,3600000,0
38048,45924,2517,76,25,1,24,.960,3600000,0
38049,5162,2488,0,0,0,0,.00nan,0,0
38049,6571,842,0,0,0,0,.00nan,0,0
38049,30703,842,100,37,0,37,1000,3600000,0
38049,32158,2488,53,21,3,18,.857,3600000,0
38050,5824,847,0,0,0,0,.00nan,0,0
38050,10355,846,45,18,3,15,.833,3600000,0
38050,16413,846,0,0,0,0,.00nan,0,0
38050,53346,847,78,36,4,32,.889,3586000,0
38051,11561,841,88,31,2,29,.935,3900000,0
38051,11762,2493,69,32,2,30,.938,3900000,0
38051,15510,2493,0,0,0,0,.00nan,0,0
38051,45918,841,0,0,0,0,.00nan,0,0
38052,6095,849,90,31,2,29,.935,3900000,0
38052,43348,843,0,0,0,0,.00nan,0,0
38052,44500,843,97,45,2,43,.956,3900000,0
38052,46051,849,0,0,0,0,.00nan,0,0
38053,8523,845,0,0,0,0,.00nan,0,0
38053,10355,846,63,23,2,21,.913,3900000,0
38053,16413,846,0,0,0,0,.00nan,0,0
38053,32604,845,86,37,2,35,.946,3900000,0
38054,5824,847,0,0,0,0,.00nan,0,0
38054,11762,2493,68,44,5,39,.886,3600000,0
38054,15510,2493,0,0,0,0,.00nan,0,0
38054,53346,847,100,26,0,26,1000,3600000,0
38055,5162,2488,87,25,1,24,.960,3600000,0
38055,11561,841,55,19,2,17,.895,3600000,0
38055,32158,2488,0,0,0,0,.00nan,0,0
38055,45918,841,0,0,0,0,.00nan,0,0
38056,6571,842,0,0,0,0,.00nan,0,0
38056,16629,2517,78,25,1,24,.960,3600000,0
38056,30703,842,68,34,3,31,.912,3600000,0
38056,45924,2517,0,0,0,0,.00nan,0,0
38057,5824,847,0,0,0,0,.00nan,0,0
38057,11561,841,0,0,0,0,.00nan,0,0
38057,45918,841,71,23,1,22,.957,3600000,0
38057,53346,847,97,64,2,62,.969,3600000,0
38058,13577,2488,55,4,0,4,1000,256000,0
38058,16629,2517,50,18,3,15,.833,3600000,0
38058,32158,2488,15,29,7,22,.759,3344000,0
38058,45924,2517,0,0,0,0,.00nan,0,0
38059,8523,845,0,0,0,0,.00nan,0,0
38059,32604,845,48,21,4,17,.810,3900000,0
38059,43348,843,0,0,0,0,.00nan,0,0
38059,44500,843,57,29,4,25,.862,3900000,0
38060,6571,842,0,0,0,0,.00nan,0,0
38060,10355,846,50,28,3,25,.893,3900000,0
38060,16413,846,0,0,0,0,.00nan,0,0
38060,30703,842,69,35,3,32,.914,3900000,0
38061,6095,849,37,30,6,24,.800,3600000,0
38061,11762,2493,86,40,3,37,.925,3600000,0
38061,15510,2493,0,0,0,0,.00nan,0,0
38061,46051,849,0,0,0,0,.00nan,0,0
38062,10355,846,0,0,0,0,.00nan,0,0
38062,11762,2493,75,26,1,25,.962,3593000,0
38062,15510,2493,0,0,0,0,.00nan,0,0
38062,16413,846,100,25,0,25,1000,3600000,0
38063,11561,841,100,25,0,25,1000,3600000,0
38063,16629,2517,0,0,0,0,.00nan,0,0
38063,45918,841,0,0,0,0,.00nan,0,0
38063,45924,2517,70,29,2,27,.931,3528000,0
38064,6095,849,0,0,0,0,.00nan,0,0
38064,13577,2488,0,0,0,0,.00nan,0,0
38064,32158,2488,46,27,4,23,.852,3600000,0
38064,46051,849,84,27,1,26,.963,3600000,0
38065,6571,842,0,0,0,0,.00nan,0,0
38065,8523,845,0,0,0,0,.00nan,0,0
38065,30703,842,46,21,3,18,.857,3597000,0
38065,32604,845,88,30,1,29,.967,3600000,0
38066,5824,847,0,0,0,0,.00nan,0,0
38066,43348,843,0,0,0,0,.00nan,0,0
38066,44500,843,35,19,4,15,.789,3575000,0
38066,53346,847,86,35,2,33,.943,3600000,0
38067,8523,845,0,0,0,0,.00nan,0,0
38067,11561,841,98,16,0,16,1000,3600000,0
38067,32604,845,98,40,1,39,.975,3554000,0
38067,45918,841,0,0,0,0,.00nan,0,0
38068,5824,847,0,0,0,0,.00nan,0,0
38068,13577,2488,90,28,1,27,.964,3170000,0
38068,32158,2488,26,5,3,2,.400,430000,0
38068,53346,847,42,27,5,22,.815,3545000,0
38069,10355,846,0,0,0,0,.00nan,0,0
38069,16413,846,76,31,2,29,.935,3600000,0
38069,43348,843,0,0,0,0,.00nan,0,0
38069,44500,843,84,36,3,33,.917,3600000,0
38070,6571,842,86,22,1,21,.955,3900000,0
38070,11762,2493,97,47,1,46,.979,3900000,0
38070,15510,2493,0,0,0,0,.00nan,0,0
38070,30703,842,0,0,0,0,.00nan,0,0
38071,6095,849,56,29,3,26,.897,3600000,0
38071,16629,2517,43,23,4,19,.826,3600000,0
38071,45924,2517,0,0,0,0,.00nan,0,0
38071,46051,849,0,0,0,0,.00nan,0,0
38072,8523,845,0,0,0,0,.00nan,0,0
38072,13577,2488,0,0,0,0,.00nan,0,0
38072,32158,2488,42,25,4,21,.840,3600000,0
38072,32604,845,100,38,1,37,.974,3600000,0
38073,5824,847,0,0,0,0,.00nan,0,0
38073,16629,2517,0,0,0,0,.00nan,0,0
38073,45924,2517,31,23,5,18,.783,3600000,0
38073,53346,847,100,31,0,31,1000,3600000,0
38074,6571,842,0,0,0,0,.00nan,0,0
38074,11561,841,74,30,2,28,.933,3784000,0
38074,30703,842,83,46,3,43,.935,3784000,0
38074,45918,841,0,0,0,0,.00nan,0,0
38075,6095,849,0,0,0,0,.00nan,0,0
38075,10355,846,94,40,2,38,.950,3600000,0
38075,16413,846,0,0,0,0,.00nan,0,0
38075,46051,849,75,40,3,37,.925,3589000,0
38076,11762,2493,50,28,4,24,.857,3548000,0
38076,15510,2493,0,0,0,0,.00nan,0,0
38076,43348,843,0,0,0,0,.00nan,0,0
38076,44500,843,78,32,3,29,.906,3600000,0
38077,6095,849,70,31,2,29,.935,3600000,0
38077,11561,841,79,25,1,24,.960,3600000,0
38077,45918,841,0,0,0,0,.00nan,0,0
38077,46051,849,0,0,0,0,.00nan,0,0
38078,10355,846,48,35,5,30,.857,3569000,0
38078,16413,846,0,0,0,0,.00nan,0,0
38078,16629,2517,32,18,4,14,.778,3600000,0
38078,45924,2517,0,0,0,0,.00nan,0,0
38079,13577,2488,0,0,0,0,.00nan,0,0
38079,32158,2488,70,22,2,20,.909,3600000,0
38079,43348,843,0,0,0,0,.00nan,0,0
38079,44500,843,40,32,5,27,.844,3600000,0
38080,5824,847,0,0,0,0,.00nan,0,0
38080,6571,842,0,0,0,0,.00nan,0,0
38080,30703,842,63,28,3,25,.893,3579000,0
38080,53346,847,88,31,1,30,.968,3600000,0
38081,8523,845,0,0,0,0,.00nan,0,0
38081,11762,2493,0,0,0,0,.00nan,0,0
38081,15510,2493,46,38,5,33,.868,3600000,0
38081,32604,845,86,32,2,30,.938,3600000,0
38082,16629,2517,72,24,1,23,.958,3600000,0
38082,43348,843,0,0,0,0,.00nan,0,0
38082,44500,843,56,31,4,27,.871,3600000,0
38082,45924,2517,0,0,0,0,.00nan,0,0
38083,6571,842,0,0,0,0,.00nan,0,0
38083,13577,2488,57,28,4,24,.857,3600000,0
38083,30703,842,66,41,5,36,.878,3566000,0
38083,32158,2488,0,0,0,0,.00nan,0,0
38084,6095,849,0,0,0,0,.00nan,0,0
38084,8523,845,0,0,0,0,.00nan,0,0
38084,32604,845,87,34,2,32,.941,3556000,0
38084,46051,849,64,18,1,17,.944,3600000,0
38085,5824,847,0,0,0,0,.00nan,0,0
38085,10355,846,61,32,4,28,.875,3600000,0
38085,16413,846,0,0,0,0,.00nan,0,0
38085,53346,847,59,38,5,33,.868,3600000,0
38086,11561,841,0,0,0,0,.00nan,0,0
38086,11762,2493,86,37,2,35,.946,3600000,0
38086,15510,2493,0,0,0,0,.00nan,0,0
38086,45918,841,62,17,1,16,.941,3600000,0
38087,6095,849,83,29,1,28,.966,3900000,0
38087,10355,846,93,31,1,30,.968,3900000,0
38087,16413,846,0,0,0,0,.00nan,0,0
38087,46051,849,0,0,0,0,.00nan,0,0
38088,8523,845,0,0,0,0,.00nan,0,0
38088,13577,2488,0,0,0,0,.00nan,0,0
38088,32158,2488,89,38,3,35,.921,3900000,0
38088,32604,845,75,31,3,28,.903,3900000,0
38089,11762,2493,30,29,6,23,.793,2400000,0
38089,15510,2493,78,19,0,19,1000,1200000,0
38089,43348,843,0,0,0,0,.00nan,0,0
38089,44500,843,74,24,2,22,.917,3600000,0
38090,6571,842,74,23,1,22,.957,3600000,0
38090,11561,841,62,44,5,39,.886,3600000,0
38090,30703,842,0,0,0,0,.00nan,0,0
38090,45918,841,0,0,0,0,.00nan,0,0
38091,5824,847,0,0,0,0,.00nan,0,0
38091,16629,2517,55,15,2,13,.867,3600000,0
38091,45924,2517,0,0,0,0,.00nan,0,0
38091,53346,847,79,45,5,40,.889,3600000,0
38092,5824,847,0,0,0,0,.00nan,0,0
38092,6095,849,35,19,4,15,.789,3542000,0
38092,46051,849,0,0,0,0,.00nan,0,0
38092,53346,847,83,37,3,34,.919,3600000,0
38093,10355,846,86,35,2,33,.943,3600000,0
38093,11561,841,33,19,5,14,.737,3600000,0
38093,16413,846,0,0,0,0,.00nan,0,0
38093,45918,841,0,0,0,0,.00nan,0,0
38094,8523,845,0,0,0,0,.00nan,0,0
38094,16629,2517,43,25,4,21,.840,3764000,0
38094,32604,845,50,35,5,30,.857,3764000,0
38094,45924,2517,0,0,0,0,.00nan,0,0
38095,6571,842,0,0,0,0,.00nan,0,0
38095,30703,842,43,21,4,17,.810,3579000,0
38095,43348,843,0,0,0,0,.00nan,0,0
38095,44500,843,63,31,3,28,.903,3600000,0
38096,5162,2488,68,28,3,25,.893,3600000,0
38096,11762,2493,37,23,5,18,.783,3549000,0
38096,15510,2493,0,0,0,0,.00nan,0,0
38096,32158,2488,0,0,0,0,.00nan,0,0
38097,11762,2493,74,40,4,36,.900,3600000,0
38097,15510,2493,0,0,0,0,.00nan,0,0
38097,16629,2517,71,22,2,20,.909,3600000,0
38097,45924,2517,0,0,0,0,.00nan,0,0
38098,11561,841,0,0,0,0,.00nan,0,0
38098,43348,843,0,0,0,0,.00nan,0,0
38098,44500,843,88,30,2,28,.933,3600000,0
38098,45918,841,50,38,5,33,.868,3600000,0
38099,5162,2488,0,0,0,0,.00nan,0,0
38099,10355,846,69,20,1,19,.950,3600000,0
38099,16413,846,0,0,0,0,.00nan,0,0
38099,32158,2488,58,23,3,20,.870,3573000,0
38100,6095,849,69,26,2,24,.923,3546000,0
38100,6571,842,0,0,0,0,.00nan,0,0
38100,30703,842,72,25,1,24,.960,3600000,0
38100,46051,849,0,0,0,0,.00nan,0,0
38101,5824,847,53,39,5,34,.872,3600000,0
38101,8523,845,0,0,0,0,.00nan,0,0
38101,32604,845,82,41,2,39,.951,3600000,0
38101,53346,847,0,0,0,0,.00nan,0,0
38258,11762,2493,87,33,2,31,.939,3836000,0
38258,13577,2488,0,0,0,0,.00nan,0,0
38258,15510,2493,0,0,0,0,.00nan,0,0
38258,32158,2488,79,25,1,24,.960,3836000,0
38260,5824,847,0,0,0,0,.00nan,0,0
38260,6571,842,0,0,0,0,.00nan,0,0
38260,30703,842,50,28,4,24,.857,3600000,0
38260,53346,847,74,27,1,26,.963,3600000,0
38262,1319,843,0,0,0,0,.00nan,0,0
38262,8523,845,63,17,2,15,.882,1742000,0
38262,32604,845,59,14,1,13,.929,1975000,0
38262,43348,843,79,36,2,34,.944,3717000,0
38264,10355,846,37,28,6,22,.786,3600000,0
38264,11561,841,0,0,0,0,.00nan,0,0
38264,16413,846,0,0,0,0,.00nan,0,0
38264,45918,841,74,34,2,32,.941,3600000,0
38266,16629,2517,0,0,0,0,.00nan,0,0
38266,29271,849,54,26,3,23,.885,3531000,0
38266,45924,2517,80,23,1,22,.957,3600000,0
38266,46051,849,0,0,0,0,.00nan,0,0
38268,16629,2517,87,34,2,32,.941,3600000,0
38268,29271,849,65,8,0,8,1000,545000,0
38268,45924,2517,0,0,0,0,.00nan,0,0
38268,46051,849,45,34,6,28,.824,3055000,0
38270,10355,846,0,0,0,0,.00nan,0,0
38270,11762,2493,0,0,0,0,.00nan,0,0
38270,15510,2493,80,20,1,19,.950,3600000,0
38270,16413,846,62,26,3,23,.885,3600000,0
38272,5824,847,63,28,3,25,.893,3900000,0
38272,13577,2488,0,0,0,0,.00nan,0,0
38272,32158,2488,58,21,3,18,.857,3900000,0
38272,53346,847,0,0,0,0,.00nan,0,0
38274,1319,843,74,26,2,24,.923,3565000,0
38274,8523,845,79,28,1,27,.964,3600000,0
38274,32604,845,0,0,0,0,.00nan,0,0
38274,43348,843,0,0,0,0,.00nan,0,0
38276,6571,842,83,24,1,23,.958,3600000,0
38276,11561,841,44,30,5,25,.833,3600000,0
38276,30703,842,0,0,0,0,.00nan,0,0
38276,45918,841,0,0,0,0,.00nan,0,0
38278,1319,843,0,0,0,0,.00nan,0,0
38278,11762,2493,60,29,3,26,.897,3600000,0
38278,15510,2493,0,0,0,0,.00nan,0,0
38278,43348,843,70,24,1,23,.958,3600000,0
38280,8523,845,61,29,3,26,.897,3600000,0
38280,10355,846,68,41,5,36,.878,3537000,0
38280,16413,846,0,0,0,0,.00nan,0,0
38280,32604,845,0,0,0,0,.00nan,0,0
38282,6571,842,0,0,0,0,.00nan,0,0
38282,11561,841,57,28,3,25,.893,3557000,0
38282,30703,842,68,26,2,24,.923,3600000,0
38282,45918,841,0,0,0,0,.00nan,0,0
38284,5824,847,0,0,0,0,.00nan,0,0
38284,16629,2517,0,0,0,0,.00nan,0,0
38284,45924,2517,67,22,2,20,.909,3572000,0
38284,53346,847,86,32,1,31,.969,3600000,0
38286,13577,2488,0,0,0,0,.00nan,0,0
38286,29271,849,82,43,3,40,.930,3595000,0
38286,32158,2488,55,10,2,8,.800,3600000,0
38286,46051,849,0,0,0,0,.00nan,0,0
38288,5824,847,0,0,0,0,.00nan,0,0
38288,8523,845,0,0,0,0,.00nan,0,0
38288,32604,845,100,31,0,31,1000,3600000,0
38288,53346,847,63,38,4,34,.895,3600000,0
38290,1319,843,81,15,0,15,1000,3600000,0
38290,10355,846,56,36,5,31,.861,3600000,0
38290,16413,846,0,0,0,0,.00nan,0,0
38290,28323,843,0,0,0,0,.00nan,0,0
38292,6571,842,0,0,0,0,.00nan,0,0
38292,29271,849,60,31,3,28,.903,3536000,0
38292,30703,842,79,24,1,23,.958,3600000,0
38292,46051,849,0,0,0,0,.00nan,0,0
38294,11561,841,0,0,0,0,.00nan,0,0
38294,13577,2488,0,0,0,0,.00nan,0,0
38294,32158,2488,73,35,3,32,.914,3900000,0
38294,45918,841,51,20,3,17,.850,3900000,0
38296,11762,2493,91,42,3,39,.929,3701000,0
38296,15510,2493,0,0,0,0,.00nan,0,0
38296,16629,2517,0,0,0,0,.00nan,0,0
38296,45924,2517,61,33,4,29,.879,3701000,0
38298,1319,843,82,42,3,39,.929,3600000,0
38298,11561,841,71,25,2,23,.920,3600000,0
38298,28323,843,0,0,0,0,.00nan,0,0
38298,45918,841,0,0,0,0,.00nan,0,0
38300,13577,2488,95,23,0,23,1000,3900000,0
38300,16629,2517,100,26,0,26,1000,3900000,0
38300,32158,2488,0,0,0,0,.00nan,0,0
38300,45924,2517,0,0,0,0,.00nan,0,0
38302,8523,845,0,0,0,0,.00nan,0,0
38302,10355,846,27,23,5,18,.783,3600000,0
38302,16413,846,0,0,0,0,.00nan,0,0
38302,32604,845,97,24,0,24,1000,3600000,0
38304,5824,847,63,21,2,19,.905,3600000,0
38304,11762,2493,0,0,0,0,.00nan,0,0
38304,15510,2493,71,32,3,29,.906,3576000,0
38304,53346,847,0,0,0,0,.00nan,0,0
38306,6571,842,51,29,4,25,.862,3782000,0
38306,29271,849,66,37,5,32,.865,3782000,0
38306,30703,842,0,0,0,0,.00nan,0,0
38306,46051,849,0,0,0,0,.00nan,0,0
38308,5824,847,0,0,0,0,.00nan,0,0
38308,11561,841,37,26,5,21,.808,3546000,0
38308,45918,841,0,0,0,0,.00nan,0,0
38308,53346,847,56,31,4,27,.871,3600000,0
38310,8523,845,0,0,0,0,.00nan,0,0
38310,11762,2493,55,40,5,35,.875,3546000,0
38310,15510,2493,0,0,0,0,.00nan,0,0
38310,32604,845,56,29,4,25,.862,3600000,0
38312,1319,843,85,38,2,36,.947,3731000,0
38312,13577,2488,59,25,3,22,.880,3731000,0
38312,28323,843,0,0,0,0,.00nan,0,0
38312,32158,2488,0,0,0,0,.00nan,0,0
38314,16629,2517,100,29,0,29,1000,3600000,0
38314,29271,849,72,27,2,25,.926,3527000,0
38314,45924,2517,0,0,0,0,.00nan,0,0
38314,46051,849,0,0,0,0,.00nan,0,0
38316,6571,842,0,0,0,0,.00nan,0,0
38316,10355,846,0,0,0,0,.00nan,0,0
38316,16413,846,60,28,3,25,.893,3515000,0
38316,30703,842,84,28,1,27,.964,3600000,0
38318,5824,847,73,27,2,25,.926,3900000,0
38318,11762,2493,0,0,0,0,.00nan,0,0
38318,15510,2493,62,21,2,19,.905,3900000,0
38318,53346,847,0,0,0,0,.00nan,0,0
38320,11561,841,0,0,0,0,.00nan,0,0
38320,29271,849,0,0,0,0,.00nan,0,0
38320,45918,841,68,18,1,17,.944,3600000,0
38320,46051,849,68,25,2,23,.920,3578000,0
38322,10355,846,81,26,1,25,.962,3600000,0
38322,13577,2488,0,0,0,0,.00nan,0,0
38322,16413,846,0,0,0,0,.00nan,0,0
38322,32158,2488,33,31,6,25,.806,3600000,0
38324,6571,842,80,23,1,22,.957,3600000,0
38324,8523,845,58,27,3,24,.889,3528000,0
38324,30703,842,0,0,0,0,.00nan,0,0
38324,32604,845,0,0,0,0,.00nan,0,0
38326,1319,843,0,0,0,0,.00nan,0,0
38326,16629,2517,65,18,1,17,.944,3600000,0
38326,28323,843,49,24,3,21,.875,3600000,0
38326,45924,2517,0,0,0,0,.00nan,0,0
38327,13613,1481,65,30,3,27,.900,3600000,0
38327,14428,521,98,25,0,25,1000,3600000,0
38327,15730,1481,0,0,0,0,.00nan,0,0
38327,52465,521,0,0,0,0,.00nan,0,0
38328,8208,1861,0,0,0,0,.00nan,0,0
38328,10047,522,90,33,1,32,.970,3600000,0
38328,17266,1861,60,21,2,19,.905,3558000,0
38328,62615,522,0,0,0,0,.00nan,0,0
38329,5319,1472,62,30,3,27,.900,3600000,0
38329,49834,1475,38,22,4,18,.818,3554000,0
38329,62949,1472,0,0,0,0,.00nan,0,0
38329,128255,1475,0,0,0,0,.00nan,0,0
38330,15610,1871,65,42,5,37,.881,3600000,0
38330,16204,1854,0,0,0,0,.00nan,0,0
38330,60964,1854,97,23,0,23,1000,3600000,0
38330,145668,1871,0,0,0,0,.00nan,0,0
38331,30055,1869,0,0,0,0,.00nan,0,0
38331,30156,1869,64,25,2,23,.920,3600000,0
38331,34408,1876,15,25,6,19,.760,2712000,0
38331,53248,1876,67,9,0,9,1000,888000,0
38332,30592,517,74,25,2,23,.920,3600000,0
38332,31597,4962,0,0,0,0,.00nan,0,0
38332,62358,517,0,0,0,0,.00nan,0,0
38332,65044,4962,48,28,4,24,.857,3572000,0
38333,2096,1479,0,0,0,0,.00nan,0,0
38333,7520,3922,81,29,1,28,.966,3900000,0
38333,24867,1479,70,23,1,22,.957,3900000,0
38333,49851,3922,0,0,0,0,.00nan,0,0
38334,13613,1481,0,0,0,0,.00nan,0,0
38334,15730,1481,96,49,2,47,.959,3600000,0
38334,30592,517,18,8,4,4,.500,764000,0
38334,62358,517,60,10,1,9,.900,2836000,0
38335,30055,1869,0,0,0,0,.00nan,0,0
38335,30156,1869,82,16,0,16,1000,3600000,0
38335,31597,4962,98,41,2,39,.951,3580000,0
38335,65044,4962,0,0,0,0,.00nan,0,0
38336,14428,521,73,42,4,38,.905,3517000,0
38336,15610,1871,86,34,2,32,.941,3600000,0
38336,52903,521,0,0,0,0,.00nan,0,0
38336,145668,1871,0,0,0,0,.00nan,0,0
38337,4056,1861,0,0,0,0,.00nan,0,0
38337,5319,1472,86,37,2,35,.946,3600000,0
38337,8208,1861,54,24,3,21,.875,3566000,0
38337,62949,1472,0,0,0,0,.00nan,0,0
38338,2096,1479,74,36,3,33,.917,3600000,0
38338,24867,1479,0,0,0,0,.00nan,0,0
38338,49834,1475,100,25,0,25,1000,3600000,0
38338,128255,1475,0,0,0,0,.00nan,0,0
38339,16204,1854,0,0,0,0,.00nan,0,0
38339,34408,1876,69,18,1,17,.944,3600000,0
38339,53248,1876,0,0,0,0,.00nan,0,0
38339,60964,1854,44,26,4,22,.846,3600000,0
38340,7520,3922,83,33,2,31,.939,3854000,0
38340,10047,522,81,26,1,25,.962,3854000,0
38340,49851,3922,0,0,0,0,.00nan,0,0
38340,62615,522,0,0,0,0,.00nan,0,0
38341,13613,1481,0,0,0,0,.00nan,0,0
38341,15730,1481,74,37,3,34,.919,3600000,0
38341,34408,1876,99,25,0,25,1000,3600000,0
38341,53248,1876,0,0,0,0,.00nan,0,0
38342,10047,522,64,28,3,25,.893,3552000,0
38342,30055,1869,0,0,0,0,.00nan,0,0
38342,30156,1869,89,32,1,31,.969,3600000,0
38342,62615,522,0,0,0,0,.00nan,0,0
38343,5319,1472,84,36,2,34,.944,3600000,0
38343,30592,517,46,38,5,33,.868,3600000,0
38343,62358,517,0,0,0,0,.00nan,0,0
38343,62949,1472,0,0,0,0,.00nan,0,0
38344,7520,3922,100,26,0,26,1000,3600000,0
38344,15610,1871,59,16,1,15,.938,3600000,0
38344,49851,3922,0,0,0,0,.00nan,0,0
38344,145668,1871,0,0,0,0,.00nan,0,0
38345,4056,1861,100,26,0,26,1000,3600000,0
38345,8208,1861,0,0,0,0,.00nan,0,0
38345,49834,1475,65,36,4,32,.889,3600000,0
38345,128255,1475,0,0,0,0,.00nan,0,0
38346,14428,521,79,31,2,29,.935,3600000,0
38346,31597,4962,60,27,3,24,.889,3553000,0
38346,52903,521,0,0,0,0,.00nan,0,0
38346,65044,4962,0,0,0,0,.00nan,0,0
38347,2096,1479,0,0,0,0,.00nan,0,0
38347,16204,1854,0,0,0,0,.00nan,0,0
38347,24867,1479,77,34,3,31,.912,3600000,0
38347,60964,1854,74,43,4,39,.907,3574000,0
38348,2096,1479,0,0,0,0,.00nan,0,0
38348,24867,1479,61,39,5,34,.872,3639000,0
38348,30592,517,0,0,0,0,.00nan,0,0
38348,62358,517,45,23,4,19,.826,3639000,0
38349,5319,1472,86,32,1,31,.969,3900000,0
38349,30055,1869,83,28,1,27,.964,3900000,0
38349,30156,1869,0,0,0,0,.00nan,0,0
38349,62949,1472,0,0,0,0,.00nan,0,0
38350,4056,1861,40,26,4,22,.846,3554000,0
38350,8208,1861,0,0,0,0,.00nan,0,0
38350,14428,521,100,45,2,43,.956,3600000,0
38350,52903,521,0,0,0,0,.00nan,0,0
38351,10047,522,62,23,2,21,.913,3564000,0
38351,49834,1475,67,14,1,13,.929,3600000,0
38351,62615,522,0,0,0,0,.00nan,0,0
38351,128255,1475,0,0,0,0,.00nan,0,0
38352,13613,1481,0,0,0,0,.00nan,0,0
38352,15730,1481,67,28,3,25,.893,3738000,0
38352,16204,1854,70,36,4,32,.889,3738000,0
38352,60964,1854,0,0,0,0,.00nan,0,0
38353,15610,1871,65,35,3,32,.914,3600000,0
38353,34408,1876,42,35,5,30,.857,3518000,0
38353,53248,1876,0,0,0,0,.00nan,0,0
38353,145668,1871,0,0,0,0,.00nan,0,0
38354,7520,3922,85,32,2,30,.938,3551000,0
38354,31597,4962,92,22,0,22,1000,3600000,0
38354,49851,3922,0,0,0,0,.00nan,0,0
38354,65044,4962,0,0,0,0,.00nan,0,0
38355,10047,522,88,38,3,35,.921,3570000,0
38355,14428,521,68,27,2,25,.926,3600000,0
38355,52903,521,0,0,0,0,.00nan,0,0
38355,62615,522,0,0,0,0,.00nan,0,0
38356,5319,1472,54,22,2,20,.909,3600000,0
38356,16204,1854,0,0,0,0,.00nan,0,0
38356,60964,1854,52,26,4,22,.846,3538000,0
38356,62949,1472,0,0,0,0,.00nan,0,0
38357,15610,1871,0,0,0,0,.00nan,0,0
38357,30592,517,53,33,5,28,.848,3600000,0
38357,62358,517,0,0,0,0,.00nan,0,0
38357,145668,1871,83,31,1,30,.968,3600000,0
38358,4056,1861,0,0,0,0,.00nan,0,0
38358,8208,1861,100,30,0,30,1000,3600000,0
38358,30055,1869,63,20,1,19,.950,2652000,0
38358,30156,1869,30,16,4,12,.750,948000,0
38359,13613,1481,0,0,0,0,.00nan,0,0
38359,15730,1481,90,39,2,37,.949,3900000,0
38359,31597,4962,55,18,2,16,.889,3900000,0
38359,65044,4962,0,0,0,0,.00nan,0,0
38360,7520,3922,83,27,1,26,.963,3600000,0
38360,49834,1475,63,29,3,26,.897,3586000,0
38360,49851,3922,0,0,0,0,.00nan,0,0
38360,128255,1475,0,0,0,0,.00nan,0,0
38361,2096,1479,0,0,0,0,.00nan,0,0
38361,24867,1479,85,34,2,32,.941,3537000,0
38361,34408,1876,90,20,0,20,1000,3600000,0
38361,53248,1876,0,0,0,0,.00nan,0,0
38362,13613,1481,0,0,0,0,.00nan,0,0
38362,15610,1871,28,21,5,16,.762,3600000,0
38362,15730,1481,100,27,0,27,1000,3600000,0
38362,145668,1871,0,0,0,0,.00nan,0,0
38363,30055,1869,0,0,0,0,.00nan,0,0
38363,30156,1869,81,39,4,35,.897,3900000,0
38363,49834,1475,62,36,4,32,.889,3900000,0
38363,128255,1475,0,0,0,0,.00nan,0,0
38364,2096,1479,74,45,4,41,.911,3544000,0
38364,14428,521,65,28,3,25,.893,3600000,0
38364,24867,1479,0,0,0,0,.00nan,0,0
38364,52903,521,0,0,0,0,.00nan,0,0
38365,10047,522,43,39,6,33,.846,3600000,0
38365,16204,1854,0,0,0,0,.00nan,0,0
38365,60964,1854,54,31,5,26,.839,3600000,0
38365,62615,522,0,0,0,0,.00nan,0,0
38366,31597,4962,81,26,1,25,.962,3600000,0
38366,34408,1876,28,29,6,23,.793,3176000,0
38366,53248,1876,55,6,0,6,1000,424000,0
38366,65044,4962,0,0,0,0,.00nan,0,0
38367,4056,1861,0,0,0,0,.00nan,0,0
38367,8208,1861,70,29,3,26,.897,3600000,0
38367,30592,517,0,0,0,0,.00nan,0,0
38367,62358,517,47,27,5,22,.815,3591000,0
38368,5319,1472,48,27,4,23,.852,3600000,0
38368,7520,3922,80,28,1,27,.964,3600000,0
38368,49851,3922,0,0,0,0,.00nan,0,0
38368,62949,1472,0,0,0,0,.00nan,0,0
38369,30055,1869,62,34,4,30,.882,3011000,0
38369,30156,1869,41,2,1,1,.500,889000,0
38369,30592,517,54,35,5,30,.857,3900000,0
38369,62358,517,0,0,0,0,.00nan,0,0
38370,10047,522,0,0,0,0,.00nan,0,0
38370,13613,1481,0,0,0,0,.00nan,0,0
38370,15730,1481,66,29,3,26,.897,3900000,0
38370,62615,522,70,35,3,32,.914,3900000,0
38371,4056,1861,0,0,0,0,.00nan,0,0
38371,7520,3922,39,35,6,29,.829,2965000,0
38371,8208,1861,95,24,0,24,1000,3600000,0
38371,49851,3922,65,8,0,8,1000,635000,0
38372,16204,1854,52,35,4,31,.886,3567000,0
38372,31597,4962,0,0,0,0,.00nan,0,0
38372,60964,1854,0,0,0,0,.00nan,0,0
38372,65044,4962,68,27,2,25,.926,3600000,0
38373,14428,521,89,33,1,32,.970,3600000,0
38373,49834,1475,51,24,3,21,.875,3588000,0
38373,52903,521,0,0,0,0,.00nan,0,0
38373,128255,1475,0,0,0,0,.00nan,0,0
38374,2096,1479,0,0,0,0,.00nan,0,0
38374,15610,1871,71,29,3,26,.897,3600000,0
38374,24867,1479,95,30,1,29,.967,3600000,0
38374,145668,1871,0,0,0,0,.00nan,0,0
38375,5319,1472,50,30,4,26,.867,3600000,0
38375,34408,1876,97,40,1,39,.975,3600000,0
38375,53248,1876,0,0,0,0,.00nan,0,0
38375,62949,1472,0,0,0,0,.00nan,0,0
38376,2096,1479,0,0,0,0,.00nan,0,0
38376,13613,1481,0,0,0,0,.00nan,0,0
38376,15730,1481,74,36,4,32,.889,3600000,0
38376,24867,1479,36,28,5,23,.821,3567000,0
38377,15610,1871,69,17,1,16,.941,3576000,0
38377,31597,4962,100,31,0,31,1000,3600000,0
38377,65044,4962,0,0,0,0,.00nan,0,0
38377,145668,1871,0,0,0,0,.00nan,0,0
38378,10047,522,51,39,5,34,.872,3600000,0
38378,34408,1876,79,24,1,23,.958,3600000,0
38378,53248,1876,0,0,0,0,.00nan,0,0
38378,62615,522,0,0,0,0,.00nan,0,0
38379,30592,517,47,42,6,36,.857,3578000,0
38379,49834,1475,48,28,4,24,.857,3600000,0
38379,62358,517,0,0,0,0,.00nan,0,0
38379,128255,1475,0,0,0,0,.00nan,0,0
38380,7520,3922,62,36,4,32,.889,3600000,0
38380,30055,1869,0,0,0,0,.00nan,0,0
38380,30156,1869,26,25,6,19,.760,3525000,0
38380,49851,3922,0,0,0,0,.00nan,0,0
38381,1319,1472,79,32,2,30,.938,3900000,0
38381,14428,521,69,30,2,28,.933,3900000,0
38381,52903,521,0,0,0,0,.00nan,0,0
38381,62949,1472,0,0,0,0,.00nan,0,0
38382,4056,1861,0,0,0,0,.00nan,0,0
38382,8208,1861,80,27,1,26,.963,3600000,0
38382,16204,1854,0,0,0,0,.00nan,0,0
38382,60964,1854,60,37,4,33,.892,3600000,0
38383,7520,3922,50,30,4,26,.867,3550000,0
38383,30592,517,62,28,3,25,.893,3600000,0
38383,49851,3922,0,0,0,0,.00nan,0,0
38383,62358,517,0,0,0,0,.00nan,0,0
38384,14428,521,73,39,3,36,.923,3560000,0
38384,30055,1869,0,0,0,0,.00nan,0,0
38384,30156,1869,61,28,2,26,.929,3600000,0
38384,52903,521,0,0,0,0,.00nan,0,0
38385,10047,522,69,24,2,22,.917,3600000,0
38385,15610,1871,70,31,3,28,.903,3584000,0
38385,62615,522,0,0,0,0,.00nan,0,0
38385,145668,1871,0,0,0,0,.00nan,0,0
38386,4056,1861,0,0,0,0,.00nan,0,0
38386,8208,1861,63,26,3,23,.885,3600000,0
38386,34408,1876,45,33,5,28,.848,2111000,0
38386,53248,1876,76,17,0,17,1000,1446000,0
38387,2096,1479,55,20,3,17,.850,3590000,0
38387,24867,1479,0,0,0,0,.00nan,0,0
38387,31597,4962,89,31,1,30,.968,3600000,0
38387,65044,4962,0,0,0,0,.00nan,0,0
38388,16204,1854,80,31,2,29,.935,3600000,0
38388,49834,1475,68,17,1,16,.941,3600000,0
38388,60964,1854,0,0,0,0,.00nan,0,0
38388,128255,1475,0,0,0,0,.00nan,0,0
38389,1319,1472,0,0,0,0,.00nan,0,0
38389,13613,1481,0,0,0,0,.00nan,0,0
38389,15730,1481,30,32,6,26,.813,3600000,0
38389,16186,1472,49,21,3,18,.857,3600000,0
38390,13613,1481,99,35,1,34,.971,3600000,0
38390,15730,1481,0,0,0,0,.00nan,0,0
38390,30055,1869,0,0,0,0,.00nan,0,0
38390,30156,1869,64,33,3,30,.909,3517000,0
38391,4056,1861,77,35,3,32,.914,3600000,0
38391,8208,1861,0,0,0,0,.00nan,0,0
38391,15610,1871,41,31,5,26,.839,3513000,0
38391,145668,1871,0,0,0,0,.00nan,0,0
38392,34408,1876,65,17,1,16,.941,3600000,0
38392,49834,1475,40,15,3,12,.800,3587000,0
38392,53248,1876,0,0,0,0,.00nan,0,0
38392,128255,1475,0,0,0,0,.00nan,0,0
38393,7520,3922,62,33,4,29,.879,3600000,0
38393,14428,521,89,21,0,21,1000,3600000,0
38393,49851,3922,0,0,0,0,.00nan,0,0
38393,52903,521,0,0,0,0,.00nan,0,0
38394,10047,522,25,13,4,9,.692,932000,0
38394,31597,4962,67,23,1,22,.957,3600000,0
38394,62615,522,79,33,3,30,.909,2668000,0
38394,65044,4962,0,0,0,0,.00nan,0,0
38395,1319,1472,79,26,1,25,.962,3600000,0
38395,2096,1479,0,0,0,0,.00nan,0,0
38395,16186,1472,0,0,0,0,.00nan,0,0
38395,24867,1479,40,25,4,21,.840,3600000,0
38396,16204,1854,42,27,5,22,.815,3600000,0
38396,30592,517,0,0,0,0,.00nan,0,0
38396,60964,1854,0,0,0,0,.00nan,0,0
38396,62358,517,65,24,2,22,.917,3600000,0
38397,2096,1479,35,24,5,19,.792,3600000,0
38397,10047,522,100,46,2,44,.957,3600000,0
38397,24867,1479,0,0,0,0,.00nan,0,0
38397,62615,522,0,0,0,0,.00nan,0,0
38398,1319,1472,42,3,1,2,.667,466000,0
38398,15610,1871,36,7,3,4,.571,542000,0
38398,16186,1472,33,31,6,25,.806,3134000,0
38398,145668,1871,72,12,0,12,1000,3058000,0
38399,14428,521,77,33,2,31,.939,3600000,0
38399,30592,517,84,27,1,26,.963,3600000,0
38399,52903,521,0,0,0,0,.00nan,0,0
38399,62358,517,0,0,0,0,.00nan,0,0
38400,16204,1854,90,35,1,34,.971,3600000,0
38400,30055,1869,52,30,4,26,.867,3600000,0
38400,30156,1869,0,0,0,0,.00nan,0,0
38400,60964,1854,0,0,0,0,.00nan,0,0
38401,7520,3922,0,0,0,0,.00nan,0,0
38401,34408,1876,85,33,2,31,.939,3600000,0
38401,49851,3922,46,28,4,24,.857,3593000,0
38401,53248,1876,0,0,0,0,.00nan,0,0
38402,4056,1861,0,0,0,0,.00nan,0,0
38402,8208,1861,94,34,2,32,.941,3900000,0
38402,13613,1481,0,0,0,0,.00nan,0,0
38402,15730,1481,74,32,2,30,.938,3900000,0
38403,31597,4962,51,39,5,34,.872,3600000,0
38403,49834,1475,66,23,2,21,.913,3600000,0
38403,65044,4962,0,0,0,0,.00nan,0,0
38403,128255,1475,0,0,0,0,.00nan,0,0
38404,7520,3922,90,33,1,32,.970,3600000,0
38404,13613,1481,0,0,0,0,.00nan,0,0
38404,15730,1481,49,32,4,28,.875,3600000,0
38404,49851,3922,0,0,0,0,.00nan,0,0
38405,1319,1472,0,0,0,0,.00nan,0,0
38405,5319,1472,63,18,1,17,.944,3600000,0
38405,10047,522,46,38,6,32,.842,3600000,0
38405,62615,522,0,0,0,0,.00nan,0,0
38406,4056,1861,78,30,2,28,.933,3900000,0
38406,8208,1861,0,0,0,0,.00nan,0,0
38406,31597,4962,0,0,0,0,.00nan,0,0
38406,65044,4962,84,33,2,31,.939,3900000,0
38407,2096,1479,0,0,0,0,.00nan,0,0
38407,24867,1479,100,28,0,28,1000,3600000,0
38407,30055,1869,0,0,0,0,.00nan,0,0
38407,30156,1869,71,22,1,21,.955,3553000,0
38408,14428,521,0,0,0,0,.00nan,0,0
38408,16204,1854,0,0,0,0,.00nan,0,0
38408,52903,521,74,43,4,39,.907,3511000,0
38408,60964,1854,87,31,2,29,.935,3600000,0
38409,15610,1871,69,29,3,26,.897,3900000,0
38409,49834,1475,67,29,3,26,.897,3900000,0
38409,128255,1475,0,0,0,0,.00nan,0,0
38409,145668,1871,0,0,0,0,.00nan,0,0
38410,30592,517,63,28,3,25,.893,3600000,0
38410,34408,1876,77,49,5,44,.898,3570000,0
38410,53248,1876,0,0,0,0,.00nan,0,0
38410,62358,517,0,0,0,0,.00nan,0,0
38411,1319,1472,0,0,0,0,.00nan,0,0
38411,5319,1472,58,22,2,20,.909,3586000,0
38411,31597,4962,100,43,1,42,.977,3600000,0
38411,65044,4962,0,0,0,0,.00nan,0,0
38412,10047,522,73,26,2,24,.923,3600000,0
38412,30592,517,32,8,3,5,.625,559000,0
38412,62358,517,63,28,3,25,.893,3041000,0
38412,62615,522,0,0,0,0,.00nan,0,0
38413,15610,1871,54,45,6,39,.867,3584000,0
38413,30055,1869,40,23,4,19,.826,3600000,0
38413,30156,1869,0,0,0,0,.00nan,0,0
38413,145668,1871,0,0,0,0,.00nan,0,0
38414,7520,3922,50,37,6,31,.838,3600000,0
38414,16204,1854,64,24,3,21,.875,3600000,0
38414,49851,3922,0,0,0,0,.00nan,0,0
38414,60964,1854,0,0,0,0,.00nan,0,0
38415,14428,521,90,28,1,27,.964,3600000,0
38415,34408,1876,0,0,0,0,.00nan,0,0
38415,52903,521,0,0,0,0,.00nan,0,0
38415,53248,1876,65,39,3,36,.923,3587000,0
38416,2096,1479,0,0,0,0,.00nan,0,0
38416,4056,1861,0,0,0,0,.00nan,0,0
38416,8208,1861,65,20,2,18,.900,3900000,0
38416,24867,1479,93,39,2,37,.949,3900000,0
38417,13613,1481,45,21,4,17,.810,2459000,0
38417,15730,1481,26,11,4,7,.636,1141000,0
38417,49834,1475,100,30,0,30,1000,3600000,0
38417,128255,1475,0,0,0,0,.00nan,0,0
38418,30592,517,0,0,0,0,.00nan,0,0
38418,31597,4962,100,34,1,33,.971,3600000,0
38418,62358,517,69,25,2,23,.920,3600000,0
38418,65044,4962,0,0,0,0,.00nan,0,0
38419,30055,1869,0,0,0,0,.00nan,0,0
38419,30156,1869,51,22,3,19,.864,3533000,0
38419,34408,1876,92,36,1,35,.972,3600000,0
38419,53248,1876,0,0,0,0,.00nan,0,0
38420,13613,1481,0,0,0,0,.00nan,0,0
38420,14428,521,85,27,2,25,.926,3600000,0
38420,15730,1481,34,26,5,21,.808,3600000,0
38420,52903,521,0,0,0,0,.00nan,0,0
38421,4056,1861,78,18,1,17,.944,3600000,0
38421,8208,1861,0,0,0,0,.00nan,0,0
38421,10047,522,73,36,4,32,.889,3600000,0
38421,62615,522,0,0,0,0,.00nan,0,0
38422,1319,1472,0,0,0,0,.00nan,0,0
38422,5319,1472,100,34,0,34,1000,3600000,0
38422,49834,1475,87,33,1,32,.970,3600000,0
38422,128255,1475,0,0,0,0,.00nan,0,0
38423,15610,1871,47,31,5,26,.839,3600000,0
38423,16204,1854,73,23,1,22,.957,3600000,0
38423,60964,1854,0,0,0,0,.00nan,0,0
38423,145668,1871,0,0,0,0,.00nan,0,0
38424,2096,1479,0,0,0,0,.00nan,0,0
38424,7520,3922,100,33,0,33,1000,3600000,0
38424,24867,1479,83,24,1,23,.958,3600000,0
38424,49851,3922,0,0,0,0,.00nan,0,0
38425,13613,1481,52,3,0,3,1000,332000,0
38425,15730,1481,56,54,6,48,.889,3246000,0
38425,30592,517,40,21,4,17,.810,3600000,0
38425,62358,517,0,0,0,0,.00nan,0,0
38426,7520,3922,54,26,3,23,.885,3600000,0
38426,10047,522,55,34,4,30,.882,3563000,0
38426,49851,3922,0,0,0,0,.00nan,0,0
38426,62615,522,0,0,0,0,.00nan,0,0
38427,1319,1472,0,0,0,0,.00nan,0,0
38427,4056,1861,0,0,0,0,.00nan,0,0
38427,5319,1472,81,33,2,31,.939,3600000,0
38427,8208,1861,61,28,3,25,.893,3548000,0
38428,14428,521,52,29,4,25,.862,3600000,0
38428,15610,1871,0,0,0,0,.00nan,0,0
38428,52903,521,0,0,0,0,.00nan,0,0
38428,145668,1871,70,34,3,31,.912,3600000,0
38429,16204,1854,12,19,6,13,.684,3600000,0
38429,34408,1876,65,32,3,29,.906,3600000,0
38429,53248,1876,0,0,0,0,.00nan,0,0
38429,60964,1854,0,0,0,0,.00nan,0,0
38430,10492,1869,52,20,3,17,.850,3610000,0
38430,30055,1869,0,0,0,0,.00nan,0,0
38430,31597,4962,58,28,4,24,.857,3610000,0
38430,65044,4962,0,0,0,0,.00nan,0,0
38431,2096,1479,71,34,3,31,.912,3578000,0
38431,24867,1479,0,0,0,0,.00nan,0,0
38431,49834,1475,71,24,2,22,.917,3600000,0
38431,128255,1475,0,0,0,0,.00nan,0,0
38692,2096,1479,0,0,0,0,.00nan,0,0
38692,24867,1479,75,32,3,29,.906,3585000,0
38692,30055,1869,0,0,0,0,.00nan,0,0
38692,30156,1869,83,27,2,25,.926,3600000,0
38694,15610,1871,60,36,4,32,.889,3600000,0
38694,16204,1854,100,25,0,25,1000,3600000,0
38694,60964,1854,0,0,0,0,.00nan,0,0
38694,145668,1871,0,0,0,0,.00nan,0,0
38696,15876,3922,0,0,0,0,.00nan,0,0
38696,31597,4962,79,23,1,22,.957,3600000,0
38696,49851,3922,50,20,2,18,.900,3546000,0
38696,65044,4962,0,0,0,0,.00nan,0,0
38698,10047,522,65,25,2,23,.920,3585000,0
38698,34408,1876,0,0,0,0,.00nan,0,0
38698,53248,1876,68,19,1,18,.947,3600000,0
38698,62615,522,0,0,0,0,.00nan,0,0
38700,8208,1861,0,0,0,0,.00nan,0,0
38700,14428,521,82,37,3,34,.919,3578000,0
38700,17266,1861,87,27,1,26,.963,3600000,0
38700,52465,521,0,0,0,0,.00nan,0,0
38702,13613,1481,39,26,4,22,.846,2461000,0
38702,15730,1481,14,7,4,3,.429,1139000,0
38702,30592,517,62,22,2,20,.909,3600000,0
38702,62358,517,0,0,0,0,.00nan,0,0
38704,5319,1472,91,23,0,23,1000,3600000,0
38704,7146,1475,0,0,0,0,.00nan,0,0
38704,62949,1472,0,0,0,0,.00nan,0,0
38704,128255,1475,74,28,1,27,.964,3545000,0
38706,15610,1871,0,0,0,0,.00nan,0,0
38706,31597,4962,0,0,0,0,.00nan,0,0
38706,65044,4962,63,28,3,25,.893,3690000,0
38706,145668,1871,62,34,4,30,.882,3647000,0
38708,7146,1475,60,21,2,19,.905,3600000,0
38708,10047,522,0,0,0,0,.00nan,0,0
38708,62615,522,58,38,5,33,.868,3600000,0
38708,128255,1475,0,0,0,0,.00nan,0,0
38710,5319,1472,76,24,1,23,.958,3600000,0
38710,16204,1854,81,32,2,30,.938,3600000,0
38710,60964,1854,0,0,0,0,.00nan,0,0
38710,62949,1472,0,0,0,0,.00nan,0,0
38712,14428,521,0,0,0,0,.00nan,0,0
38712,34408,1876,54,50,6,44,.880,3600000,0
38712,52465,521,64,19,2,17,.895,3600000,0
38712,53248,1876,0,0,0,0,.00nan,0,0
38714,7520,3922,96,36,1,35,.972,3573000,0
38714,30592,517,0,0,0,0,.00nan,0,0
38714,49851,3922,0,0,0,0,.00nan,0,0
38714,62358,517,94,20,0,20,1000,3600000,0
38716,13613,1481,0,0,0,0,.00nan,0,0
38716,15730,1481,73,36,3,33,.917,3600000,0
38716,30055,1869,0,0,0,0,.00nan,0,0
38716,30156,1869,56,31,4,27,.871,3574000,0
38718,2096,1479,76,34,3,31,.912,3739000,0
38718,8208,1861,73,21,2,19,.905,3739000,0
38718,17266,1861,0,0,0,0,.00nan,0,0
38718,24867,1479,0,0,0,0,.00nan,0,0
38720,10047,522,71,23,1,22,.957,3600000,0
38720,13613,1481,0,0,0,0,.00nan,0,0
38720,15730,1481,58,27,3,24,.889,3553000,0
38720,62615,522,0,0,0,0,.00nan,0,0
38722,8208,1861,0,0,0,0,.00nan,0,0
38722,17266,1861,54,34,4,30,.882,3600000,0
38722,30055,1869,57,44,5,39,.886,3561000,0
38722,30156,1869,0,0,0,0,.00nan,0,0
38724,16204,1854,0,0,0,0,.00nan,0,0
38724,49834,1475,50,31,4,27,.871,3123000,0
38724,60964,1854,74,19,1,18,.947,3600000,0
38724,128255,1475,40,3,1,2,.667,477000,0
38726,2096,1479,0,0,0,0,.00nan,0,0
38726,24867,1479,77,50,5,45,.900,3600000,0
38726,31597,4962,83,26,1,25,.962,3600000,0
38726,65044,4962,0,0,0,0,.00nan,0,0
38728,14428,521,65,37,3,34,.919,3572000,0
38728,30592,517,0,0,0,0,.00nan,0,0
38728,52465,521,0,0,0,0,.00nan,0,0
38728,62358,517,66,23,2,21,.913,3600000,0
38730,5319,1472,63,34,4,30,.882,3538000,0
38730,34408,1876,55,26,3,23,.885,3600000,0
38730,53248,1876,0,0,0,0,.00nan,0,0
38730,62949,1472,0,0,0,0,.00nan,0,0
38732,7520,3922,98,37,1,36,.973,3600000,0
38732,15610,1871,54,34,5,29,.853,3600000,0
38732,49851,3922,0,0,0,0,.00nan,0,0
38732,145668,1871,0,0,0,0,.00nan,0,0
38734,13613,1481,100,42,0,42,1000,3600000,0
38734,15730,1481,0,0,0,0,.00nan,0,0
38734,30055,1869,0,0,0,0,.00nan,0,0
38734,30156,1869,83,32,2,30,.938,3514000,0
38736,2096,1479,100,36,0,36,1000,3600000,0
38736,15610,1871,0,0,0,0,.00nan,0,0
38736,24867,1479,0,0,0,0,.00nan,0,0
38736,145668,1871,72,20,1,19,.950,3568000,0
38738,5319,1472,0,0,0,0,.00nan,0,0
38738,30592,517,56,29,3,26,.897,3900000,0
38738,62358,517,0,0,0,0,.00nan,0,0
38738,62949,1472,51,23,3,20,.870,3900000,0
38740,14428,521,0,0,0,0,.00nan,0,0
38740,31597,4962,0,0,0,0,.00nan,0,0
38740,52465,521,75,26,1,25,.962,3900000,0
38740,65044,4962,63,22,1,21,.955,3900000,0
38742,8208,1861,64,26,2,24,.923,3600000,0
38742,16204,1854,59,29,3,26,.897,3568000,0
38742,17266,1861,0,0,0,0,.00nan,0,0
38742,60964,1854,0,0,0,0,.00nan,0,0
38744,7520,3922,0,0,0,0,.00nan,0,0
38744,34408,1876,0,0,0,0,.00nan,0,0
38744,49851,3922,100,29,0,29,1000,3600000,0
38744,53248,1876,53,17,3,14,.824,3600000,0
38746,10047,522,0,0,0,0,.00nan,0,0
38746,49834,1475,0,0,0,0,.00nan,0,0
38746,62615,522,79,34,3,31,.912,3565000,0
38746,128255,1475,62,22,2,20,.909,3600000,0
38748,30592,517,0,0,0,0,.00nan,0,0
38748,49834,1475,81,33,2,31,.939,3900000,0
38748,62358,517,55,18,2,16,.889,3900000,0
38748,128255,1475,0,0,0,0,.00nan,0,0
38750,13613,1481,74,28,2,26,.929,3569000,0
38750,14428,521,99,42,1,41,.976,3600000,0
38750,15730,1481,0,0,0,0,.00nan,0,0
38750,52465,521,0,0,0,0,.00nan,0,0
38752,5319,1472,45,24,4,20,.833,3600000,0
38752,10047,522,42,31,5,26,.839,3600000,0
38752,62615,522,0,0,0,0,.00nan,0,0
38752,62949,1472,0,0,0,0,.00nan,0,0
38754,30055,1869,82,35,2,33,.943,3691000,0
38754,30156,1869,0,0,0,0,.00nan,0,0
38754,34408,1876,80,33,1,32,.970,3691000,0
38754,53248,1876,0,0,0,0,.00nan,0,0
38756,2096,1479,26,25,6,19,.760,3600000,0
38756,24867,1479,0,0,0,0,.00nan,0,0
38756,31597,4962,46,18,3,15,.833,3600000,0
38756,65044,4962,0,0,0,0,.00nan,0,0
38758,7520,3922,0,0,0,0,.00nan,0,0
38758,15610,1871,42,30,5,25,.833,3732000,0
38758,49851,3922,64,33,4,29,.879,3732000,0
38758,145668,1871,0,0,0,0,.00nan,0,0
38760,8208,1861,0,0,0,0,.00nan,0,0
38760,16204,1854,0,0,0,0,.00nan,0,0
38760,17266,1861,55,28,3,25,.893,3900000,0
38760,60964,1854,76,37,3,34,.919,3900000,0
38762,30592,517,65,36,4,32,.889,3546000,0
38762,31597,4962,0,0,0,0,.00nan,0,0
38762,62358,517,0,0,0,0,.00nan,0,0
38762,65044,4962,65,22,2,20,.909,3600000,0
38764,13613,1481,0,0,0,0,.00nan,0,0
38764,15730,1481,48,22,3,19,.864,3600000,0
38764,16204,1854,64,18,1,17,.944,3600000,0
38764,60964,1854,0,0,0,0,.00nan,0,0
38766,7520,3922,80,26,3,23,.885,3631000,0
38766,10047,522,0,0,0,0,.00nan,0,0
38766,49851,3922,0,0,0,0,.00nan,0,0
38766,62615,522,86,32,2,30,.938,3631000,0
38768,2096,1479,0,0,0,0,.00nan,0,0
38768,24867,1479,80,27,2,25,.926,3600000,0
38768,34408,1876,0,0,0,0,.00nan,0,0
38768,53248,1876,44,31,4,27,.871,3595000,0
38770,5319,1472,0,0,0,0,.00nan,0,0
38770,14428,521,62,41,5,36,.878,3543000,0
38770,52465,521,0,0,0,0,.00nan,0,0
38770,62949,1472,45,22,4,18,.818,3600000,0
38772,8208,1861,51,26,3,23,.885,3600000,0
38772,17266,1861,0,0,0,0,.00nan,0,0
38772,30055,1869,100,29,0,29,1000,3600000,0
38772,30156,1869,0,0,0,0,.00nan,0,0
38774,15610,1871,0,0,0,0,.00nan,0,0
38774,49834,1475,0,0,0,0,.00nan,0,0
38774,128255,1475,56,23,3,20,.870,3600000,0
38774,145668,1871,50,28,4,24,.857,3543000,0
38776,5319,1472,92,21,0,21,1000,3600000,0
38776,31597,4962,69,34,3,31,.912,3600000,0
38776,62949,1472,0,0,0,0,.00nan,0,0
38776,65044,4962,0,0,0,0,.00nan,0,0
38778,8208,1861,0,0,0,0,.00nan,0,0
38778,17266,1861,73,27,2,25,.926,3600000,0
38778,49834,1475,60,28,3,25,.893,3552000,0
38778,128255,1475,0,0,0,0,.00nan,0,0
38780,2096,1479,37,26,5,21,.808,3600000,0
38780,15610,1871,100,25,0,25,1000,3600000,0
38780,24867,1479,0,0,0,0,.00nan,0,0
38780,145668,1871,0,0,0,0,.00nan,0,0
38782,13613,1481,100,26,0,26,1000,3600000,0
38782,15730,1481,0,0,0,0,.00nan,0,0
38782,30592,517,0,0,0,0,.00nan,0,0
38782,62358,517,46,38,6,32,.842,3600000,0
38784,7520,3922,58,35,5,30,.857,3600000,0
38784,30055,1869,92,31,1,30,.968,3600000,0
38784,30156,1869,0,0,0,0,.00nan,0,0
38784,49851,3922,0,0,0,0,.00nan,0,0
38786,10047,522,78,37,2,35,.946,3600000,0
38786,34408,1876,73,38,3,35,.921,3600000,0
38786,53248,1876,0,0,0,0,.00nan,0,0
38786,62615,522,0,0,0,0,.00nan,0,0
38788,14428,521,96,41,1,40,.976,3566000,0
38788,16204,1854,0,0,0,0,.00nan,0,0
38788,52465,521,0,0,0,0,.00nan,0,0
38788,60964,1854,88,22,0,22,1000,3600000,0
38789,20347,1919,0,0,0,0,.00nan,0,0
38789,31971,4616,0,0,0,0,.00nan,0,0
38789,32636,4616,74,34,3,31,.912,3513000,0
38789,66133,1919,75,21,1,20,.952,3600000,0
38790,4978,2259,58,29,3,26,.897,3600000,0
38790,24427,2259,0,0,0,0,.00nan,0,0
38790,26346,1930,48,30,4,26,.867,3562000,0
38790,34843,1930,0,0,0,0,.00nan,0,0
38791,26841,2244,75,28,2,26,.929,3600000,0
38791,29945,2556,79,40,3,37,.925,3553000,0
38791,52558,2244,0,0,0,0,.00nan,0,0
38791,53939,2556,0,0,0,0,.00nan,0,0
38792,15311,1937,0,0,0,0,.00nan,0,0
38792,15787,1937,56,29,4,25,.862,3559000,0
38792,26410,1923,79,30,2,28,.933,3600000,0
38792,32858,1923,0,0,0,0,.00nan,0,0
38793,9067,2280,0,0,0,0,.00nan,0,0
38793,11715,1933,0,0,0,0,.00nan,0,0
38793,12365,1933,69,19,1,18,.947,3600000,0
38793,48706,2280,80,34,4,30,.882,3600000,0
38794,20347,1919,85,34,2,32,.941,3600000,0
38794,31971,4616,0,0,0,0,.00nan,0,0
38794,32636,4616,62,36,4,32,.889,3539000,0
38794,66133,1919,0,0,0,0,.00nan,0,0
38795,15311,1937,55,39,5,34,.872,3600000,0
38795,15787,1937,0,0,0,0,.00nan,0,0
38795,31942,1920,0,0,0,0,.00nan,0,0
38795,52860,1920,36,27,6,21,.778,3570000,0
38796,30892,579,0,0,0,0,.00nan,0,0
38796,30936,2256,25,27,6,21,.778,2689000,0
38796,36248,579,64,28,3,25,.893,3600000,0
38796,75312,2256,48,6,1,5,.833,911000,0
38797,9067,2280,57,25,3,22,.880,3600000,0
38797,11715,1933,0,0,0,0,.00nan,0,0
38797,12365,1933,65,35,4,31,.886,3550000,0
38797,48706,2280,0,0,0,0,.00nan,0,0
38798,26841,2244,44,6,1,5,.833,339000,0
38798,29945,2556,46,13,2,11,.846,816000,0
38798,52558,2244,20,30,7,23,.767,3261000,0
38798,53939,2556,28,35,7,28,.800,2731000,0
38799,4978,2259,0,0,0,0,.00nan,0,0
38799,24427,2259,39,23,4,19,.826,3574000,0
38799,26346,1930,0,0,0,0,.00nan,0,0
38799,34843,1930,84,43,3,40,.930,3600000,0
38800,30892,579,63,29,3,26,.897,3600000,0
38800,30936,2256,0,0,0,0,.00nan,0,0
38800,36248,579,0,0,0,0,.00nan,0,0
38800,75312,2256,57,36,4,32,.889,3571000,0
38801,26410,1923,36,10,3,7,.700,497000,0
38801,31942,1920,45,18,3,15,.833,3600000,0
38801,32858,1923,22,28,6,22,.786,3103000,0
38801,52860,1920,0,0,0,0,.00nan,0,0
38802,15311,1937,0,0,0,0,.00nan,0,0
38802,15787,1937,60,30,4,26,.867,3900000,0
38802,26410,1923,0,0,0,0,.00nan,0,0
38802,32858,1923,53,34,4,30,.882,3900000,0
38803,30936,2256,39,30,5,25,.833,3600000,0
38803,31942,1920,54,27,3,24,.889,3600000,0
38803,52860,1920,0,0,0,0,.00nan,0,0
38803,75312,2256,0,0,0,0,.00nan,0,0
38804,9067,2280,0,0,0,0,.00nan,0,0
38804,30892,579,0,0,0,0,.00nan,0,0
38804,36248,579,69,33,3,30,.909,3592000,0
38804,48706,2280,88,31,1,30,.968,3600000,0
38805,4978,2259,0,0,0,0,.00nan,0,0
38805,24427,2259,61,34,4,30,.882,3569000,0
38805,29945,2556,0,0,0,0,.00nan,0,0
38805,53939,2556,65,31,3,28,.903,3600000,0
38806,11715,1933,0,0,0,0,.00nan,0,0
38806,12365,1933,57,33,4,29,.879,3600000,0
38806,26346,1930,24,10,4,6,.600,490000,0
38806,34843,1930,53,29,4,25,.862,3110000,0
38807,9067,2280,18,24,6,18,.750,3069000,0
38807,20347,1919,0,0,0,0,.00nan,0,0
38807,48706,2280,47,6,1,5,.833,531000,0
38807,66133,1919,73,42,4,38,.905,3600000,0
38808,11715,1933,0,0,0,0,.00nan,0,0
38808,12365,1933,80,43,4,39,.907,3583000,0
38808,26841,2244,0,0,0,0,.00nan,0,0
38808,52558,2244,68,21,2,19,.905,3600000,0
38809,4978,2259,18,33,8,25,.758,3600000,0
38809,24427,2259,0,0,0,0,.00nan,0,0
38809,30936,2256,0,0,0,0,.00nan,0,0
38809,75312,2256,76,35,3,32,.914,3600000,0
38810,26346,1930,73,32,2,30,.938,3552000,0
38810,29945,2556,0,0,0,0,.00nan,0,0
38810,34843,1930,0,0,0,0,.00nan,0,0
38810,53939,2556,97,34,1,33,.971,3600000,0
38811,4978,2259,0,0,0,0,.00nan,0,0
38811,24427,2259,68,26,2,24,.923,3600000,0
38811,26841,2244,44,42,6,36,.857,3600000,0
38811,52558,2244,0,0,0,0,.00nan,0,0
38812,9067,2280,23,18,5,13,.722,3513000,0
38812,15311,1937,0,0,0,0,.00nan,0,0
38812,15787,1937,83,37,3,34,.919,3600000,0
38812,48706,2280,0,0,0,0,.00nan,0,0
38813,11715,1933,0,0,0,0,.00nan,0,0
38813,12365,1933,75,28,2,26,.929,3615000,0
38813,26410,1923,88,31,1,30,.968,3615000,0
38813,32858,1923,0,0,0,0,.00nan,0,0
38814,4978,2259,81,42,3,39,.929,3599000,0
38814,24427,2259,0,0,0,0,.00nan,0,0
38814,26410,1923,0,0,0,0,.00nan,0,0
38814,32858,1923,78,31,2,29,.935,3600000,0
38815,20347,1919,0,0,0,0,.00nan,0,0
38815,31942,1920,0,0,0,0,.00nan,0,0
38815,52860,1920,97,52,3,49,.942,3589000,0
38815,66133,1919,61,23,2,21,.913,3600000,0
38816,26346,1930,38,37,6,31,.838,3569000,0
38816,30892,579,46,35,5,30,.857,3600000,0
38816,34843,1930,0,0,0,0,.00nan,0,0
38816,36248,579,0,0,0,0,.00nan,0,0
38817,15311,1937,65,34,4,30,.882,3600000,0
38817,15787,1937,0,0,0,0,.00nan,0,0
38817,30936,2256,64,22,2,20,.909,2561000,0
38817,75312,2256,12,13,6,7,.538,1039000,0
38818,26841,2244,0,0,0,0,.00nan,0,0
38818,31971,4616,0,0,0,0,.00nan,0,0
38818,32636,4616,75,28,2,26,.929,3561000,0
38818,52558,2244,96,31,1,30,.968,3600000,0
38819,20347,1919,0,0,0,0,.00nan,0,0
38819,29945,2556,56,17,2,15,.882,1586000,0
38819,53939,2556,57,34,4,30,.882,2014000,0
38819,66133,1919,51,19,3,16,.842,3600000,0
38820,26346,1930,0,0,0,0,.00nan,0,0
38820,31971,4616,58,20,2,18,.900,3339000,0
38820,32636,4616,22,4,3,1,.250,234000,0
38820,34843,1930,72,42,4,38,.905,3600000,0
38821,31942,1920,66,12,0,12,1000,1369000,0
38821,31971,4616,0,0,0,0,.00nan,0,0
38821,32636,4616,81,48,5,43,.896,3600000,0
38821,52860,1920,9,14,6,8,.571,2202000,0
38822,26346,1930,66,29,2,27,.931,3600000,0
38822,31942,1920,0,0,0,0,.00nan,0,0
38822,34843,1930,0,0,0,0,.00nan,0,0
38822,52860,1920,47,34,5,29,.853,3600000,0
38823,29945,2556,68,19,2,17,.895,1255000,0
38823,30892,579,73,26,2,24,.923,3600000,0
38823,36248,579,0,0,0,0,.00nan,0,0
38823,53939,2556,33,24,5,19,.792,2345000,0
38824,11715,1933,0,0,0,0,.00nan,0,0
38824,12365,1933,62,18,1,17,.944,3600000,0
38824,31971,4616,0,0,0,0,.00nan,0,0
38824,32636,4616,66,35,4,31,.886,3600000,0
38825,9067,2280,0,0,0,0,.00nan,0,0
38825,26841,2244,40,19,4,15,.789,3600000,0
38825,48706,2280,61,41,5,36,.878,3565000,0
38825,52558,2244,0,0,0,0,.00nan,0,0
38826,4978,2259,0,0,0,0,.00nan,0,0
38826,15311,1937,0,0,0,0,.00nan,0,0
38826,15787,1937,59,25,3,22,.880,3600000,0
38826,24427,2259,65,42,4,38,.905,3547000,0
38827,26841,2244,0,0,0,0,.00nan,0,0
38827,30936,2256,75,42,4,38,.905,3568000,0
38827,52558,2244,61,32,3,29,.906,3600000,0
38827,75312,2256,0,0,0,0,.00nan,0,0
38828,4978,2259,21,25,6,19,.760,3600000,0
38828,11715,1933,0,0,0,0,.00nan,0,0
38828,12365,1933,73,29,3,26,.897,3600000,0
38828,24427,2259,0,0,0,0,.00nan,0,0
38829,26346,1930,0,0,0,0,.00nan,0,0
38829,26410,1923,66,23,2,21,.913,3600000,0
38829,32858,1923,0,0,0,0,.00nan,0,0
38829,34843,1930,64,35,3,32,.914,3545000,0
38830,9067,2280,0,0,0,0,.00nan,0,0
38830,31971,4616,0,0,0,0,.00nan,0,0
38830,32636,4616,84,36,2,34,.944,3790000,0
38830,48706,2280,93,42,3,39,.929,3790000,0
38831,11715,1933,0,0,0,0,.00nan,0,0
38831,12365,1933,76,30,3,27,.900,3600000,0
38831,15311,1937,65,35,4,31,.886,3584000,0
38831,15787,1937,0,0,0,0,.00nan,0,0
38832,26410,1923,68,36,3,33,.917,3600000,0
38832,31942,1920,0,0,0,0,.00nan,0,0
38832,32858,1923,0,0,0,0,.00nan,0,0
38832,52860,1920,42,31,5,26,.839,3541000,0
38833,15311,1937,0,0,0,0,.00nan,0,0
38833,15787,1937,60,29,3,26,.897,3600000,0
38833,31971,4616,43,31,5,26,.839,3550000,0
38833,32636,4616,0,0,0,0,.00nan,0,0
38834,30892,579,35,33,6,27,.818,3545000,0
38834,31942,1920,49,31,5,26,.839,3600000,0
38834,36248,579,0,0,0,0,.00nan,0,0
38834,52860,1920,0,0,0,0,.00nan,0,0
38835,20347,1919,0,0,0,0,.00nan,0,0
38835,26346,1930,51,25,3,22,.880,3627000,0
38835,34843,1930,0,0,0,0,.00nan,0,0
38835,66133,1919,55,33,4,29,.879,3627000,0
38836,29945,2556,54,4,0,4,1000,714000,0
38836,30936,2256,76,37,3,34,.919,3600000,0
38836,53939,2556,41,36,6,30,.833,2886000,0
38836,75312,2256,0,0,0,0,.00nan,0,0
38837,20347,1919,0,0,0,0,.00nan,0,0
38837,26841,2244,0,0,0,0,.00nan,0,0
38837,52558,2244,83,34,1,33,.971,3600000,0
38837,66133,1919,29,35,7,28,.800,3600000,0
38838,30892,579,0,0,0,0,.00nan,0,0
38838,30936,2256,100,38,2,36,.947,3600000,0
38838,36248,579,44,31,5,26,.839,3600000,0
38838,75312,2256,0,0,0,0,.00nan,0,0
38839,26410,1923,53,16,3,13,.813,3600000,0
38839,29945,2556,29,16,4,12,.750,860000,0
38839,32858,1923,0,0,0,0,.00nan,0,0
38839,53939,2556,60,32,3,29,.906,2740000,0
38840,26346,1930,19,8,4,4,.500,822000,0
38840,26841,2244,0,0,0,0,.00nan,0,0
38840,34843,1930,91,28,1,27,.964,2746000,0
38840,52558,2244,52,23,3,20,.870,3600000,0
38841,26410,1923,100,27,0,27,1000,3600000,0
38841,31971,4616,0,0,0,0,.00nan,0,0
38841,32636,4616,49,32,4,28,.875,3600000,0
38841,32858,1923,0,0,0,0,.00nan,0,0
38842,26410,1923,52,37,5,32,.865,3592000,0
38842,30936,2256,66,31,4,27,.871,3600000,0
38842,32858,1923,0,0,0,0,.00nan,0,0
38842,75312,2256,0,0,0,0,.00nan,0,0
38843,15311,1937,0,0,0,0,.00nan,0,0
38843,15787,1937,90,42,3,39,.929,3600000,0
38843,31942,1920,56,34,5,29,.853,3595000,0
38843,52860,1920,0,0,0,0,.00nan,0,0
38844,11715,1933,0,0,0,0,.00nan,0,0
38844,12365,1933,100,40,0,40,1000,3600000,0
38844,30892,579,50,23,3,20,.870,3600000,0
38844,36248,579,0,0,0,0,.00nan,0,0
38845,4978,2259,0,0,0,0,.00nan,0,0
38845,9067,2280,0,0,0,0,.00nan,0,0
38845,24427,2259,69,25,2,23,.920,3900000,0
38845,48706,2280,100,44,2,42,.955,3900000,0
38846,15311,1937,54,22,3,19,.864,3600000,0
38846,15787,1937,0,0,0,0,.00nan,0,0
38846,30892,579,35,11,3,8,.727,1241000,0
38846,36248,579,36,18,4,14,.778,2359000,0
38847,4978,2259,61,26,3,23,.885,3600000,0
38847,20347,1919,36,21,4,17,.810,3600000,0
38847,24427,2259,0,0,0,0,.00nan,0,0
38847,66133,1919,0,0,0,0,.00nan,0,0
38848,9067,2280,100,34,1,33,.971,3600000,0
38848,29945,2556,64,40,5,35,.875,3600000,0
38848,48706,2280,0,0,0,0,.00nan,0,0
38848,53939,2556,0,0,0,0,.00nan,0,0
38849,11715,1933,0,0,0,0,.00nan,0,0
38849,12365,1933,36,44,8,36,.818,3600000,0
38849,31971,4616,0,0,0,0,.00nan,0,0
38849,32636,4616,67,23,2,21,.913,3600000,0
38972,4978,2259,0,0,0,0,.00nan,0,0
38972,24427,2259,57,41,6,35,.854,3600000,0
38972,26841,2244,40,2,1,1,.500,345000,0
38972,52558,2244,36,35,6,29,.829,3247000,0
38974,11715,1933,0,0,0,0,.00nan,0,0
38974,30709,1933,48,20,3,17,.850,3600000,0
38974,30892,579,27,30,6,24,.800,3600000,0
38974,36248,579,0,0,0,0,.00nan,0,0
38976,20005,1930,0,0,0,0,.00nan,0,0
38976,31942,1920,74,29,1,28,.966,3600000,0
38976,34843,1930,75,34,3,31,.912,3600000,0
38976,65207,1920,0,0,0,0,.00nan,0,0
38978,29945,2556,0,0,0,0,.00nan,0,0
38978,30936,2256,89,35,1,34,.971,3600000,0
38978,53939,2556,47,28,4,24,.857,3600000,0
38978,75312,2256,0,0,0,0,.00nan,0,0
38980,15311,1937,0,0,0,0,.00nan,0,0
38980,15787,1937,59,23,3,20,.870,3900000,0
38980,20347,1919,64,30,3,27,.900,3900000,0
38980,34341,1919,0,0,0,0,.00nan,0,0
38982,26410,1923,89,40,2,38,.950,3558000,0
38982,31971,4616,0,0,0,0,.00nan,0,0
38982,32636,4616,100,23,0,23,1000,3600000,0
38982,32858,1923,0,0,0,0,.00nan,0,0
38984,15311,1937,24,28,6,22,.786,3592000,0
38984,15787,1937,0,0,0,0,.00nan,0,0
38984,20005,1930,58,30,4,26,.867,3600000,0
38984,34843,1930,0,0,0,0,.00nan,0,0
38986,30892,579,14,29,7,22,.759,3600000,0
38986,30936,2256,56,32,4,28,.875,3600000,0
38986,36248,579,0,0,0,0,.00nan,0,0
38986,75312,2256,0,0,0,0,.00nan,0,0
38988,26841,2244,76,39,3,36,.923,3600000,0
38988,31942,1920,37,23,4,19,.826,3557000,0
38988,52558,2244,0,0,0,0,.00nan,0,0
38988,65207,1920,0,0,0,0,.00nan,0,0
38990,9067,2280,0,0,0,0,.00nan,0,0
38990,31971,4616,0,0,0,0,.00nan,0,0
38990,32636,4616,81,36,2,34,.944,3600000,0
38990,48706,2280,72,35,3,32,.914,3589000,0
38992,4978,2259,63,39,4,35,.897,3565000,0
38992,20347,1919,0,0,0,0,.00nan,0,0
38992,24427,2259,0,0,0,0,.00nan,0,0
38992,34341,1919,56,22,3,19,.864,3600000,0
38994,11715,1933,85,35,3,32,.914,3706000,0
38994,26410,1923,71,27,2,25,.926,3706000,0
38994,30709,1933,0,0,0,0,.00nan,0,0
38994,32858,1923,0,0,0,0,.00nan,0,0
38996,15311,1937,0,0,0,0,.00nan,0,0
38996,15787,1937,72,36,4,32,.889,3600000,0
38996,26410,1923,0,0,0,0,.00nan,0,0
38996,32858,1923,79,26,1,25,.962,3600000,0
38998,20347,1919,51,23,3,20,.870,3600000,0
38998,30936,2256,0,0,0,0,.00nan,0,0
38998,34341,1919,0,0,0,0,.00nan,0,0
38998,75312,2256,53,34,4,30,.882,3586000,0
39000,4978,2259,0,0,0,0,.00nan,0,0
39000,20005,1930,0,0,0,0,.00nan,0,0
39000,24427,2259,100,28,0,28,1000,3600000,0
39000,34843,1930,55,23,3,20,.870,3600000,0
39002,9067,2280,30,33,7,26,.788,3648000,0
39002,11715,1933,51,1,0,1,1000,424000,0
39002,30709,1933,40,38,6,32,.842,3224000,0
39002,48706,2280,0,0,0,0,.00nan,0,0
39004,29945,2556,19,30,7,23,.767,3600000,0
39004,31971,4616,61,23,2,21,.913,3600000,0
39004,32636,4616,0,0,0,0,.00nan,0,0
39004,53939,2556,0,0,0,0,.00nan,0,0
39006,26841,2244,0,0,0,0,.00nan,0,0
39006,31942,1920,0,0,0,0,.00nan,0,0
39006,52558,2244,91,36,1,35,.972,3600000,0
39006,65207,1920,67,32,4,28,.875,3600000,0
39008,15311,1937,0,0,0,0,.00nan,0,0
39008,15787,1937,66,47,6,41,.872,3569000,0
39008,31942,1920,45,28,5,23,.821,3600000,0
39008,65207,1920,0,0,0,0,.00nan,0,0
39010,26410,1923,84,19,1,18,.947,3600000,0
39010,29945,2556,24,28,6,22,.786,2332000,0
39010,32858,1923,0,0,0,0,.00nan,0,0
39010,53939,2556,56,14,1,13,.929,1268000,0
39012,26841,2244,0,0,0,0,.00nan,0,0
39012,30892,579,0,0,0,0,.00nan,0,0
39012,36248,579,75,23,1,22,.957,3600000,0
39012,52558,2244,53,39,5,34,.872,3600000,0
39014,20005,1930,0,0,0,0,.00nan,0,0
39014,30936,2256,59,22,3,19,.864,3530000,0
39014,34843,1930,89,32,1,31,.969,3600000,0
39014,75312,2256,0,0,0,0,.00nan,0,0
39016,4978,2259,0,0,0,0,.00nan,0,0
39016,11715,1933,59,24,3,21,.875,3600000,0
39016,24427,2259,51,29,4,25,.862,3566000,0
39016,30709,1933,0,0,0,0,.00nan,0,0
39018,20347,1919,31,9,3,6,.667,418000,0
39018,31971,4616,0,0,0,0,.00nan,0,0
39018,32636,4616,37,22,4,18,.818,3600000,0
39018,34341,1919,67,29,2,27,.931,3182000,0
39019,21732,2161,60,9,0,9,1000,1202000,0
39019,21777,2163,0,0,0,0,.00nan,0,0
39019,21794,2161,28,21,5,16,.762,2398000,0
39019,27322,2163,64,19,1,18,.947,3600000,0
39020,2296,2158,63,19,1,18,.947,3600000,0
39020,20934,4840,43,36,6,30,.833,3600000,0
39020,45377,2158,0,0,0,0,.00nan,0,0
39020,78555,4840,0,0,0,0,.00nan,0,0
39021,21732,2161,66,35,4,31,.886,3600000,0
39021,21777,2163,80,27,1,26,.963,3600000,0
39021,21794,2161,0,0,0,0,.00nan,0,0
39021,27322,2163,0,0,0,0,.00nan,0,0
39022,2296,2158,0,0,0,0,.00nan,0,0
39022,20934,4840,0,0,0,0,.00nan,0,0
39022,45377,2158,75,21,1,20,.952,3600000,0
39022,78555,4840,87,49,4,45,.918,3600000,0
39023,2296,2158,47,36,5,31,.861,3600000,0
39023,21777,2163,0,0,0,0,.00nan,0,0
39023,27322,2163,72,33,2,31,.939,3600000,0
39023,45377,2158,0,0,0,0,.00nan,0,0
39024,14570,2162,0,0,0,0,.00nan,0,0
39024,21732,2161,62,19,2,17,.895,3575000,0
39024,21794,2161,0,0,0,0,.00nan,0,0
39024,27042,2162,95,39,1,38,.974,3600000,0
39025,20934,4840,0,0,0,0,.00nan,0,0
39025,21748,2164,42,32,5,27,.844,3600000,0
39025,27250,2164,0,0,0,0,.00nan,0,0
39025,78555,4840,100,42,1,41,.976,3600000,0
39026,2296,2158,0,0,0,0,.00nan,0,0
39026,21777,2163,53,37,6,31,.838,3600000,0
39026,27322,2163,0,0,0,0,.00nan,0,0
39026,45377,2158,83,27,1,26,.963,3600000,0
39027,14570,2162,82,41,3,38,.927,3599000,0
39027,21732,2161,0,0,0,0,.00nan,0,0
39027,21794,2161,70,32,2,30,.938,3600000,0
39027,27042,2162,0,0,0,0,.00nan,0,0
39028,20934,4840,69,37,3,34,.919,3600000,0
39028,21748,2164,0,0,0,0,.00nan,0,0
39028,27250,2164,72,22,2,20,.909,3600000,0
39028,78555,4840,0,0,0,0,.00nan,0,0
39029,20934,4840,0,0,0,0,.00nan,0,0
39029,21732,2161,100,21,0,21,1000,3600000,0
39029,21794,2161,0,0,0,0,.00nan,0,0
39029,78555,4840,93,30,1,29,.967,3551000,0
39030,2296,2158,28,24,5,19,.792,3578000,0
39030,14570,2162,0,0,0,0,.00nan,0,0
39030,27042,2162,70,42,3,39,.929,3600000,0
39030,45377,2158,0,0,0,0,.00nan,0,0
39031,21748,2164,0,0,0,0,.00nan,0,0
39031,21777,2163,45,25,3,22,.880,3600000,0
39031,27250,2164,86,36,2,34,.944,3600000,0
39031,27322,2163,0,0,0,0,.00nan,0,0
39032,20934,4840,57,29,3,26,.897,3600000,0
39032,21732,2161,90,21,0,21,1000,3600000,0
39032,21794,2161,0,0,0,0,.00nan,0,0
39032,78555,4840,0,0,0,0,.00nan,0,0
39033,2296,2158,0,0,0,0,.00nan,0,0
39033,14570,2162,58,36,4,32,.889,3561000,0
39033,27042,2162,0,0,0,0,.00nan,0,0
39033,45377,2158,63,26,2,24,.923,3600000,0
39034,21748,2164,57,45,5,40,.889,3600000,0
39034,21777,2163,0,0,0,0,.00nan,0,0
39034,27250,2164,0,0,0,0,.00nan,0,0
39034,27322,2163,70,18,1,17,.944,3600000,0
39035,2296,2158,75,31,2,29,.935,3600000,0
39035,21732,2161,32,28,6,22,.786,1508000,0
39035,21794,2161,43,21,3,18,.857,2092000,0
39035,45377,2158,0,0,0,0,.00nan,0,0
39036,14570,2162,80,48,4,44,.917,3574000,0
39036,21748,2164,0,0,0,0,.00nan,0,0
39036,27042,2162,0,0,0,0,.00nan,0,0
39036,27250,2164,64,21,2,19,.905,3600000,0
39037,20934,4840,0,0,0,0,.00nan,0,0
39037,21777,2163,82,36,2,34,.944,3900000,0
39037,27322,2163,0,0,0,0,.00nan,0,0
39037,78555,4840,79,30,2,28,.933,3900000,0
39038,2296,2158,0,0,0,0,.00nan,0,0
39038,21732,2161,79,36,3,33,.917,3600000,0
39038,21794,2161,0,0,0,0,.00nan,0,0
39038,45377,2158,39,36,5,31,.861,3539000,0
39039,14570,2162,0,0,0,0,.00nan,0,0
39039,21748,2164,58,18,2,16,.889,3647000,0
39039,27042,2162,96,42,1,41,.976,3647000,0
39039,27250,2164,0,0,0,0,.00nan,0,0
39040,20934,4840,75,40,4,36,.900,3590000,0
39040,21777,2163,0,0,0,0,.00nan,0,0
39040,27322,2163,56,31,3,28,.903,3600000,0
39040,78555,4840,0,0,0,0,.00nan,0,0
39041,21732,2161,88,32,2,30,.938,3600000,0
39041,21748,2164,50,29,4,25,.862,3600000,0
39041,21794,2161,0,0,0,0,.00nan,0,0
39041,27250,2164,0,0,0,0,.00nan,0,0
39042,12198,2162,0,0,0,0,.00nan,0,0
39042,14570,2162,82,38,2,36,.947,3571000,0
39042,21777,2163,0,0,0,0,.00nan,0,0
39042,27322,2163,97,40,1,39,.975,3600000,0
39043,7963,2158,0,0,0,0,.00nan,0,0
39043,20934,4840,0,0,0,0,.00nan,0,0
39043,45377,2158,78,31,2,29,.935,3900000,0
39043,78555,4840,92,47,2,45,.957,3900000,0
39044,21732,2161,0,0,0,0,.00nan,0,0
39044,21748,2164,0,0,0,0,.00nan,0,0
39044,21794,2161,71,31,3,28,.903,3600000,0
39044,27250,2164,93,37,2,35,.946,3600000,0
39045,12198,2162,45,37,5,32,.865,3600000,0
39045,14570,2162,0,0,0,0,.00nan,0,0
39045,21777,2163,83,34,2,32,.941,3600000,0
39045,27322,2163,0,0,0,0,.00nan,0,0
39046,7963,2158,56,27,3,24,.889,3600000,0
39046,20934,4840,61,47,5,42,.894,3598000,0
39046,45377,2158,0,0,0,0,.00nan,0,0
39046,78555,4840,0,0,0,0,.00nan,0,0
39047,7963,2158,70,15,1,14,.933,3600000,0
39047,21732,2161,0,0,0,0,.00nan,0,0
39047,21794,2161,76,50,4,46,.920,3600000,0
39047,45377,2158,0,0,0,0,.00nan,0,0
39048,12198,2162,73,23,1,22,.957,3600000,0
39048,14570,2162,0,0,0,0,.00nan,0,0
39048,20934,4840,0,0,0,0,.00nan,0,0
39048,78555,4840,91,52,3,49,.942,3591000,0
39049,2296,2158,0,0,0,0,.00nan,0,0
39049,21732,2161,34,27,6,21,.778,2936000,0
39049,21794,2161,47,3,1,2,.667,664000,0
39049,45377,2158,56,25,3,22,.880,3600000,0
39050,12198,2162,0,0,0,0,.00nan,0,0
39050,14570,2162,79,37,3,34,.919,3900000,0
39050,20934,4840,75,34,3,31,.912,3900000,0
39050,78555,4840,0,0,0,0,.00nan,0,0
39051,20934,4840,0,0,0,0,.00nan,0,0
39051,21777,2163,0,0,0,0,.00nan,0,0
39051,27322,2163,76,40,4,36,.900,3638000,0
39051,78555,4840,63,32,3,29,.906,3638000,0
39052,2296,2158,61,23,3,20,.870,3900000,0
39052,12198,2162,93,44,3,41,.932,3900000,0
39052,27042,2162,0,0,0,0,.00nan,0,0
39052,45377,2158,0,0,0,0,.00nan,0,0
39053,21732,2161,79,32,2,30,.938,3900000,0
39053,21748,2164,70,36,2,34,.944,3890000,0
39053,21794,2161,0,0,0,0,.00nan,0,0
39053,27250,2164,0,0,0,0,.00nan,0,0
39054,20934,4840,0,0,0,0,.00nan,0,0
39054,21777,2163,94,30,1,29,.967,3900000,0
39054,27322,2163,0,0,0,0,.00nan,0,0
39054,78555,4840,96,45,1,44,.978,3900000,0
39055,2296,2158,63,20,2,18,.900,2595000,0
39055,12198,2162,0,0,0,0,.00nan,0,0
39055,27042,2162,84,50,5,45,.900,3779000,0
39055,45377,2158,21,11,4,7,.636,1184000,0
39056,21732,2161,0,0,0,0,.00nan,0,0
39056,21748,2164,0,0,0,0,.00nan,0,0
39056,21794,2161,76,30,2,28,.933,3600000,0
39056,27250,2164,71,48,4,44,.917,3600000,0
39057,12198,2162,69,41,4,37,.902,3547000,0
39057,21732,2161,74,34,2,32,.941,3600000,0
39057,21794,2161,0,0,0,0,.00nan,0,0
39057,27042,2162,0,0,0,0,.00nan,0,0
39058,2296,2158,77,23,1,22,.957,3600000,0
39058,21748,2164,0,0,0,0,.00nan,0,0
39058,27250,2164,71,42,4,38,.905,3600000,0
39058,45377,2158,0,0,0,0,.00nan,0,0
39059,20934,4840,0,0,0,0,.00nan,0,0
39059,21777,2163,63,42,5,37,.881,3600000,0
39059,27322,2163,0,0,0,0,.00nan,0,0
39059,78555,4840,50,39,6,33,.846,3600000,0
39060,12198,2162,0,0,0,0,.00nan,0,0
39060,21732,2161,0,0,0,0,.00nan,0,0
39060,21794,2161,76,21,1,20,.952,3600000,0
39060,27042,2162,75,40,3,37,.925,3539000,0
39061,2296,2158,0,0,0,0,.00nan,0,0
39061,21748,2164,84,39,3,36,.923,3900000,0
39061,27250,2164,0,0,0,0,.00nan,0,0
39061,45377,2158,65,28,3,25,.893,3900000,0
39062,20934,4840,95,40,1,39,.975,3600000,0
39062,21777,2163,0,0,0,0,.00nan,0,0
39062,27322,2163,42,27,4,23,.852,3600000,0
39062,78555,4840,0,0,0,0,.00nan,0,0
39140,20934,2161,82,33,1,32,.970,3600000,0
39140,21732,2161,0,0,0,0,.00nan,0,0
39140,21794,2164,35,27,5,22,.815,3600000,0
39140,32765,2164,0,0,0,0,.00nan,0,0
39142,2296,2158,50,14,2,12,.857,3600000,0
39142,21748,4840,0,0,0,0,.00nan,0,0
39142,23108,2158,0,0,0,0,.00nan,0,0
39142,78555,4840,89,44,3,41,.932,3559000,0
39144,21777,2163,0,0,0,0,.00nan,0,0
39144,23118,2162,0,0,0,0,.00nan,0,0
39144,27042,2162,100,30,0,30,1000,3600000,0
39144,27322,2163,52,33,5,28,.848,3600000,0
39146,20934,2161,24,22,6,16,.727,3600000,0
39146,21732,2161,0,0,0,0,.00nan,0,0
39146,21777,2163,75,30,2,28,.933,3600000,0
39146,27322,2163,0,0,0,0,.00nan,0,0
39148,21748,4840,0,0,0,0,.00nan,0,0
39148,23118,2162,0,0,0,0,.00nan,0,0
39148,27042,2162,83,35,3,32,.914,3561000,0
39148,78555,4840,90,32,1,31,.969,3600000,0
39150,2296,2158,59,25,2,23,.920,3600000,0
39150,21794,2164,39,36,5,31,.861,3600000,0
39150,23108,2158,0,0,0,0,.00nan,0,0
39150,32765,2164,0,0,0,0,.00nan,0,0
39152,21794,2164,0,0,0,0,.00nan,0,0
39152,23118,2162,67,44,5,39,.886,3742000,0
39152,27042,2162,0,0,0,0,.00nan,0,0
39152,32765,2164,50,22,4,18,.818,3742000,0
39154,2296,2158,0,0,0,0,.00nan,0,0
39154,20934,2161,0,0,0,0,.00nan,0,0
39154,21732,2161,99,47,2,45,.957,3900000,0
39154,23108,2158,68,24,2,22,.917,3900000,0
39156,21748,4840,0,0,0,0,.00nan,0,0
39156,21777,2163,0,0,0,0,.00nan,0,0
39156,27322,2163,100,24,0,24,1000,3600000,0
39156,78555,4840,72,22,1,21,.955,3553000,0
39158,21777,2163,0,0,0,0,.00nan,0,0
39158,23118,2162,77,28,2,26,.929,2723000,0
39158,27042,2162,29,12,4,8,.667,877000,0
39158,27322,2163,94,41,2,39,.951,3600000,0
39160,2296,2158,34,12,3,9,.750,3600000,0
39160,21748,4840,0,0,0,0,.00nan,0,0
39160,23108,2158,0,0,0,0,.00nan,0,0
39160,78555,4840,56,50,7,43,.860,3600000,0
39162,20934,2161,73,26,1,25,.962,3544000,0
39162,21732,2161,0,0,0,0,.00nan,0,0
39162,21794,2164,100,31,0,31,1000,3600000,0
39162,32765,2164,0,0,0,0,.00nan,0,0
39164,2296,2158,0,0,0,0,.00nan,0,0
39164,21777,2163,18,26,6,20,.769,1794000,0
39164,23108,2158,56,18,2,16,.889,3600000,0
39164,27322,2163,73,19,0,19,1000,1806000,0
39166,20934,2161,0,0,0,0,.00nan,0,0
39166,21732,2161,61,27,3,24,.889,3548000,0
39166,23118,2162,0,0,0,0,.00nan,0,0
39166,27042,2162,90,43,2,41,.953,3600000,0
39168,21748,4840,0,0,0,0,.00nan,0,0
39168,21794,2164,0,0,0,0,.00nan,0,0
39168,32765,2164,63,31,3,28,.903,3892000,0
39168,78555,4840,51,25,4,21,.840,3892000,0
39170,20934,2161,78,22,1,21,.955,3600000,0
39170,21732,2161,0,0,0,0,.00nan,0,0
39170,21748,4840,0,0,0,0,.00nan,0,0
39170,78555,4840,89,40,2,38,.950,3571000,0
39172,2296,2158,97,40,1,39,.975,3900000,0
39172,21777,2163,81,35,1,34,.971,3900000,0
39172,23108,2158,0,0,0,0,.00nan,0,0
39172,27322,2163,0,0,0,0,.00nan,0,0
39174,21794,2164,37,26,5,21,.808,3600000,0
39174,23118,2162,0,0,0,0,.00nan,0,0
39174,27042,2162,90,31,2,29,.935,3600000,0
39174,32765,2164,0,0,0,0,.00nan,0,0
39175,7540,3797,76,28,1,27,.964,3600000,0
39175,14229,3800,64,44,5,39,.886,3600000,0
39175,35017,3797,0,0,0,0,.00nan,0,0
39175,35568,3800,0,0,0,0,.00nan,0,0
39176,14388,3796,49,1,0,1,1000,279000,0
39176,29919,3795,0,0,0,0,.00nan,0,0
39176,35125,3795,73,32,3,29,.906,3600000,0
39176,35378,3796,47,44,7,37,.841,3321000,0
39177,2968,4999,95,32,2,30,.938,3900000,0
39177,4618,3798,0,0,0,0,.00nan,0,0
39177,20018,4999,0,0,0,0,.00nan,0,0
39177,35119,3798,95,43,2,41,.953,3900000,0
39178,2968,4999,0,0,0,0,.00nan,0,0
39178,20018,4999,49,40,6,34,.850,3600000,0
39178,29919,3795,87,30,1,29,.967,3600000,0
39178,35125,3795,0,0,0,0,.00nan,0,0
39179,3855,4635,0,0,0,0,.00nan,0,0
39179,14229,3800,0,0,0,0,.00nan,0,0
39179,29928,4635,58,13,1,12,.923,3617000,0
39179,35568,3800,92,47,2,45,.957,3617000,0
39180,2968,4999,77,47,5,42,.894,3600000,0
39180,14229,3800,61,22,2,20,.909,3600000,0
39180,20018,4999,0,0,0,0,.00nan,0,0
39180,35568,3800,0,0,0,0,.00nan,0,0
39181,7540,3797,100,52,1,51,.981,3600000,0
39181,29919,3795,0,0,0,0,.00nan,0,0
39181,35017,3797,0,0,0,0,.00nan,0,0
39181,35125,3795,56,26,3,23,.885,3553000,0
39182,3855,4635,0,0,0,0,.00nan,0,0
39182,4618,3798,0,0,0,0,.00nan,0,0
39182,29928,4635,46,19,3,16,.842,3513000,0
39182,35119,3798,83,31,1,30,.968,3600000,0
39183,3855,4635,62,35,4,31,.886,3600000,0
39183,14388,3796,25,5,3,2,.400,435000,0
39183,29928,4635,0,0,0,0,.00nan,0,0
39183,35378,3796,73,27,2,25,.926,3151000,0
39184,2968,4999,83,22,1,21,.955,3600000,0
39184,4618,3798,81,18,0,18,1000,1317000,0
39184,20018,4999,0,0,0,0,.00nan,0,0
39184,35119,3798,33,30,6,24,.800,2283000,0
39185,14229,3800,87,37,3,34,.919,3896000,0
39185,14388,3796,0,0,0,0,.00nan,0,0
39185,35378,3796,64,29,3,26,.897,3900000,0
39185,35568,3800,0,0,0,0,.00nan,0,0
39186,3855,4635,0,0,0,0,.00nan,0,0
39186,7540,3797,80,32,2,30,.938,3600000,0
39186,29928,4635,71,30,3,27,.900,3551000,0
39186,35017,3797,0,0,0,0,.00nan,0,0
39187,2968,4999,0,0,0,0,.00nan,0,0
39187,7540,3797,0,0,0,0,.00nan,0,0
39187,20018,4999,47,22,4,18,.818,3514000,0
39187,35017,3797,73,29,2,27,.931,3600000,0
39188,4618,3798,0,0,0,0,.00nan,0,0
39188,14229,3800,0,0,0,0,.00nan,0,0
39188,35119,3798,55,33,4,29,.879,3544000,0
39188,35568,3800,59,20,2,18,.900,3600000,0
39189,14388,3796,61,39,5,34,.872,3556000,0
39189,29919,3795,0,0,0,0,.00nan,0,0
39189,35125,3795,73,32,3,29,.906,3600000,0
39189,35378,3796,0,0,0,0,.00nan,0,0
39302,2876,3796,0,0,0,0,.00nan,0,0
39302,2968,4999,54,42,5,37,.881,3600000,0
39302,20018,4999,0,0,0,0,.00nan,0,0
39302,35378,3796,64,20,2,18,.900,3600000,0
39304,3855,4635,34,18,4,14,.778,3600000,0
39304,7540,3797,0,0,0,0,.00nan,0,0
39304,29928,4635,0,0,0,0,.00nan,0,0
39304,35017,3797,30,42,8,34,.810,3600000,0
39306,4618,3798,65,13,1,12,.923,935000,0
39306,29919,3795,0,0,0,0,.00nan,0,0
39306,35119,3798,28,24,6,18,.750,2665000,0
39306,35125,3795,92,29,1,28,.966,3600000,0
39308,2968,4999,0,0,0,0,.00nan,0,0
39308,4618,3798,0,0,0,0,.00nan,0,0
39308,20018,4999,62,42,4,38,.905,3600000,0
39308,35119,3798,34,36,7,29,.806,3600000,0
39310,2876,3796,0,0,0,0,.00nan,0,0
39310,3855,4635,0,0,0,0,.00nan,0,0
39310,29928,4635,63,35,4,31,.886,3900000,0
39310,35378,3796,55,30,4,26,.867,3875000,0
39312,7540,3797,0,0,0,0,.00nan,0,0
39312,14229,3800,66,25,2,23,.920,3600000,0
39312,35017,3797,40,37,6,31,.838,3600000,0
39312,35568,3800,0,0,0,0,.00nan,0,0
39314,2876,3796,27,31,6,25,.806,3534000,0
39314,3855,4635,36,21,4,17,.810,3600000,0
39314,29928,4635,0,0,0,0,.00nan,0,0
39314,35378,3796,0,0,0,0,.00nan,0,0
39316,7540,3797,51,34,5,29,.853,3546000,0
39316,14229,3800,0,0,0,0,.00nan,0,0
39316,35017,3797,0,0,0,0,.00nan,0,0
39316,35568,3800,70,37,4,33,.892,3600000,0
39318,2968,4999,32,42,8,34,.810,3600000,0
39318,20018,4999,0,0,0,0,.00nan,0,0
39318,29919,3795,0,0,0,0,.00nan,0,0
39318,35125,3795,54,22,3,19,.864,3600000,0
39320,2876,3796,0,0,0,0,.00nan,0,0
39320,14229,3800,33,33,6,27,.818,3582000,0
39320,35378,3796,57,42,5,37,.881,3600000,0
39320,35568,3800,0,0,0,0,.00nan,0,0
39322,7540,3797,76,46,4,42,.913,3600000,0
39322,29919,3795,0,0,0,0,.00nan,0,0
39322,35017,3797,0,0,0,0,.00nan,0,0
39322,35125,3795,97,29,1,28,.966,3600000,0
39324,3855,4635,0,0,0,0,.00nan,0,0
39324,4618,3798,0,0,0,0,.00nan,0,0
39324,29928,4635,91,32,1,31,.969,3600000,0
39324,35119,3798,81,42,4,38,.905,3600000,0
39326,2876,3796,86,16,0,16,1000,3600000,0
39326,4618,3798,67,56,6,50,.893,3600000,0
39326,35119,3798,0,0,0,0,.00nan,0,0
39326,35378,3796,0,0,0,0,.00nan,0,0
39328,2968,4999,66,24,2,22,.917,3589000,0
39328,3855,4635,76,23,1,22,.957,3600000,0
39328,20018,4999,0,0,0,0,.00nan,0,0
39328,29928,4635,0,0,0,0,.00nan,0,0
39330,7540,3797,0,0,0,0,.00nan,0,0
39330,14229,3800,0,0,0,0,.00nan,0,0
39330,35017,3797,59,33,4,29,.879,3600000,0
39330,35568,3800,76,28,2,26,.929,3600000,0
39332,7540,3797,31,34,7,27,.794,3600000,0
39332,29919,3795,0,0,0,0,.00nan,0,0
39332,35017,3797,0,0,0,0,.00nan,0,0
39332,35125,3795,66,26,3,23,.885,3600000,0
39334,2968,4999,0,0,0,0,.00nan,0,0
39334,4618,3798,0,0,0,0,.00nan,0,0
39334,20018,4999,63,30,3,27,.900,3600000,0
39334,35119,3798,100,41,0,41,1000,3600000,0
39336,3855,4635,0,0,0,0,.00nan,0,0
39336,14388,3796,0,0,0,0,.00nan,0,0
39336,29928,4635,64,23,2,21,.913,3600000,0
39336,35378,3796,67,31,3,28,.903,3600000,0
39337,2761,1453,29,14,4,10,.714,1190000,0
39337,8959,1453,69,34,3,31,.912,2410000,0
39337,25814,1429,0,0,0,0,.00nan,0,0
39337,25831,1429,42,10,2,8,.800,3600000,0
39338,7627,4961,0,0,0,0,.00nan,0,0
39338,25814,1429,81,25,1,24,.960,3600000,0
39338,25831,1429,0,0,0,0,.00nan,0,0
39338,34889,4961,40,22,4,18,.818,3600000,0
39339,20383,1421,0,0,0,0,.00nan,0,0
39339,26920,1421,71,23,2,21,.913,3641000,0
39339,33478,1426,86,28,1,27,.964,3641000,0
39339,76932,1426,0,0,0,0,.00nan,0,0
39340,2700,1427,0,0,0,0,.00nan,0,0
39340,5935,1427,70,29,3,26,.897,3600000,0
39340,19455,1425,0,0,0,0,.00nan,0,0
39340,19626,1425,63,43,5,38,.884,3528000,0
39341,10224,1422,0,0,0,0,.00nan,0,0
39341,19350,1440,55,23,3,20,.870,2701000,0
39341,27926,1422,36,28,5,23,.821,3600000,0
39341,52846,1440,34,19,4,15,.789,872000,0
39342,14526,1430,0,0,0,0,.00nan,0,0
39342,19880,4742,38,27,5,22,.815,3600000,0
39342,19894,4742,0,0,0,0,.00nan,0,0
39342,48173,1430,91,31,1,30,.968,3600000,0
39343,2761,1453,11,24,7,17,.708,2045000,0
39343,7627,4961,0,0,0,0,.00nan,0,0
39343,8959,1453,30,24,5,19,.792,1555000,0
39343,34889,4961,40,15,3,12,.800,3600000,0
39344,19455,1425,0,0,0,0,.00nan,0,0
39344,19626,1425,82,23,1,22,.957,3600000,0
39344,33478,1426,53,38,4,34,.895,3600000,0
39344,76932,1426,0,0,0,0,.00nan,0,0
39345,2700,1427,61,29,3,26,.897,3600000,0
39345,5935,1427,0,0,0,0,.00nan,0,0
39345,20383,1421,80,49,4,45,.918,3551000,0
39345,26920,1421,0,0,0,0,.00nan,0,0
39346,10224,1422,79,31,2,29,.935,3600000,0
39346,19880,4742,0,0,0,0,.00nan,0,0
39346,19894,4742,44,44,6,38,.864,3600000,0
39346,27926,1422,0,0,0,0,.00nan,0,0
39347,14526,1430,0,0,0,0,.00nan,0,0
39347,19350,1440,0,0,0,0,.00nan,0,0
39347,48173,1430,100,35,0,35,1000,3600000,0
39347,52846,1440,73,24,2,22,.917,3560000,0
39348,7627,4961,0,0,0,0,.00nan,0,0
39348,33478,1426,73,33,2,31,.939,3600000,0
39348,34889,4961,82,38,3,35,.921,3600000,0
39348,76932,1426,0,0,0,0,.00nan,0,0
39349,7627,4961,0,0,0,0,.00nan,0,0
39349,33478,1426,92,33,1,32,.970,3600000,0
39349,34889,4961,54,28,4,24,.857,3600000,0
39349,76932,1426,0,0,0,0,.00nan,0,0
39350,2700,1427,0,0,0,0,.00nan,0,0
39350,2761,1453,69,41,4,37,.902,3600000,0
39350,5935,1427,66,25,2,23,.920,3600000,0
39350,8959,1453,0,0,0,0,.00nan,0,0
39351,19880,4742,48,0,0,0,.00nan,283000,0
39351,19894,4742,73,52,6,46,.885,3317000,0
39351,20383,1421,58,9,1,8,.889,3600000,0
39351,26920,1421,0,0,0,0,.00nan,0,0
39352,19350,1440,79,35,3,32,.914,3887000,0
39352,19455,1425,0,0,0,0,.00nan,0,0
39352,19626,1425,79,42,4,38,.905,3887000,0
39352,52846,1440,0,0,0,0,.00nan,0,0
39353,14526,1430,57,4,0,4,1000,273000,0
39353,25814,1429,0,0,0,0,.00nan,0,0
39353,25831,1429,20,26,6,20,.769,3600000,0
39353,48173,1430,21,32,7,25,.781,3296000,0
39354,2700,1427,54,4,0,4,1000,631000,0
39354,5935,1427,32,31,7,24,.774,2969000,0
39354,10224,1422,0,0,0,0,.00nan,0,0
39354,27926,1422,61,14,1,13,.929,3600000,0
39355,2761,1453,59,37,4,33,.892,3598000,0
39355,8959,1453,0,0,0,0,.00nan,0,0
39355,33478,1426,0,0,0,0,.00nan,0,0
39355,76932,1426,76,25,2,23,.920,3600000,0
39356,19880,4742,79,55,5,50,.909,3600000,0
39356,19894,4742,0,0,0,0,.00nan,0,0
39356,20383,1421,0,0,0,0,.00nan,0,0
39356,26920,1421,93,22,0,22,1000,3600000,0
39357,19350,1440,63,33,3,30,.909,3028000,0
39357,19455,1425,0,0,0,0,.00nan,0,0
39357,19626,1425,58,15,2,13,.867,3600000,0
39357,52846,1440,29,8,3,5,.625,572000,0
39358,14526,1430,0,0,0,0,.00nan,0,0
39358,25814,1429,100,39,0,39,1000,3600000,0
39358,25831,1429,0,0,0,0,.00nan,0,0
39358,48173,1430,55,36,5,31,.861,3600000,0
39359,2761,1453,100,40,0,40,1000,3600000,0
39359,8959,1453,0,0,0,0,.00nan,0,0
39359,14526,1430,52,21,2,19,.905,3516000,0
39359,48173,1430,0,0,0,0,.00nan,0,0
39360,19350,1440,51,2,0,2,1000,374000,0
39360,33478,1426,56,21,2,19,.905,3600000,0
39360,52846,1440,32,35,6,29,.829,3226000,0
39360,76932,1426,0,0,0,0,.00nan,0,0
39361,7627,4961,0,0,0,0,.00nan,0,0
39361,19880,4742,0,0,0,0,.00nan,0,0
39361,19894,4742,69,34,2,32,.941,3834000,0
39361,34889,4961,66,18,1,17,.944,3834000,0
39362,2700,1427,0,0,0,0,.00nan,0,0
39362,5935,1427,72,21,1,20,.952,3600000,0
39362,20383,1421,1,34,9,25,.735,3600000,0
39362,26920,1421,0,0,0,0,.00nan,0,0
39363,10224,1422,100,36,1,35,.972,3600000,0
39363,25814,1429,37,42,7,35,.833,3600000,0
39363,25831,1429,0,0,0,0,.00nan,0,0
39363,27926,1422,0,0,0,0,.00nan,0,0
39364,2761,1453,55,32,4,28,.875,3600000,0
39364,8959,1453,0,0,0,0,.00nan,0,0
39364,14526,1430,0,0,0,0,.00nan,0,0
39364,48173,1430,94,29,1,28,.966,3600000,0
39365,19880,4742,74,42,4,38,.905,3600000,0
39365,19894,4742,0,0,0,0,.00nan,0,0
39365,25814,1429,0,0,0,0,.00nan,0,0
39365,25831,1429,60,17,1,16,.941,3600000,0
39366,13377,1440,0,0,0,0,.00nan,0,0
39366,19350,1440,76,36,3,33,.917,3600000,0
39366,33478,1426,51,34,5,29,.853,3532000,0
39366,76932,1426,0,0,0,0,.00nan,0,0
39367,10224,1422,0,0,0,0,.00nan,0,0
39367,19455,1425,0,0,0,0,.00nan,0,0
39367,19626,1425,42,25,4,21,.840,3600000,0
39367,27926,1422,74,20,1,19,.950,3600000,0
39368,7627,4961,0,0,0,0,.00nan,0,0
39368,20383,1421,57,3,0,3,1000,406000,0
39368,26920,1421,1,17,7,10,.588,3194000,0
39368,34889,4961,56,23,3,20,.870,3600000,0
39369,2700,1427,0,0,0,0,.00nan,0,0
39369,5935,1427,62,31,3,28,.903,3600000,0
39369,7627,4961,0,0,0,0,.00nan,0,0
39369,34889,4961,58,35,4,31,.886,3591000,0
39370,19455,1425,0,0,0,0,.00nan,0,0
39370,19626,1425,49,30,5,25,.833,3628000,0
39370,19880,4742,61,34,6,28,.824,3628000,0
39370,19894,4742,0,0,0,0,.00nan,0,0
39371,25814,1429,0,0,0,0,.00nan,0,0
39371,25831,1429,83,25,1,24,.960,3600000,0
39371,33478,1426,58,35,4,31,.886,3600000,0
39371,76932,1426,0,0,0,0,.00nan,0,0
39372,2761,1453,30,27,6,21,.778,2953000,0
39372,8959,1453,47,7,1,6,.857,647000,0
39372,10224,1422,93,39,2,37,.949,3600000,0
39372,27926,1422,0,0,0,0,.00nan,0,0
39373,13377,1440,0,0,0,0,.00nan,0,0
39373,19350,1440,91,41,2,39,.951,3869000,0
39373,20383,1421,58,29,3,26,.897,3869000,0
39373,26920,1421,0,0,0,0,.00nan,0,0
39374,7627,4961,0,0,0,0,.00nan,0,0
39374,10224,1422,0,0,0,0,.00nan,0,0
39374,27926,1422,74,33,3,30,.909,3900000,0
39374,34889,4961,67,38,3,35,.921,3900000,0
39375,2700,1427,68,27,2,25,.926,3600000,0
39375,5935,1427,0,0,0,0,.00nan,0,0
39375,19880,4742,0,0,0,0,.00nan,0,0
39375,19894,4742,56,35,4,31,.886,3525000,0
39376,13377,1440,44,26,4,22,.846,3577000,0
39376,14526,1430,79,35,2,33,.943,3600000,0
39376,19350,1440,0,0,0,0,.00nan,0,0
39376,48173,1430,0,0,0,0,.00nan,0,0
39377,2761,1453,77,52,5,47,.904,3600000,0
39377,8959,1453,0,0,0,0,.00nan,0,0
39377,20383,1421,0,0,0,0,.00nan,0,0
39377,26920,1421,52,14,2,12,.857,3600000,0
39378,19455,1425,0,0,0,0,.00nan,0,0
39378,19626,1425,76,28,2,26,.929,3900000,0
39378,25814,1429,69,29,2,27,.931,3900000,0
39378,25831,1429,0,0,0,0,.00nan,0,0
39379,2700,1427,0,0,0,0,.00nan,0,0
39379,5935,1427,87,29,1,28,.966,3900000,0
39379,33478,1426,80,27,1,26,.963,3900000,0
39379,76932,1426,0,0,0,0,.00nan,0,0
39380,7627,4961,0,0,0,0,.00nan,0,0
39380,14526,1430,0,0,0,0,.00nan,0,0
39380,34889,4961,67,16,1,15,.938,3600000,0
39380,48173,1430,37,29,5,24,.828,3600000,0
39381,2761,1453,98,47,1,46,.979,3600000,0
39381,8959,1453,0,0,0,0,.00nan,0,0
39381,19455,1425,0,0,0,0,.00nan,0,0
39381,19626,1425,60,29,3,26,.897,3584000,0
39382,19350,1440,0,0,0,0,.00nan,0,0
39382,20383,1421,50,7,1,6,.857,1105000,0
39382,26920,1421,48,16,3,13,.813,2495000,0
39382,52846,1440,52,45,6,39,.867,3600000,0
39383,19880,4742,53,4,0,4,1000,330000,0
39383,19894,4742,58,47,6,41,.872,3270000,0
39383,25814,1429,0,0,0,0,.00nan,0,0
39383,25831,1429,55,20,2,18,.900,3600000,0
39384,2700,1427,39,24,4,20,.833,3558000,0
39384,5935,1427,0,0,0,0,.00nan,0,0
39384,10224,1422,95,47,3,44,.936,3600000,0
39384,27926,1422,0,0,0,0,.00nan,0,0
39385,7627,4961,0,0,0,0,.00nan,0,0
39385,14526,1430,47,45,7,38,.844,3285000,0
39385,34889,4961,58,24,3,21,.875,3600000,0
39385,48173,1430,48,0,0,0,.00nan,315000,0
39386,2694,1421,0,0,0,0,.00nan,0,0
39386,19455,1425,0,0,0,0,.00nan,0,0
39386,19626,1425,76,35,3,32,.914,3591000,0
39386,20383,1421,77,31,2,29,.935,3600000,0
39387,15780,1429,0,0,0,0,.00nan,0,0
39387,19350,1440,30,27,5,22,.815,1425000,0
39387,25831,1429,58,20,2,18,.900,3600000,0
39387,52846,1440,45,32,5,27,.844,2175000,0
39388,2761,1453,0,0,0,0,.00nan,0,0
39388,8959,1453,70,38,3,35,.921,3600000,0
39388,19880,4742,48,28,4,24,.857,3558000,0
39388,19894,4742,0,0,0,0,.00nan,0,0
39389,7627,4961,0,0,0,0,.00nan,0,0
39389,19455,1425,0,0,0,0,.00nan,0,0
39389,19626,1425,69,23,2,21,.913,3600000,0
39389,34889,4961,23,29,7,22,.759,3600000,0
39390,2694,1421,63,27,4,23,.852,3590000,0
39390,15780,1429,0,0,0,0,.00nan,0,0
39390,20383,1421,0,0,0,0,.00nan,0,0
39390,25831,1429,94,38,2,36,.947,3600000,0
39391,2761,1453,24,11,4,7,.636,977000,0
39391,8959,1453,62,25,2,23,.920,2623000,0
39391,19350,1440,65,24,2,22,.917,3600000,0
39391,52846,1440,0,0,0,0,.00nan,0,0
39392,1771,1426,0,0,0,0,.00nan,0,0
39392,2700,1427,0,0,0,0,.00nan,0,0
39392,5935,1427,54,14,2,12,.857,3600000,0
39392,33478,1426,60,40,5,35,.875,3600000,0
39393,10224,1422,66,22,2,20,.909,3600000,0
39393,19880,4742,46,4,1,3,.750,563000,0
39393,19894,4742,31,39,7,32,.821,3037000,0
39393,27926,1422,0,0,0,0,.00nan,0,0
39394,1771,1426,67,28,3,25,.893,3600000,0
39394,10224,1422,52,21,2,19,.905,1421000,0
39394,27926,1422,24,30,7,23,.767,2179000,0
39394,33478,1426,0,0,0,0,.00nan,0,0
39395,2700,1427,33,8,3,5,.625,540000,0
39395,5935,1427,80,26,1,25,.962,3060000,0
39395,14526,1430,0,0,0,0,.00nan,0,0
39395,48173,1430,56,36,5,31,.861,3600000,0
39396,19350,1440,0,0,0,0,.00nan,0,0
39396,19880,4742,55,30,3,27,.900,3900000,0
39396,19894,4742,0,0,0,0,.00nan,0,0
39396,52846,1440,72,29,3,26,.897,3900000,0
39397,2694,1421,0,0,0,0,.00nan,0,0
39397,15780,1429,67,26,2,24,.923,3600000,0
39397,20383,1421,77,43,4,39,.907,3589000,0
39397,25831,1429,0,0,0,0,.00nan,0,0
39398,2761,1453,56,51,7,44,.863,3600000,0
39398,8959,1453,0,0,0,0,.00nan,0,0
39398,19455,1425,0,0,0,0,.00nan,0,0
39398,19626,1425,73,26,1,25,.962,3600000,0
39646,802,1430,0,0,0,0,.00nan,0,0
39646,14526,1430,67,36,3,33,.917,3900000,0
39646,19455,1425,0,0,0,0,.00nan,0,0
39646,19626,1425,78,36,3,33,.917,3900000,0
39648,7627,4961,0,0,0,0,.00nan,0,0
39648,19350,1440,0,0,0,0,.00nan,0,0
39648,34889,4961,70,23,2,21,.913,3600000,0
39648,52846,1440,47,37,5,32,.865,3600000,0
39650,2700,1427,0,0,0,0,.00nan,0,0
39650,5935,1427,70,30,3,27,.900,3600000,0
39650,10224,1422,63,33,4,29,.879,3600000,0
39650,27926,1422,0,0,0,0,.00nan,0,0
39652,2761,1453,24,12,4,8,.667,1146000,0
39652,8959,1453,56,27,3,24,.889,2454000,0
39652,20383,1421,0,0,0,0,.00nan,0,0
39652,26920,1421,50,22,3,19,.864,3600000,0
39654,19880,4742,54,6,1,5,.833,1224000,0
39654,19894,4742,36,37,6,31,.838,2376000,0
39654,25814,1429,0,0,0,0,.00nan,0,0
39654,25831,1429,54,15,2,13,.867,3600000,0
39656,19455,1425,58,19,2,17,.895,3900000,0
39656,19626,1425,0,0,0,0,.00nan,0,0
39656,19880,4742,0,0,0,0,.00nan,0,0
39656,19894,4742,97,41,2,39,.951,3900000,0
39658,2761,1453,81,43,3,40,.930,3799000,0
39658,8959,1453,0,0,0,0,.00nan,0,0
39658,25814,1429,65,24,2,22,.917,3799000,0
39658,25831,1429,0,0,0,0,.00nan,0,0
39660,2700,1427,50,24,4,20,.833,3600000,0
39660,5935,1427,0,0,0,0,.00nan,0,0
39660,19350,1440,25,25,6,19,.760,2762000,0
39660,52846,1440,62,9,0,9,1000,780000,0
39662,802,1430,0,0,0,0,.00nan,0,0
39662,7627,4961,0,0,0,0,.00nan,0,0
39662,14526,1430,49,34,4,30,.882,3600000,0
39662,34889,4961,84,29,2,27,.931,3600000,0
39664,10224,1422,0,0,0,0,.00nan,0,0
39664,27926,1422,68,25,3,22,.880,3600000,0
39664,33478,1426,41,42,7,35,.833,3600000,0
39664,76932,1426,0,0,0,0,.00nan,0,0
39666,2700,1427,56,21,3,18,.857,2527000,0
39666,5935,1427,20,9,4,5,.556,1073000,0
39666,33478,1426,76,39,4,35,.897,3600000,0
39666,76932,1426,0,0,0,0,.00nan,0,0
39668,10224,1422,66,25,2,23,.920,3600000,0
39668,19455,1425,0,0,0,0,.00nan,0,0
39668,19626,1425,65,45,5,40,.889,3600000,0
39668,27926,1422,0,0,0,0,.00nan,0,0
39670,802,1430,0,0,0,0,.00nan,0,0
39670,14526,1430,52,29,4,25,.862,3900000,0
39670,20383,1421,0,0,0,0,.00nan,0,0
39670,26920,1421,58,33,4,29,.879,3900000,0
39672,2761,1453,43,37,6,31,.838,2263000,0
39672,7627,4961,0,0,0,0,.00nan,0,0
39672,8959,1453,51,19,3,16,.842,1337000,0
39672,34889,4961,74,16,1,15,.938,3600000,0
39674,19880,4742,55,40,5,35,.875,3546000,0
39674,19894,4742,0,0,0,0,.00nan,0,0
39674,25814,1429,0,0,0,0,.00nan,0,0
39674,25831,1429,50,20,3,17,.850,3600000,0
39676,2700,1427,0,0,0,0,.00nan,0,0
39676,5935,1427,65,17,1,16,.941,3600000,0
39676,33478,1426,58,44,5,39,.886,3600000,0
39676,76932,1426,0,0,0,0,.00nan,0,0
39678,10224,1422,62,24,2,22,.917,3600000,0
39678,19455,1425,0,0,0,0,.00nan,0,0
39678,19626,1425,46,28,4,24,.857,3567000,0
39678,27926,1422,0,0,0,0,.00nan,0,0
39680,802,1430,0,0,0,0,.00nan,0,0
39680,14526,1430,70,37,4,33,.892,3582000,0
39680,19350,1440,0,0,0,0,.00nan,0,0
39680,52846,1440,80,30,2,28,.933,3600000,0
39682,19880,4742,0,0,0,0,.00nan,0,0
39682,19894,4742,64,52,5,47,.904,3600000,0
39682,25814,1429,0,0,0,0,.00nan,0,0
39682,25831,1429,83,18,0,18,1000,3600000,0
39684,2761,1453,38,45,7,38,.844,3600000,0
39684,7627,4961,0,0,0,0,.00nan,0,0
39684,8959,1453,0,0,0,0,.00nan,0,0
39684,34889,4961,71,18,1,17,.944,3600000,0
39686,2761,1453,53,40,5,35,.875,3600000,0
39686,8959,1453,0,0,0,0,.00nan,0,0
39686,20383,1421,0,0,0,0,.00nan,0,0
39686,26920,1421,65,19,1,18,.947,3600000,0
39688,19350,1440,50,38,6,32,.842,3600000,0
39688,25814,1429,0,0,0,0,.00nan,0,0
39688,25831,1429,80,26,1,25,.962,3600000,0
39688,52846,1440,0,0,0,0,.00nan,0,0
39690,7627,4961,61,29,3,26,.897,3600000,0
39690,33478,1426,83,26,1,25,.962,3600000,0
39690,34889,4961,0,0,0,0,.00nan,0,0
39690,76932,1426,0,0,0,0,.00nan,0,0
39692,10224,1422,0,0,0,0,.00nan,0,0
39692,19455,1425,52,33,5,28,.848,3600000,0
39692,19626,1425,0,0,0,0,.00nan,0,0
39692,27926,1422,72,30,2,28,.933,3600000,0
39694,2700,1427,57,9,1,8,.889,3600000,0
39694,5935,1427,0,0,0,0,.00nan,0,0
39694,19880,4742,28,13,4,9,.692,1011000,0
39694,19894,4742,81,39,2,37,.949,2589000,0
39696,10224,1422,57,41,5,36,.878,3718000,0
39696,19455,1425,0,0,0,0,.00nan,0,0
39696,19626,1425,49,27,4,23,.852,3718000,0
39696,27926,1422,0,0,0,0,.00nan,0,0
39698,2761,1453,33,40,7,33,.825,3600000,0
39698,8959,1453,0,0,0,0,.00nan,0,0
39698,19350,1440,0,0,0,0,.00nan,0,0
39698,52846,1440,31,31,6,25,.806,3600000,0
39700,7627,4961,0,0,0,0,.00nan,0,0
39700,33478,1426,84,28,1,27,.964,3600000,0
39700,34889,4961,68,24,2,22,.917,3598000,0
39700,76932,1426,0,0,0,0,.00nan,0,0
39702,19880,4742,0,0,0,0,.00nan,0,0
39702,19894,4742,98,53,2,51,.962,3567000,0
39702,20383,1421,0,0,0,0,.00nan,0,0
39702,26920,1421,90,15,0,15,1000,3600000,0
39704,802,1430,0,0,0,0,.00nan,0,0
39704,2700,1427,0,0,0,0,.00nan,0,0
39704,5935,1427,67,26,2,24,.923,3564000,0
39704,14526,1430,78,22,1,21,.955,3600000,0
39706,19880,4742,52,55,8,47,.855,3600000,0
39706,19894,4742,0,0,0,0,.00nan,0,0
39706,20383,1421,73,8,0,8,1000,3600000,0
39706,26920,1421,0,0,0,0,.00nan,0,0
39708,19455,1425,48,35,5,30,.857,3600000,0
39708,19626,1425,0,0,0,0,.00nan,0,0
39708,33478,1426,100,23,0,23,1000,3600000,0
39708,76932,1426,0,0,0,0,.00nan,0,0
39710,2700,1427,58,26,4,22,.846,3715000,0
39710,5935,1427,0,0,0,0,.00nan,0,0
39710,7627,4961,0,0,0,0,.00nan,0,0
39710,34889,4961,60,31,3,28,.903,3743000,0
39712,10224,1422,0,0,0,0,.00nan,0,0
39712,19350,1440,55,29,4,25,.862,3600000,0
39712,27926,1422,96,31,1,30,.968,3600000,0
39712,52846,1440,0,0,0,0,.00nan,0,0
39714,802,1430,0,0,0,0,.00nan,0,0
39714,2761,1453,55,46,6,40,.870,3600000,0
39714,8959,1453,0,0,0,0,.00nan,0,0
39714,14526,1430,34,13,4,9,.692,3600000,0
